,ticker,roc,yield,market_cap,roc_rank,yield_rank,magic_rank
0,SCPL,98.125,0.8821274549888005,395278816,3,19,22
1,BWMX,2.4134453953681074,0.5215989782295393,1323569408,82,31,113
2,JFIN,1.54509857184966,0.863142039592553,386818976,110,20,130
3,EDTK,1.5331729987260054,0.2783202775706274,41760000,112,55,167
4,SPKE,2.2723597000793307,0.1808626746905274,371986656,85,103,188
5,WIMI,1.8276932315863836,0.1985480943400193,559266560,102,88,190
6,SPKEP,2.2723597000793307,0.17310834726239785,393979200,85,115,200
7,VHC,0.8402892571189242,0.9789998835532505,375189408,186,16,202
8,SJ,0.8939947570999994,0.489227619108535,350444416,175,34,209
9,CIH,0.7989375347070358,1.1936370916226653,201707728,194,15,209
10,NVO,1.008964291006075,0.25394075326055376,157006479360,154,63,217
11,UWMC,1.3465861254231861,0.17963129740116132,12440068096,126,104,230
12,HNNA,1.2505800464037122,0.18574483926696117,65801436,134,99,233
13,QDEL,0.9913327874648752,0.19882302427758552,5511640064,159,87,246
14,CIXX,4.2886181960750145,0.11660398925568811,3135681792,48,205,253
15,GBL,1.1008470758852547,0.17685150703225047,508683712,144,111,255
16,KARO,0.6590268547267938,0.5965874893422093,778123712,234,26,260
17,BPT,59.74803149606299,0.10177175123056909,74686000,4,260,264
18,FHI,1.5129239541800237,0.13409088592645893,3079787776,113,157,270
19,MSGN,1.020593249469631,0.15905869512497203,927036480,152,128,280
20,QIWI,0.5072510705674907,4.995917864433721,663503552,307,4,311
21,FHS,3.930238152513832,0.10213347310870287,221438432,57,258,315
22,ONEW,1.8697591248553698,0.10772597678355936,623421056,101,228,329
23,SIGA,0.6103351858565489,0.19764861187736738,534936320,248,90,338
24,CODX,0.6248437184088261,0.1839222143917636,265157728,244,100,344
25,APT,0.5021943773056863,0.2833542453108829,128897656,312,54,366
26,OMAB,0.4850606987285899,0.3291132272686634,2507143424,331,47,378
27,SDH,0.710958513361235,0.12863137354086546,86318400,216,171,387
28,RKT,0.6318768945323884,0.14025057374323965,44808880128,240,147,387
29,TGNA,0.9549140361097419,0.10748256092125488,4390477312,165,232,397
30,NLS,0.5496104388980667,0.17157027881841985,490284704,283,120,403
31,QRTEA,0.9980952380952381,0.10311928738827122,4911480832,155,249,404
32,QRTEB,0.9980952380952381,0.10303848483738094,4923435520,155,250,405
33,FORTY,4.124552837667988,0.08592707468708961,1324320640,52,358,410
34,GSS,0.48255442979233537,0.21569777290704428,351993600,334,76,410
35,GTN,0.5559815950920245,0.13703121187697181,1834765440,278,152,430
36,SGRP,0.5213986914083449,0.15696189452134857,34005600,298,132,430
37,PRG,0.5396540034106552,0.13851460670555826,2936655616,288,150,438
38,EAF,0.5939108420873135,0.12178066620935767,3353799424,256,189,445
39,SQBG,1.9057037131555443,0.08697589602372022,44325724,99,348,447
40,KUKE,0.46817142970051834,0.1812700193434252,204010240,351,102,453
41,SAMG,0.6184874382207578,0.114468489269395,207790560,245,210,455
42,SBSW,0.3855315156167368,1.4571012576340687,13623529472,444,12,456
43,TUP,0.9588859416445623,0.09394497805923484,1281498240,164,302,466
44,SBS,0.44096202226021547,0.1833879370970607,5100766208,379,101,480
45,ICON,2.21227350269722,0.08209701573155875,31046862,87,398,485
46,NRT,7.055687832107777,0.07609165925167512,43655304,35,463,498
47,GILD,0.7118740877070509,0.09616824567698089,82594332672,215,286,501
48,WLKP,0.3854615977653387,0.2746990344870728,862725056,445,56,501
49,FLGT,0.5179592738442981,0.11703476594309799,2481484032,300,202,502
50,LAZY,0.4997937846699524,0.12190892603208293,199872496,318,186,504
51,ZIM,0.4412326610913671,0.1660439355635261,3148699904,378,126,504
52,BTI,1.742650454055718,0.08087290295376905,88069447680,104,410,514
53,CRT,0.6441024308990854,0.0963856570361413,54540000,237,281,518
54,SBR,7.0858021882166025,0.07448134538855598,456550784,34,485,519
55,SGU,0.5384763986066756,0.10579044549589241,445398976,290,239,529
56,AMCX,0.4267230056226487,0.1437163085997298,2163787008,389,141,530
57,LFVN,0.4685672736086285,0.12193434385100226,123957752,350,185,535
58,LH,0.5873495693834484,0.09711582875571385,24634798080,260,277,537
59,UONEK,0.4686392622230427,0.11967844548972711,123299968,348,195,543
60,UONE,0.4686392622230427,0.11967842684646936,123300120,348,196,544
61,TVTY,0.9926172434211019,0.08227014910342298,1147161472,158,394,552
62,QFIN,0.344594841548441,0.29746532660775826,3775419904,505,49,554
63,LEU,0.9284467713787086,0.08289886846659682,319645792,167,389,556
64,MSB,2.1007397681488547,0.07553498073645225,399765792,92,475,567
65,INVA,0.3487961017141437,0.23133132694600908,1250360576,498,69,567
66,FINV,0.3131842899162012,24.555561230465546,1921545344,572,1,573
67,DGX,0.5166748406081413,0.09730509786127477,17047541760,301,275,576
68,GMAB,0.3240077741407529,0.4025634741802226,21743648768,545,40,585
69,MVO,0.5324422193892495,0.09503248584762224,59800084,294,296,590
70,MO,0.5677090980277003,0.0912496130456323,95034826752,272,320,592
71,UPC,0.49697796135451555,0.09759533011906188,107100000,321,273,594
72,PFMT,13.663522012578616,0.06667855064126196,134321152,19,580,599
73,LXEH,0.3332358584519837,0.21134012936425403,105867200,524,79,603
74,THRY,0.44533947693827913,0.10746136095284906,784795200,371,233,604
75,HEAR,0.44594837019894873,0.1055419543799599,439093856,368,240,608
76,TLK,0.31003673041044777,0.5872465822681706,23163203584,581,27,608
77,HYW,0.3225346571597758,0.2601638384254761,217000000,548,61,609
78,SURF,0.31473730117752036,0.32361994489317153,336742528,567,48,615
79,ABEV,0.3221141881740119,0.234112165787189,42133614592,549,68,617
80,SCU,0.35698723195057025,0.14269561317916976,1240971392,479,144,623
81,DISH,0.7099116956095148,0.08136189950537683,19895697408,218,406,624
82,PBH,0.9705965991714439,0.07603970544581416,2160142848,162,466,628
83,JHG,0.3752235136343317,0.12236142626603883,5554840576,459,183,642
84,RGR,0.47023146087771606,0.09369842450912969,1212644352,346,304,650
85,PZN,0.7796129651047985,0.07624002897443866,750580608,198,459,657
86,GNE,0.4719847413889824,0.09153424590577248,169233776,343,318,661
87,WW,1.581742224779392,0.06715498977502558,2183186176,108,568,676
88,DISCB,0.6015557476231633,0.07834639201689961,19385501696,249,435,684
89,DISCK,0.6015557476231633,0.0783463513780872,19385520128,249,436,685
90,DISCA,0.6015557476231633,0.07834634234724572,19385524224,249,437,686
91,GPL,0.3098647838539932,0.1771021085023758,288052992,583,110,693
92,SAGE,0.2982583523657747,0.21088992729879102,4552620544,615,80,695
93,STRL,0.5061990127305793,0.08291177168224109,625754816,309,388,697
94,GSMG,0.33358713031750004,0.12412806801407039,228076464,522,179,701
95,LPX,0.38188073394495414,0.10247386509006577,6400218112,449,256,705
96,NOG,0.33109197635772,0.12440538069298583,773995584,529,178,707
97,VNT,0.628687232605269,0.07562633546844753,5130571264,242,474,716
98,EBIX,0.56372211372495,0.07737851637443753,944359296,274,444,718
99,VALE,0.27294847567603725,0.4908062192442938,95672811520,687,33,720
100,SPWH,0.3099732394203033,0.14596209362704707,754677440,582,139,721
101,TSM,0.2677514891524448,0.7503646720445973,542291230720,699,22,721
102,USNA,0.41561423380611373,0.09215152291576982,2059070080,409,314,723
103,BTG,0.29079275378617486,0.187913246275946,4768328704,630,96,726
104,HESM,0.28142543324383695,0.22166014626207647,578328384,656,74,730
105,NXST,0.36904194698522313,0.09773538093217068,6206809088,465,270,735
106,PRDO,0.29666355286979096,0.17197810392598506,836545024,618,118,736
107,ALSN,0.5218198700092851,0.07694386512072754,4688026112,297,450,747
108,STEP,0.4270777343374278,0.08572770644423766,1416806272,388,360,748
109,CEPU,0.25964322672061435,0.5370386540534118,529113216,720,30,750
110,PINC,0.42095164839402904,0.08610195267752765,4162237952,399,354,753
111,SBGI,0.3501912960306074,0.10129660854157108,2219542272,493,261,754
112,BIIB,0.38650836481381545,0.09188160078304243,40829091840,443,316,759
113,BIPC,0.44433094994892747,0.0828499432128586,3323912448,372,390,762
114,PBT,7.390110838667562,0.05927770954932873,185969120,32,731,763
115,GIB,0.6261227339850458,0.06971287812736209,21606291456,243,530,773
116,DLX,0.4987579323461969,0.07686981734102151,1784210816,320,453,773
117,PM,0.7669655127282246,0.06582373991279178,137585262592,203,597,800
118,APAM,0.4216487729521225,0.08155225437807793,4208251648,397,404,801
119,GSK,0.7287174641353835,0.06587580239526049,90378625024,211,596,807
120,HLF,0.417328990228013,0.08186513943724474,5337964544,408,399,807
121,WFG,0.3177433498976907,0.10314904393775924,9807149056,559,248,807
122,VEON,0.2986962444055264,0.11962319024873175,3095960064,613,197,810
123,VGR,0.3618942496161367,0.08827063026032828,2171065600,471,341,812
124,EBS,0.3151889859136975,0.10266283638772787,4203238144,565,254,819
125,HPQ,2.54445165476963,0.05841406685547558,40240242688,77,744,821
126,CMCL,0.24928680860056,0.2404140823373461,166148752,757,65,822
127,MBT,0.25802257778006615,0.18631245923776485,7176487424,731,97,828
128,ERIC,0.25060315912472575,0.21597529279859773,45103677440,754,75,829
129,KHC,0.49583087677924703,0.07152611919044191,49707597824,323,509,832
130,MNDO,0.30466789359210306,0.10279350716845001,55760380,594,253,847
131,HLG,0.2397819494030481,0.283834701285365,1427075584,794,53,847
132,TKC,0.2381219695459227,0.3525894493254765,4079516160,802,45,847
133,GIS,2.1350130083527317,0.05754703254011334,37446119424,90,765,855
134,RLGY,0.44541484716157204,0.07393622216244695,1787269504,370,492,862
135,MNSO,0.3137711574862496,0.0953431375693917,7572037120,571,293,864
136,OBCI,0.2859678869820986,0.10852315658764679,115859128,641,225,866
137,MRK,0.5356948043092867,0.06644746418132397,191847530496,292,585,877
138,XPER,0.392847801792805,0.07768713957029183,2339959296,437,441,878
139,GHG,0.2335047854125065,0.2743822491483252,1337523072,823,57,880
140,RDY,0.22980418551505,0.361817577777731,10393155584,838,43,881
141,ALXN,0.34620976365842815,0.08323164564172866,33493843968,502,383,885
142,BSIG,0.2610619469026549,0.12882268237323571,1617376128,716,170,886
143,WIT,0.22466217712994552,0.9339744469940034,31852482560,870,18,888
144,BDSI,0.2914500642162559,0.10060915884726289,359068704,629,262,891
145,MARPS,0.6130038695128514,0.06346383116549334,9980000,246,648,894
146,VIAC,0.32928968137971354,0.08550821384023097,27677691904,533,362,895
147,DLHC,0.9082360366046072,0.05968475302282475,133968856,173,723,896
148,ABBV,2.668536460989291,0.05532831157601489,185977618432,72,826,898
149,KOF,0.22849629970994062,0.27383447812557715,9964105728,843,58,901
150,WINA,2.0778989251756923,0.05591243379956158,696255680,94,809,903
151,VIACA,0.32928968137971354,0.08443230501488444,28349198336,533,374,907
152,SGC,0.2853596992636078,0.09944458332062774,385162976,645,263,908
153,TRIB,0.266641665104069,0.11590854643886007,75872808,703,207,910
154,CDK,0.7848118648722878,0.05998265829243628,6569953792,196,719,915
155,WTRH,0.3819980356391188,0.07564410602020057,319939072,448,473,921
156,VIPS,0.2392425023990241,0.16936147809494523,20027523072,799,122,921
157,ATHM,0.2272895762775254,0.22172984438132814,11763118080,849,73,922
158,PHAR,0.3396079102989029,0.08077057135320265,817374336,512,412,924
159,BHAT,0.2470795204827223,0.13207152578983486,68581600,764,163,927
160,ITIC,0.24675124531453513,0.13274760601787863,316318048,767,160,927
161,KBAL,0.2537832010387671,0.12240779394280453,504491616,746,182,928
162,MAS,0.4671857619577308,0.06671066583103179,15513534464,352,578,930
163,REYN,0.444275966641395,0.06798932742243309,6290999808,373,557,930
164,TSN,0.30071675928163,0.0905814172435418,27617583104,607,326,933
165,HIBB,0.2528721042074137,0.12186980629715229,1144577408,749,187,936
166,IRWD,0.30152258260366366,0.08967193093937133,1672395264,605,333,938
167,DFIN,0.5518565941101152,0.0628261127131365,976640960,281,658,939
168,CWH,0.28217371407146835,0.09604170792029318,3315613440,652,288,940
169,ENDP,0.4043967405733587,0.06999750761597573,1558186752,421,525,946
170,IEA,0.30296245056917914,0.08644348796391312,317921408,599,352,951
171,MUSA,0.2596305578761719,0.10750448820668461,3885703680,722,231,953
172,VTRU,0.22023015977713456,0.22865427828909532,323966304,885,70,955
173,CBOE,1.3185007385524372,0.05517074915603294,10740353024,127,831,958
174,CAG,0.5687774294670846,0.061097730839759154,18194683904,271,691,962
175,HMPT,0.24900003953332078,0.11680385775382028,1341387520,758,204,962
176,WU,1.0756885708089352,0.055674643118308886,10368306176,148,816,964
177,TEVA,0.44313896141572384,0.06623944149113489,12402557952,375,590,965
178,LMT,0.3989662921348315,0.0691325419654856,105963520000,428,541,969
179,AMOV,0.2252562749037905,0.17742884660013464,46113050624,865,107,972
180,AMX,0.2252562749037905,0.17739718088327983,46279405568,865,108,973
181,CPRX,0.24353627352088314,0.11929252496884986,453715232,776,198,974
182,EBF,0.2685400167509515,0.09639918749979354,555801728,697,280,977
183,SJM,0.4875839686014039,0.0632814263835067,13847433216,328,650,978
184,CPB,0.6603580562659846,0.0583631994265349,14914103296,231,748,979
185,TROW,0.3804067721466375,0.06984753055133072,40247808000,451,528,979
186,GFI,0.2301098144729844,0.14294356922944215,8817674240,837,143,980
187,ELVT,0.20739372044435472,0.2934534409242541,113094496,929,51,980
188,MHH,0.5481958260191145,0.060840725397046234,203811152,284,698,982
189,SVA,0.22435314702403644,0.17380580699599169,460249280,872,114,986
190,BBY,0.3563851770216283,0.07105400631647495,30152925184,481,514,995
191,ESCA,0.27689805772342047,0.0907733635556531,291255296,672,325,997
192,CHRS,0.2257532497729022,0.14999110563941148,1033670464,864,134,998
193,NATH,0.3149195399724521,0.07781405300214486,277758016,566,440,1006
194,DHT,0.20726631922312624,0.21541908962505174,1073583808,930,77,1007
195,OCG,0.7264944582210949,0.05606980619193582,167711680,212,802,1014
196,BCC,0.2419994708450311,0.10756277809805706,2498260736,786,229,1015
197,OMC,1.1469206853211615,0.05346512765449579,16696714240,140,878,1018
198,PKI,0.6590546900026014,0.05648167231129922,14588230656,233,791,1024
199,TGS,0.19716310879452872,0.504507219201273,695550208,992,32,1024
200,WLMS,0.4188898722973827,0.06466223581257588,98241408,405,621,1026
201,HAPP,0.19524109129743406,0.6172394758815425,53095000,1004,25,1029
202,MIK,0.2436178824698759,0.10251474848414313,3112215040,775,255,1030
203,SEE,0.3445410711210608,0.06987409948376977,6927257088,506,527,1033
204,NOMD,1.0945829750644884,0.053044784285455074,4904376832,146,891,1037
205,AAN,0.20571207947674214,0.17847738315409786,860595264,935,105,1040
206,GPI,0.2598671162237208,0.09093898892163017,2788004608,719,324,1043
207,AU,0.21997858344806487,0.13215198297641903,9463410688,886,161,1047
208,DVA,0.29068777780878047,0.0801589755335575,11615340544,632,418,1050
209,MED,0.8219068316194592,0.05385985422480156,2566230528,190,863,1053
210,BKE,0.2627581299700526,0.08824590176456677,2016450432,712,342,1054
211,HZO,0.2590611051107309,0.09014910155001475,1078234752,725,332,1057
212,DOOO,0.3302764666217127,0.06961760205514815,7302165504,532,531,1063
213,SAIC,0.8771929824561403,0.053239464588583627,4901376512,178,886,1064
214,RMR,0.1998998245546067,0.19122139191702198,665661312,977,92,1069
215,WETF,18.370738166170142,0.04791527244027494,991032832,14,1057,1071
216,PAC,0.19852437477592794,0.19092776896328204,6049466880,984,93,1077
217,SIRI,2.6448863636363638,0.049257861232545455,26206072832,73,1005,1078
218,SUPN,0.23030311934872866,0.10373261422348465,1495077632,834,246,1080
219,WSM,0.34792326037819954,0.06657505929753421,13608832000,500,583,1083
220,TOMZ,0.3269482042499735,0.06883453911343426,68086576,540,546,1086
221,TG,0.2439445043290796,0.09207428695633202,499043968,772,315,1087
222,WHR,0.29501557632398756,0.07598592148766008,14460669952,621,467,1088
223,RIO,0.21888311990988307,0.11884026032288401,128721772544,890,200,1090
224,LOW,0.3932981873329963,0.06293946586371213,138911170560,436,656,1092
225,TAP,0.3937422283913132,0.06280134238954176,11219465216,434,659,1093
226,KMB,0.4437731196054254,0.059652579600015035,46286680064,374,724,1098
227,ASO,0.23638196673655823,0.09608037908835614,2804504320,814,287,1101
228,ITRN,0.30480282160326283,0.07134081930895124,514111264,592,511,1103
229,PBFX,0.2151396595354947,0.11658150845085334,895569984,899,206,1105
230,HUM,0.2968033811536401,0.07343292055016987,53117702144,617,496,1113
231,KL,0.20116634055849889,0.14357779614653499,9364258816,971,142,1113
232,MIXT,0.3331117652644573,0.06595921584495297,309525280,525,593,1118
233,SFM,0.22298873740772496,0.10552786812241124,3129293056,879,241,1120
234,COLL,0.8210729200128494,0.05185524897546415,809474240,191,930,1121
235,VVV,0.2564966313763234,0.08300886967557873,4775000576,736,387,1123
236,AZZ,0.3165996591033295,0.06755614998664194,1264654080,563,564,1127
237,LIVE,0.20148981303339747,0.13165796223284787,39346052,967,164,1131
238,SNBR,2.592448227029907,0.04768663207588032,3225612032,76,1063,1139
239,UL,0.9610763068706994,0.05011437277592713,150235856896,163,981,1144
240,KGC,0.1910678989262247,0.16783133788094826,9093640192,1020,125,1145
241,HD,0.5623687869782152,0.05366225871201256,335973974016,275,872,1147
242,STC,0.19222928285159774,0.1578778400612184,1467664128,1016,131,1147
243,TPX,0.561078167115903,0.053456245301438464,7562264576,276,879,1155
244,SBOW,0.18783839114826842,0.1703999574978801,98005304,1034,121,1155
245,K,0.47033468559837727,0.05580390373791733,21670402048,345,814,1159
246,BGS,0.3228344805126705,0.06525245269322803,1954083968,547,612,1159
247,ZCMD,0.2424414929997953,0.08352036002318665,49082748,783,378,1161
248,RMCF,0.20876977099130917,0.1068061310501857,33651568,924,237,1161
249,JAZZ,0.28051210751091504,0.0724508155257381,9120772096,660,502,1162
250,EME,0.3376503730151581,0.06364083972225137,6260523008,517,647,1164
251,LU,0.18013535786373916,0.18969960218280152,35530989568,1069,95,1164
252,CSCO,0.4136496777973052,0.05795731805157497,218562068480,411,759,1170
253,CACI,0.48030042233859443,0.054825292451335716,6340372992,337,838,1175
254,HOLX,0.5818501759678231,0.05246441852527585,18783559680,261,915,1176
255,RVP,0.3219227008199517,0.0645465354619398,359875744,550,626,1176
256,EPC,0.2731805643963505,0.0735486347147801,2117384704,684,495,1179
257,MSM,0.31019207720537073,0.0655041343332581,4836352512,580,606,1186
258,APR,0.2816543948270175,0.06959383823825645,1026749824,655,532,1187
259,LB,0.24321868916288125,0.08072730698779457,17924954112,779,413,1192
260,UNH,0.6497216100220392,0.050944371508845634,345646432256,235,959,1194
261,BJ,0.27676653047894906,0.0700166897801352,6315693056,673,524,1197
262,LOMA,0.16080007630456775,0.48814466237028126,1290862464,1162,35,1197
263,FSI,0.23066235774537103,0.08540074795039007,44694376,833,366,1199
264,IMKTA,0.185024003974088,0.13528329475167208,1251650432,1045,154,1199
265,BSA,0.1981527093596059,0.11384925189564594,1037972352,987,214,1201
266,MLI,0.25071685737555716,0.07693235049658842,2489874688,753,451,1204
267,ANTM,0.3168878999462902,0.06387265752722929,86272811008,562,643,1205
268,NTES,0.18336728480749645,0.1345919006500791,70392152064,1050,155,1205
269,FIX,0.513794901317576,0.052738421947116566,2713890048,304,907,1211
270,MOMO,0.15892785638956614,0.35902391317972027,3239117312,1170,44,1214
271,BUD,0.5700560448358687,0.051290491534146596,125248159744,270,945,1215
272,WTM,0.17479485988543117,0.17176969217045446,3438352640,1097,119,1216
273,ORLY,0.4489134388348547,0.05413018132764229,35837587456,366,853,1219
274,INTC,0.258566168507689,0.07401593579123418,269793181696,728,491,1219
275,OTIS,1.6231505657093124,0.04653358384386705,29925580800,107,1113,1220
276,CL,0.8533783783783784,0.04839340939181223,67479785472,184,1036,1220
277,SMP,0.21449270920920824,0.09145764343734755,941246528,901,319,1220
278,HBI,0.2865128161864889,0.06657689955583848,6952259072,640,582,1222
279,SIM,0.15294614636440063,1.412216188173878,2368222464,1210,13,1223
280,DHIL,0.20258899690243895,0.09750547009942284,519854880,956,274,1230
281,NUS,0.2296174854619157,0.08282313539334138,2664241408,840,391,1231
282,GCI,0.22726048636371737,0.08321671413875695,716025088,850,384,1234
283,IBEX,0.3582232893157263,0.0579058222260209,376222560,476,760,1236
284,HCA,0.2582472748135399,0.07188505493653208,62929723392,729,507,1236
285,OXLCO,0.1830792313579027,0.12363098470597814,463695200,1056,180,1236
286,BIOX,0.4006630816387376,0.05587254126249766,468585792,425,812,1237
287,RCII,0.2578022393348136,0.07209136454306521,3139126272,732,505,1237
288,OXLCM,0.1830792313579027,0.1222097217119489,472012576,1056,184,1240
289,MTSC,0.3396380955270063,0.05927751321619583,1139075200,511,732,1243
290,OESX,0.3129360498806295,0.0623880563909288,207937600,574,670,1244
291,AN,0.24230347713460199,0.0762344464614084,7478835712,784,460,1244
292,AFYA,0.17057198252581154,0.15803679495709363,1918113664,1116,130,1246
293,ENR,0.37527058619793924,0.05623432575214695,3255636480,458,798,1256
294,PGR,0.22971120581131865,0.08013578663983605,56092770304,839,419,1258
295,JCTCF,0.1950226100475362,0.10296514485828527,37438684,1006,252,1258
296,PRGS,1.5685070754086081,0.04565541041751545,2032943232,109,1150,1259
297,ABG,0.2772432616854316,0.06631694272134069,3735039488,671,588,1259
298,AMG,0.24385124163333202,0.07442429600161844,6555736064,773,487,1260
299,LEE,0.2668048449359597,0.06790366904637776,178409024,702,559,1261
300,SWK,0.5752560377967544,0.049418976512502794,32244248576,265,999,1264
301,FANH,0.15732536569950295,0.20771131840423818,771054464,1181,84,1265
302,BC,0.3179969792029743,0.060429603834556644,7590574080,558,708,1266
303,DKS,0.18831385114469545,0.10689452158259709,7263033344,1031,235,1266
304,MODV,0.4503094190906105,0.05277324683748193,2022717568,364,904,1268
305,AZO,0.31921360196195003,0.06013559357848341,31553327104,553,716,1269
306,PDEX,0.2743521000893655,0.06612067092675691,104700600,681,591,1272
307,AMEH,0.30710863229212765,0.061241493508397124,1162784256,587,687,1274
308,CW,0.3344995157870859,0.05811821965245654,5026477568,521,756,1277
309,LX,0.1967209446776092,0.09629772245437972,1680189440,995,283,1278
310,CRWS,0.2036481364497789,0.0893107055843559,77855152,946,335,1281
311,BXC,0.16972052145229435,0.13301232835885168,409871456,1122,159,1281
312,PVAC,0.16480291280424592,0.1466887102800572,206557088,1147,137,1284
313,LGIH,0.21386300180831827,0.08327145110000239,3849879808,903,382,1285
314,VIVO,0.39708021679519034,0.05397698180975713,1074310528,431,858,1289
315,AMGN,0.46595734052649984,0.05149324092300379,142867988480,353,937,1290
316,TWNK,0.34909947854815315,0.056278012647176114,1914640000,497,796,1293
317,HII,0.233035244608101,0.07596862959160845,8262708736,825,468,1293
318,JOAN,0.17923497267759564,0.11255108742426198,526750912,1076,217,1293
319,STMP,0.35818780311890486,0.05566295358652406,3773321216,477,817,1294
320,ABM,0.3141426783479349,0.05949372784669916,3429625344,570,727,1297
321,SPGI,4.023933402705515,0.042683520023775214,87008026624,55,1245,1300
322,VZ,0.21638365906772886,0.08152355852960783,244715470848,896,405,1301
323,FOX,0.19641312042790843,0.09302217032455859,21636063232,996,308,1304
324,JBSS,0.27317066036839066,0.06468221040308933,1029761408,685,620,1305
325,FOXA,0.19641312042790843,0.09279102397941123,21702930432,996,309,1305
326,OMP,0.1838354491976608,0.10213382565957603,755372224,1048,257,1305
327,RGP,0.21499380421313508,0.08102968458504146,443738272,900,408,1308
328,FMC,0.35281715268091735,0.055399535866365854,14444138496,487,823,1310
329,CCRC,0.17747562294627536,0.10841247715106064,114376696,1086,226,1312
330,TNET,0.4274099883855981,0.05193784855094983,5168391680,387,927,1314
331,AYI,0.3141726981989564,0.0583632815817428,5962444800,569,747,1316
332,PHM,0.17578510686128582,0.10908498657308371,14157400064,1093,223,1316
333,BEN,0.22701408088471678,0.0760800070649307,15389552640,854,464,1318
334,VRTX,0.33868630473351585,0.056055870944298515,55298691072,515,804,1319
335,MTH,0.16459222691990788,0.13000956802150318,3534143488,1151,168,1319
336,LDOS,0.5009680542110359,0.04916439326965385,13926820864,314,1006,1320
337,OXLC,0.1830792313579027,0.09887593601827202,642752000,1056,264,1320
338,HI,0.3234946871310508,0.05712507589573648,3689591040,546,778,1324
339,KOP,0.19096653405101802,0.0939344153595662,717982400,1021,303,1324
340,MTR,0.2486110269270252,0.06722720833337684,9578830,759,566,1325
341,WDR,0.21731393570651686,0.07866446761147719,1566268928,894,432,1326
342,CURO,0.17045157745895365,0.11408178143050052,602646720,1118,211,1329
343,GWW,0.3385390428211587,0.055731908268792756,20870449152,516,815,1331
344,MN,0.15310701215587472,0.16224827011831777,110559672,1209,127,1336
345,CIG,0.14984495398655176,0.1753245617369592,3625983232,1226,112,1338
346,NTAP,0.44673704414587334,0.05031612439528471,16399014912,367,975,1342
347,PII,0.3564756222503465,0.05387226441104112,8431075840,480,862,1342
348,BGFV,0.15739040042989724,0.13214801003162885,365864128,1180,162,1342
349,SNX,0.21613381525471437,0.07730741491668428,6169051648,897,448,1345
350,MFGP,2.4882226980728053,0.04197054286829736,2557925376,78,1268,1346
351,MCFT,0.529413756900464,0.048096530573751,511252096,296,1050,1346
352,FAF,0.18979207337823448,0.0912408528911238,6450281984,1025,321,1346
353,BABA,0.15311280301890698,0.14627164163028694,615507099648,1208,138,1346
354,GOLD,0.15755834597630652,0.12446367330740514,36893261824,1177,176,1353
355,FMS,0.23301230713486226,0.0697772470997434,21760724992,826,529,1355
356,FCN,0.3555273886776373,0.053472747105769436,4862193664,483,877,1360
357,MEI,0.20562366737739873,0.07897424568673073,1690501504,936,428,1364
358,NGVT,0.23146173892442548,0.0694008491667223,3067691264,831,536,1367
359,EURN,0.14686302563755138,0.16890061906128592,1845308544,1244,123,1367
360,GD,0.3197206619098224,0.05539633849398202,52898906112,552,824,1376
361,QSR,0.4996857322438718,0.04775960117017506,20423735296,319,1060,1379
362,TIG,0.20032238964318602,0.08156936687312856,817869312,976,403,1379
363,DKL,0.23788121353250155,0.06688612777759068,1671698176,806,574,1380
364,TPB,0.35170955271582344,0.05298185449024331,962169088,490,892,1382
365,MMM,0.3590759075907591,0.052673779011446514,112957349888,474,909,1383
366,CTSH,0.32644401861483713,0.05476094573631028,42029936640,542,844,1386
367,UHS,0.19583991065456166,0.0831182811560969,11624649728,1001,385,1386
368,STX,0.2819051496030938,0.05909285658666384,18281689088,654,735,1389
369,ACY,0.14364825796277741,0.15868841949942297,19478088,1261,129,1390
370,SPB,0.27927215189873417,0.059565968756616995,3792922880,666,726,1392
371,RTLR,0.19262392496398462,0.08346494205010772,1643697152,1013,380,1393
372,GGB,0.1408964578029937,0.172455823849717,8637963264,1279,117,1396
373,MHO,0.15378856505076974,0.11974133921061045,1821103616,1204,194,1398
374,BCE,0.21182994454713494,0.07358938960605686,41727037440,906,494,1400
375,ATKR,0.2855357924191104,0.05800215348028256,3333687552,643,758,1401
376,DOX,0.29325929344567514,0.05714630805948081,9530601472,626,777,1403
377,SNA,0.22180496668685645,0.07017774192886642,12803746816,882,521,1403
378,MBUU,0.42515222101582717,0.04892905184325862,1697435776,393,1014,1407
379,CI,0.24364801226590735,0.0641151673058384,83448111104,774,635,1409
380,TNK,0.12962444262594197,0.25879979741740033,488190304,1347,62,1409
381,CRCT,0.8619766142206173,0.043085692223537364,4429533696,182,1228,1410
382,HSY,0.47922369257252817,0.047454060002690125,33264646144,340,1070,1410
383,OSN,0.13368970832493923,0.20780346201862912,31731762,1329,83,1412
384,STRA,0.3006506081289415,0.05604126155806364,2264137728,608,806,1414
385,TIMB,0.1280768576498642,0.26338384305382434,5446503936,1355,60,1415
386,GHLD,0.1435097172387612,0.13597047343676757,847800000,1263,153,1416
387,LHX,0.43873517786561267,0.04838586248625834,42891345920,380,1037,1417
388,MOH,0.2748868778280543,0.05869308396870843,13622724608,678,740,1418
389,BBL,0.17817112613937078,0.08890380554277089,148139655168,1082,337,1419
390,UG,0.34610442746429154,0.05234763185620242,68639136,503,917,1420
391,ECPG,0.1496450311867893,0.12062412439319471,1219343872,1228,192,1420
392,PHI,0.1516975630789869,0.11781210696543744,5610141184,1222,201,1423
393,CSGS,0.23787156328389816,0.06472396094955979,1500253824,807,618,1425
394,SSD,0.2877512947215549,0.056524288612253774,4539386880,636,790,1426
395,CVS,0.23682659640851417,0.06503415336815957,97769611264,812,614,1426
396,DHI,0.19443084536300725,0.08019874122295632,33522413568,1009,417,1426
397,UFPI,0.22420987607629564,0.06826543357627302,4871694336,874,553,1427
398,HMTV,0.2080463376146617,0.0727930677315682,499101056,927,501,1428
399,VIV,0.12715641083739945,0.24018864654101182,13439890432,1362,66,1428
400,FBHS,0.3884011826245167,0.04989488769812236,13615777792,442,987,1429
401,NVR,0.23234099984044343,0.0657126371980063,17784295424,829,600,1429
402,SYX,0.4633608815426997,0.04726062874794207,1615493888,354,1077,1431
403,CHT,0.12230034013050337,0.4454914178403501,30513285120,1393,38,1431
404,NEU,0.22623495114906308,0.0670522216574374,4246125824,861,571,1432
405,HBB,0.20833038874060222,0.07093486911838266,244462160,926,516,1442
406,MMC,0.47984293193717276,0.04671888738500617,63206334464,338,1105,1443
407,CLX,0.540447504302926,0.04529316404895758,24403453952,287,1161,1448
408,PLUS,0.2629429081973329,0.058862584457212146,1346144896,710,738,1448
409,COKE,0.20334752710751622,0.07287266023647021,2772737280,948,500,1448
410,EVC,0.18019659535111676,0.08342673604612952,320747488,1068,381,1449
411,PG,0.7100144882996005,0.0428906913366655,336719511552,217,1234,1451
412,SMTX,0.3112444384522044,0.05348542269111354,172223344,577,876,1453
413,DG,0.24343885624833458,0.061666301322377375,49223782400,777,678,1455
414,MDP,0.22782657976763956,0.06483046366070278,1379530880,844,617,1461
415,BLD,0.4960809236309713,0.045810135173682424,6920161280,322,1140,1462
416,AB,0.1920284327906089,0.07737403004933119,3985885184,1017,445,1462
417,BAH,0.4193711292113518,0.047605613224524126,11323565056,401,1064,1465
418,IMOS,0.11942738376030453,0.36482034563493504,1152759680,1424,41,1465
419,FRO,0.1365669185901364,0.13409400253039885,1514320640,1311,156,1467
420,REZI,0.28009630818619585,0.05604774504729363,4050833920,663,805,1468
421,MMS,0.42666855067671405,0.04717789033830515,5700947456,390,1081,1471
422,STCN,0.39724987449338184,0.04825618568948125,124740592,430,1043,1473
423,ASGN,0.41085373924553276,0.047710244686072295,5330740224,414,1061,1475
424,LZB,0.18386191197923357,0.07878405508088313,1963905920,1047,430,1477
425,MGIC,0.30677276173511075,0.05314033088855509,774209088,590,889,1479
426,ATUS,0.3483433099556513,0.05005247495709735,15585334272,499,983,1482
427,ATGE,0.1833181772031201,0.07870066166073812,1979060992,1051,431,1482
428,NEWA,0.1867317149324799,0.0773148446902051,37520912,1037,447,1484
429,KFRC,0.23948703012542,0.06091672647517751,1202857984,796,692,1488
430,JRSH,0.1360908429606912,0.1267337867248042,75764248,1316,172,1488
431,BRC,0.29301634472511146,0.053959538604651906,2845789440,628,861,1489
432,CHE,0.7311968166086749,0.041665748855102276,7413773312,209,1281,1490
433,BIG,0.13017279335369142,0.14206326081996276,2305639680,1345,145,1490
434,TGI,0.20467693934380654,0.06878527620977197,978613696,943,548,1491
435,LEGH,0.1574964428708514,0.09186695233376531,446295968,1178,317,1495
436,CRSR,0.6839476541999603,0.04176914615794305,3177902080,223,1275,1498
437,NOC,0.25494333252953943,0.05817818439135568,53756477440,743,755,1498
438,ENIA,0.1639389017665257,0.08740838346305262,12684958720,1154,345,1499
439,ENIC,0.12026652122244263,0.19796287165824097,5265889280,1415,89,1504
440,VYGR,0.11661797647539797,0.26864277244991847,179608624,1449,59,1508
441,EGRX,0.20286250731016653,0.06810554809941417,523801600,953,556,1509
442,CEF,0.14172222470590679,0.10709134454175255,3917004032,1276,234,1510
443,TK,0.12079938890605084,0.17713185561275765,331637504,1406,109,1515
444,IPG,0.41190446929662855,0.04672372722819828,11532815360,413,1103,1516
445,CPRI,0.21986970684039087,0.06437784901834154,7663972864,887,629,1516
446,ORCL,0.2825227599425012,0.053725811669021524,214188949504,650,868,1518
447,PVG,0.15653353795334324,0.09037096515392767,2097879040,1189,329,1518
448,NLSN,0.5194206714944042,0.04332545913046643,8977001472,299,1220,1519
449,SEIC,0.29980989269304814,0.05252054742575433,8974116864,611,913,1524
450,ZTO,0.11569988831223223,0.2441057373072825,24341864448,1460,64,1524
451,SJT,1.211411347858221,0.039217217678061876,190163904,137,1391,1528
452,BGSF,0.24702331069762234,0.05734596583352741,148424960,765,770,1535
453,DXC,0.16568519812356522,0.08210370316712577,7943332864,1138,397,1535
454,EHC,0.25255360623781675,0.056644840878412615,8088169472,750,788,1538
455,REGN,0.2277701352836671,0.0609068927031591,51615125504,845,693,1538
456,CHKP,0.2778136233754263,0.05370284889629335,15548995584,669,870,1539
457,EXPD,0.31109981233519785,0.05078388817832451,18153160704,578,962,1540
458,NBLX,0.1537304046296136,0.0892956700566991,1308905088,1205,336,1541
459,EVTC,0.48335840284424997,0.043625391581332176,2784086272,333,1213,1546
460,VEDL,0.1240179796734223,0.12975207413933657,11770704896,1379,169,1548
461,NVS,0.3272593960460569,0.049047625691106975,196039966720,539,1010,1549
462,CMCO,0.231020192002638,0.06004279289889687,1245340160,832,718,1550
463,PATK,0.25390299271480926,0.05593187714067074,2059393664,745,808,1553
464,BHP,0.17817112613937078,0.07578734657399241,177630248960,1082,471,1553
465,GLDD,0.15382444576486787,0.0867104771676975,967444096,1203,350,1553
466,CCU,0.10873804862814554,0.3306413608241345,3327811584,1510,46,1556
467,PNR,0.6725162751202943,0.04044400446693544,10219578368,226,1331,1557
468,SON,0.24114615956780458,0.057346629429363485,6435190272,788,769,1557
469,CNC,0.20648078372268275,0.06448742615616693,36419354624,931,627,1558
470,SWM,0.2089704383282365,0.06409959077034504,1531203840,923,637,1560
471,PGTI,0.2730037823072074,0.05354561464043456,1538857344,686,875,1561
472,NODK,0.12985710211347254,0.11300102849421405,380330976,1346,215,1561
473,BRFS,0.12900893391898052,0.11387931866235883,3438083072,1350,213,1563
474,AMWD,0.24955370790418213,0.0558753523695498,1716771072,756,811,1567
475,SAH,0.18575777224633824,0.0700448713221541,2026523904,1044,523,1567
476,RRD,0.1643164613329375,0.08052788629344901,296358144,1152,415,1567
477,SYKE,0.21141634736457304,0.06265750422284092,1738266752,910,661,1571
478,VOC,0.20118658533083122,0.06551116279385225,58990000,970,605,1575
479,CHD,1.3637953651071273,0.03802355254900117,21533431808,122,1454,1576
480,FLO,0.2338095250314995,0.05807409674724226,5118905856,822,757,1579
481,TGLS,0.16078867183985332,0.08011521857641703,578295360,1163,420,1583
482,FLNT,0.37771223079720395,0.0459847492376065,344156576,452,1135,1587
483,NSP,0.3070586472568982,0.04930291733887704,3229355264,588,1003,1591
484,SEM,0.25682406950372455,0.05401997058818239,4603403776,734,857,1591
485,NPK,0.15613339519841743,0.08182823128380008,717699648,1193,400,1593
486,ALLE,0.46278055869530116,0.04281095898696745,11918595072,355,1241,1596
487,SMTS,0.14758069327605752,0.0855252001025528,503855392,1236,361,1597
488,FTDR,0.671875,0.03949746119872289,4636387840,227,1379,1606
489,GOGO,0.41776646968702125,0.04417414252696049,897651328,407,1199,1606
490,HUBB,0.40200453581095913,0.044583716289741775,10199627776,422,1188,1610
491,SPH,0.22636040701608287,0.058196865941076766,939813888,858,754,1612
492,INGR,0.16477416098914963,0.07605721003491739,6044642304,1148,465,1613
493,RCKY,0.17954172147087144,0.06894969018389974,402135456,1073,543,1616
494,VIOT,0.12502845710503407,0.10391685872297093,640464448,1372,244,1616
495,CHRW,0.40957650343864727,0.04396341943651972,12625040384,415,1205,1620
496,BAOS,0.30212359010327905,0.04891131152059361,172346112,604,1017,1621
497,SUMR,0.22754760153632425,0.05719324435739195,29865640,847,775,1622
498,LXFR,0.2106060606060606,0.06034492219794301,573727488,913,710,1623
499,LKQ,0.214046009464955,0.05958664993218964,13253338112,902,725,1627
500,BRO,0.5772646460282437,0.03979824532374013,13357860864,264,1364,1628
501,LMB,0.18239715904862153,0.0671647830928697,114679592,1061,567,1628
502,TKR,0.2100501650731038,0.06028743584496332,6167371264,919,711,1630
503,PBR,0.10431885238882387,0.20686926465667424,54933258240,1550,85,1635
504,HSIC,0.365581537930199,0.04498302084584191,9768121344,466,1171,1637
505,DLTR,0.18337218991187834,0.06624724882628326,27347603456,1049,589,1638
506,FMX,0.10803823229907354,0.16796525899732787,28529229824,1519,124,1643
507,RCI,0.16655480406835665,0.07137627890733278,24344088576,1134,510,1644
508,FSS,0.2638970157987127,0.05147250910581784,2349487616,707,938,1645
509,MDC,0.1437077250017239,0.08307889193525345,4215989248,1260,386,1646
510,FRA,0.11686720896361122,0.11681493225658571,460769696,1443,203,1646
511,SJR,0.19874724902657864,0.06253049528099673,13302839296,983,664,1647
512,EMR,0.3626639500827709,0.04488380337756894,54656733184,470,1179,1649
513,STN,0.22671671736457188,0.05636098631812295,4882292224,855,795,1650
514,ELP,0.13573384214980644,0.09026568819150033,31196669952,1319,331,1650
515,ABC,1.2534469662756518,0.03652115647185557,23743864832,133,1519,1652
516,BPMC,0.19444995593953354,0.06383225143945803,5390056960,1008,644,1652
517,MTEX,0.13668587287700987,0.08808776566500255,41657336,1309,343,1652
518,OLLI,0.27416328285482255,0.050474686819583885,5848417280,682,971,1653
519,TX,0.12063421161669492,0.10388355064357735,7734535680,1410,245,1655
520,WILC,0.09759276711437152,0.3631258166972512,320466368,1613,42,1655
521,NVT,0.376614261650758,0.04407086397816109,4832422400,455,1202,1657
522,SAFT,0.13967210814723405,0.08545903676056096,1274156032,1292,365,1657
523,NMIH,0.12739396066295522,0.09417853432448568,1989674496,1360,300,1660
524,MCO,0.6756158317187932,0.0383362848103442,57625358336,225,1436,1661
525,THC,0.1746384872080089,0.06767322773868398,5375720960,1098,563,1661
526,CMC,0.13506831561778598,0.08834351427988124,3750271232,1323,340,1663
527,GEF,0.18002354432672282,0.06593866803816266,2791745792,1070,594,1664
528,EBAY,0.2558139534883721,0.05191123367809169,42024345600,739,929,1668
529,PAYX,0.729484041756156,0.03792528756345399,34191425536,210,1459,1669
530,RH,0.34994030334743453,0.04493245437037944,12336879616,495,1174,1669
531,JNJ,0.469746045157959,0.04068873180315259,430737653760,347,1323,1670
532,REPX,0.15650940518929804,0.07487191298736162,450961856,1190,480,1670
533,WWE,0.2754229459408175,0.049539522941132515,4397683200,676,996,1672
534,MLHR,0.20244941427050053,0.060164216853181435,2535485440,959,715,1674
535,SLGN,0.18730633313183254,0.0640551048460112,4627896832,1036,638,1674
536,NS,0.15206137797996389,0.07662114982222112,2036088704,1219,455,1674
537,DPZ,0.7256550617911123,0.03780624232712121,14833392640,213,1464,1677
538,PRSP,0.6124497991967871,0.03839192183292334,4701379584,247,1433,1680
539,GMLP,0.13299026822551135,0.08653063268103149,242902112,1333,351,1684
540,ASX,0.11084350654992178,0.12074261212887272,16974932992,1494,191,1685
541,PLPC,0.1247945725673403,0.09237229998981866,331430848,1374,312,1686
542,HOME,0.11579793899620767,0.10778810967145809,1711520640,1459,227,1686
543,WVVIP,0.10786768515750497,0.13161283881779257,39310464,1521,165,1686
544,AUY,0.10614624330482644,0.13903968210357806,4375278080,1537,149,1686
545,ORAN,0.16729781300455013,0.06775475418924619,33030178816,1128,561,1689
546,ICFI,0.38337221727186344,0.0427576309241397,1701383424,447,1244,1691
547,YUM,0.544331170837195,0.03886679098345789,34055331840,286,1407,1693
548,HRC,0.4368589390095952,0.04102529441383583,7343619072,381,1312,1693
549,MCK,0.6949608610567515,0.03760243589673532,30760615936,221,1473,1694
550,FRTA,0.20482635155589424,0.058201288133537823,1556355072,941,753,1694
551,ZUMZ,0.1402483826454723,0.08080261925211095,1137262848,1284,411,1695
552,LND,0.09903719670052538,0.19071060045752822,327233856,1601,94,1695
553,HMLP,0.12233136615774884,0.0935744499320874,504622240,1391,305,1696
554,SSNC,0.6665138816134102,0.03770918924338906,18530920448,230,1468,1698
555,TARO,0.11859919835437509,0.09770437291348345,2813897984,1430,271,1701
556,DOOR,0.17402474916341298,0.06570999163271965,2982873600,1101,601,1702
557,DHX,0.4998102878204781,0.03926113950209671,157535280,317,1389,1706
558,USDP,0.16659170061557838,0.06688401003151799,173905280,1133,575,1708
559,BERY,0.18589369158878505,0.06244205847863804,8354899968,1043,668,1711
560,TSCO,0.22629042107905867,0.05408742684720581,20574547968,859,854,1713
561,KNL,0.2195268044324648,0.05529800849676759,807345024,888,828,1716
562,GRBK,0.14229545681640202,0.07732849268965841,1279212928,1270,446,1716
563,TV,0.10548483277509114,0.12498334954596865,5455496704,1542,174,1716
564,DOV,0.43591916921950835,0.04041761604304255,20007630848,382,1335,1717
565,VSEC,0.18307302461789443,0.06258124602866268,505506464,1059,663,1722
566,AAWW,0.10528922658410335,0.12444027339124576,1777682048,1545,177,1722
567,CDW,0.4937640309304066,0.039123142847829535,24013590528,324,1399,1723
568,AVY,0.3283963611758514,0.0446554589904973,15823517696,537,1186,1723
569,LEN,0.13367826329515706,0.08246371926876617,31642716160,1330,393,1723
570,LPG,0.10149604414863327,0.13748686855154954,543826368,1578,151,1729
571,LUMN,0.145884461065015,0.0746662378574857,14785538048,1248,482,1730
572,MYE,0.3028136229396104,0.04608646195339767,751752448,603,1131,1734
573,TPH,0.10861486650359294,0.1109519528850697,2554411008,1514,221,1735
574,SBH,0.15846016992565176,0.06741350385450184,2229204736,1171,565,1736
575,OCCIP,0.10819194029378806,0.1115118829850461,44855392,1516,220,1736
576,VEC,0.2844689217330079,0.04709536122022527,621344768,648,1089,1737
577,WMK,0.11613662697181314,0.09624041749701535,1485867648,1455,284,1739
578,WVVI,0.10786768515750497,0.11248485647184973,45772968,1521,218,1739
579,HOLI,0.1025335369805947,0.12643201397675718,777728192,1566,173,1739
580,GNTX,0.27952097818057675,0.04730259788185706,8706186240,665,1075,1740
581,HCSG,0.21175790424570912,0.05485534995043699,2113744000,907,835,1742
582,BAK,0.11646784156856546,0.0956786120828179,5972970496,1452,290,1742
583,G,0.27493921333688437,0.04749246694177127,8234555392,677,1069,1746
584,TRGP,0.13746289505849485,0.0774077866823461,7367264768,1303,443,1746
585,AON,0.5517306601097031,0.037744618610935206,53393240064,282,1467,1749
586,MANT,0.3732971374486139,0.04149642981571987,3498166528,460,1289,1749
587,SSP,0.14583391533051562,0.0729614627030041,1658688128,1250,499,1749
588,GLP,0.12102405923794907,0.08708751168248192,751672000,1405,346,1751
589,MKC,1.496218731820826,0.034225337207902676,23806701568,115,1638,1753
590,PEP,0.3444352371239164,0.042636211835568115,197912985600,507,1246,1753
591,SIFY,0.11069311554330741,0.10194195583071916,618319360,1495,259,1754
592,INSW,0.09669927039210419,0.15170845462159926,551859584,1621,133,1754
593,HEP,0.15223910694086917,0.06916221039828442,2029720064,1217,540,1757
594,TME,0.10570682388229515,0.11165596756606616,32963463168,1539,219,1758
595,VMD,0.23399930759523357,0.05138798523840209,409476224,820,941,1761
596,WES,0.12921788297233575,0.08058917262182749,8079492608,1348,414,1762
597,ALL,0.11251964240911672,0.0963624289655845,35687579648,1481,282,1763
598,BWXT,0.2809483304397137,0.046701751350966464,6394379776,658,1106,1764
599,WMT,0.2257669945208693,0.05279983298408243,393826402304,863,903,1766
600,CROX,0.3169130116884831,0.04392168643625475,5348403200,561,1207,1768
601,TGT,0.21697586603185026,0.05358154579034585,101942042624,895,873,1768
602,CNXC,0.28791337029829484,0.04583255436415568,7668272128,635,1138,1773
603,SMPL,0.566091892470815,0.036857661472946314,3013284352,273,1501,1774
604,TER,0.3764337038324313,0.040798244327698886,21949933568,456,1318,1774
605,MCY,0.13983617769920706,0.07451518390516428,3484484352,1290,484,1774
606,CCS,0.1211515820667198,0.0845678911366283,2199129344,1404,373,1777
607,PETS,0.23808133055621739,0.050297140379034655,695298944,803,978,1781
608,SHW,0.6666355641605822,0.03572409942508982,67361718272,229,1553,1782
609,PLTK,1.3677698731828023,0.033844028529236986,10735720448,121,1662,1783
610,SRT,0.23707323800412,0.05032340688260712,318995744,811,973,1784
611,DMLP,0.26616460838289896,0.04716468059229351,494187136,704,1083,1787
612,AM,0.13667599145119405,0.074990990283277,4268317696,1310,477,1787
613,SMG,0.5042877362417784,0.0374496557174071,13806013440,310,1479,1789
614,CRTO,0.172416978146148,0.061467273843441785,2164928768,1109,680,1789
615,WTS,0.2852319436288902,0.04575216154215205,3954693888,646,1144,1790
616,NRC,0.9949160805069991,0.034249607701422824,1227804800,157,1634,1791
617,FLT,2.4860597385002747,0.03278866500322301,23462502400,79,1713,1792
618,CP,0.1799064269884265,0.05946971852282652,50470219776,1071,729,1800
619,BKCC,0.10066059843933826,0.11402291366106501,263445376,1588,212,1800
620,TTEC,0.37688307603505455,0.04012638651826895,4786571776,453,1348,1801
621,CLGX,0.37214234159260245,0.04034700541236299,5860674560,463,1339,1802
622,NDAQ,0.3407651380795541,0.04129828084309924,24847941632,509,1294,1803
623,KNX,0.17289544351613043,0.06080400364725412,8231098368,1106,699,1805
624,LPLA,0.22596380073732378,0.051289173120592946,11535206400,862,946,1808
625,GFNCP,0.11509140218875633,0.0875186033752884,247816528,1465,344,1809
626,SUN,0.16984191325496553,0.061124239540935967,3294891008,1120,690,1810
627,OC,0.16314312441534143,0.0631068218831096,10027840512,1155,655,1810
628,KFY,0.16536873258102028,0.06227680385507601,3365703680,1141,671,1812
629,CODI,0.38934463272750935,0.039545156014728994,1599784960,440,1375,1815
630,LOPE,0.20229361912185362,0.05426045741475048,5165481472,963,852,1815
631,PH,0.4055221911201279,0.03900295220934553,40898023424,418,1404,1822
632,AIT,0.2353072276844357,0.04907323866469467,3656040704,815,1008,1823
633,LCII,0.22646236164442654,0.05064597694750408,3434380800,856,969,1825
634,MPLX,0.14019591426657735,0.06893810759573755,27142807552,1286,544,1830
635,PHK,0.1363118517385253,0.07051667763570565,930280448,1312,519,1831
636,LAWS,0.2429991398260537,0.04804554393292852,459583392,780,1052,1832
637,CLW,0.10127422352004248,0.10297695665611088,575684928,1584,251,1835
638,VST,0.10901883052527254,0.09027339989871522,8516850688,1508,330,1838
639,BEDU,0.09564524338630928,0.1156306322184218,709146880,1631,208,1839
640,CORT,0.24454969794196135,0.04735909139107011,2735715840,770,1072,1842
641,SAP,0.4566252220248668,0.03719967558532314,153379323904,360,1483,1843
642,TMO,0.3934671860952952,0.03884822550631828,183657185280,435,1409,1844
643,LL,0.1440909090909091,0.06638058449570466,743580608,1257,587,1844
644,VRSK,6.01591043017089,0.03082044347295986,29222817792,38,1807,1845
645,CCK,0.22495479204339963,0.05029846338330218,13619365888,869,977,1846
646,ESGRO,0.08014458397275516,0.29721520501826626,3926718976,1797,50,1847
647,URI,0.18657744538476678,0.055960088596125605,23290290176,1041,807,1848
648,AIMC,0.29347139790377574,0.04321058868559071,3864111360,625,1224,1849
649,ESGRP,0.08014458397275516,0.29097904615121545,4042856960,1797,52,1849
650,CIGI,4.589830860765414,0.03088227130103553,4075185408,47,1803,1850
651,MLR,0.13995921900408897,0.06769382748187776,517703456,1289,562,1851
652,CMPR,0.47779102217111447,0.03667067189832451,2788116736,341,1511,1852
653,UTHR,0.14297464679698085,0.06642676409649577,8512416256,1266,586,1852
654,ODP,0.12164865946378552,0.07671827825577393,2301549824,1399,454,1853
655,FONR,0.08896226273320056,0.13134034226131802,121208936,1688,166,1854
656,HSII,0.13219940446175976,0.07014604018879039,708367744,1336,522,1858
657,SUZ,0.10608468982129206,0.09118007202296805,16841508864,1538,322,1860
658,FFHL,0.1026491324756276,0.0946170293626517,33736128,1565,297,1862
659,SCCO,0.2048674149991866,0.052029510562220625,54764490752,940,923,1863
660,LEG,0.24567014664172349,0.04685274529125375,6185225216,768,1099,1867
661,MSI,0.38907327035996936,0.03852512948856203,32165595136,441,1427,1868
662,ESGR,0.08014458397275516,0.2279784785625691,5572460032,1797,71,1868
663,HWKN,0.20321130687690792,0.05225918415074769,701178176,950,919,1869
664,FCFS,0.1773644749669385,0.05698181099066205,2682256896,1087,782,1869
665,FLIR,0.29508680311681446,0.04254741273691099,7526499328,620,1251,1871
666,FDS,0.45033427327954506,0.03670312322798655,11709956096,363,1509,1872
667,UGI,0.1361824071766758,0.06782881031182918,8755096576,1314,560,1874
668,CHCI,0.16483657612534514,0.05935084464552263,40280280,1145,730,1875
669,GMS,0.17705866682453233,0.05654444759202575,1758852864,1088,789,1877
670,VRSN,1.1357480466866017,0.032333265326801086,23113224192,141,1738,1879
671,NLOK,0.4243668720054757,0.03716422710641603,12772709376,395,1484,1879
672,CRI,0.1475875349814403,0.06369247589561881,4053975552,1235,646,1881
673,HELE,0.42043446904799153,0.03725568702912801,5255831040,400,1482,1882
674,MTG,0.09317152855980676,0.10619612944830523,4698586112,1646,238,1884
675,MPX,0.25919542064328044,0.045217591109668824,548661504,724,1165,1889
676,RS,0.15233916858520483,0.06154358496260267,9828401152,1215,679,1894
677,CPSI,0.33044024170132624,0.03977406367123698,431208928,531,1365,1896
678,T,0.1572241866393759,0.060166235275972944,220792569856,1182,714,1896
679,ROCK,0.4718584366261842,0.03568359337116836,2812636928,344,1556,1900
680,WAB,0.30579587817401704,0.04107826714285142,14747110400,591,1310,1901
681,CIEN,0.17049266410906813,0.05671199176614401,8680168448,1117,787,1904
682,IBP,0.2936344677388984,0.04162903269272812,3423826432,623,1282,1905
683,OSIS,0.22094792346466907,0.04880058956131482,1740602496,884,1021,1905
684,NCZ,0.09979675358788721,0.09246818619870448,387429440,1596,310,1906
685,FERG,0.24006187161639597,0.04635549282702655,28211390464,791,1121,1912
686,BLDR,0.24792410391720393,0.04559381827748774,9691982848,760,1153,1913
687,ELTK,0.11910747957259585,0.07416064918549496,35918216,1427,489,1916
688,JOBS,0.07572866256145332,0.22424361484742514,4349080064,1844,72,1916
689,KMDA,0.10443199461472481,0.08500263178081242,271504640,1548,369,1917
690,NGL,0.1318424839484937,0.0666839826124077,280294560,1339,579,1918
691,CR,0.22951170759565961,0.047250651127199776,5455639040,841,1078,1919
692,CSAN,0.10142166444209771,0.08890027192228757,5950196736,1581,338,1919
693,FAST,0.3402147971360382,0.03877744868846122,28676845568,510,1414,1924
694,ITW,0.38339292808899483,0.037399827032070745,69609775104,446,1480,1926
695,UMC,0.07091876766462923,0.6701606410091625,22175014912,1902,24,1926
696,ELA,0.22498491468105594,0.047867182081480615,131661288,868,1059,1927
697,BMY,0.3033540761614027,0.04047145401652639,138637705216,598,1330,1928
698,IVZ,0.10158450840105891,0.08602324297464789,11970215936,1574,357,1931
699,NOA,0.09551752017869623,0.09431129917287927,332233088,1632,299,1931
700,J,0.2827292325801448,0.04162778625994499,17099804672,649,1283,1932
701,UCTT,0.22373434948285248,0.04789863401580022,2311686144,876,1058,1934
702,GFF,0.1435803490199322,0.06225954531073282,1535515648,1262,673,1935
703,GFN,0.11509140218875633,0.07592992122517986,352757248,1465,470,1935
704,GSL,0.09767740869448475,0.0905119697496539,529735744,1611,327,1938
705,ULH,0.15535033521756278,0.05855218458587594,707982848,1197,743,1940
706,PAX,1.6717948717948719,0.030256210181806485,2125029504,105,1837,1942
707,DELL,0.5882987651360748,0.03347964626035918,69791662080,259,1683,1942
708,CMCSA,0.2273146644142681,0.047005108794916727,250104037376,848,1094,1942
709,AVTR,0.9834908800426042,0.03116567451089928,17946658816,160,1790,1950
710,MDLZ,0.35218888342351207,0.03786699639398672,84815716352,489,1462,1951
711,SII,0.28063532134216895,0.04132368722618459,1012886272,659,1293,1952
712,IESC,0.25564293876453587,0.043629571926842865,1118464512,740,1212,1952
713,RL,0.14573752238950477,0.06076687110699629,9040359424,1252,700,1952
714,SNY,0.1980994532673783,0.05070942799256384,124940992512,988,965,1953
715,HUYA,0.0727641287407047,0.20801764094821254,4393847808,1871,82,1953
716,ESNT,0.10331073689073116,0.08226668756049685,5480687104,1560,395,1955
717,HCKT,0.3187479334288548,0.03907987880897935,524903936,555,1401,1956
718,CSL,0.21142530238640078,0.04809847965104779,8932896768,909,1049,1958
719,NSIT,0.20339733543712263,0.048966117817975684,3308818176,947,1012,1959
720,LOCO,0.17298365367343274,0.05403038451077633,613623488,1104,855,1959
721,WAT,0.5102452831605264,0.033961848772126234,18391214080,306,1656,1962
722,TU,0.18060680606806068,0.05287600208870635,27353868288,1066,898,1964
723,WIRE,0.11173243880475951,0.07495115505918813,1390738432,1486,478,1964
724,LSTR,0.33277014254139947,0.03830471642690103,6451492352,526,1439,1965
725,HNI,0.20584206455783385,0.048532515145820736,1707131264,934,1031,1965
726,CBD,0.08267339990053177,0.11893663437598281,1555338752,1767,199,1966
727,BUR,0.09305892111486971,0.09114040386542542,2203643136,1647,323,1970
728,QMCO,2.8712052706368687,0.028840011003062382,472004448,69,1902,1971
729,AOS,0.31445465555318086,0.03902895092952778,10889953280,568,1403,1971
730,LII,0.42646159223979724,0.03524198012470642,12328322048,391,1581,1972
731,OCCI,0.10819194029378806,0.07646264933892746,72563552,1516,456,1972
732,TPVG,0.09551192843691717,0.08859464128009047,471876960,1633,339,1972
733,YETI,0.707186642767308,0.03191747165088836,6567351808,219,1754,1973
734,CHTR,0.34301470588235294,0.03777524727845838,131667419136,508,1466,1974
735,TSQ,0.15343366199619443,0.05741536820812946,169242144,1206,768,1974
736,RBA,0.39971297711708603,0.03584419166092858,6768425984,427,1550,1977
737,UTMD,0.1963981259939539,0.05006693366109376,321592480,998,982,1980
738,CELP,0.19061361593414392,0.0509746842941317,26882234,1022,958,1980
739,CSV,0.11666494624924424,0.06950115219019588,644320064,1447,533,1980
740,ACCO,0.18140820482979342,0.05241941520843224,803989568,1065,916,1981
741,TAYD,0.0835327344731543,0.10755922135471378,40327176,1751,230,1981
742,NAT,0.08690465491490026,0.09709270723954073,520145184,1709,278,1987
743,JKS,0.14050985615942,0.06045903550658854,1799522688,1281,707,1988
744,MNST,0.533420051148924,0.03310676696394081,49766350848,293,1697,1990
745,MATX,0.13924998662600974,0.060860082409611174,3094323456,1295,697,1992
746,ACN,0.40188958896059895,0.03541639028555442,179614777344,423,1572,1995
747,POST,0.19605806216132746,0.04963817968095811,6971000320,1000,995,1995
748,CAH,0.3029116294908905,0.03916289702539292,17825648640,601,1395,1996
749,APH,0.3630037115588547,0.03638187795676237,40924094464,469,1528,1997
750,LLY,0.3319092451453537,0.03758546248697985,175303786496,528,1474,2002
751,HRL,0.24299807643603358,0.04326760801698056,25673232384,781,1221,2002
752,IEC,0.1615602527783831,0.05477905456228299,129504552,1161,841,2002
753,CECE,0.1996921929816176,0.04855246891698366,287401184,979,1028,2007
754,ARCE,0.13681311277379204,0.060491934778855734,1607269888,1306,706,2012
755,RBC,0.1981730826264903,0.04858410181467836,5827035136,986,1027,2013
756,NCV,0.09377444464490876,0.08460601980824255,524166912,1642,372,2014
757,FIZZ,0.33339367753666915,0.037067737260936956,4634265600,523,1492,2015
758,WSO,0.34791709755871425,0.03652814714538811,10342737920,501,1518,2019
759,RLGT,0.24053869757927038,0.04306169196655514,351771200,789,1230,2019
760,GLOP,0.08198940860645172,0.1041854408534105,142225904,1778,242,2020
761,NX,0.1742502087711837,0.05205712469333874,897520576,1100,922,2022
762,CINR,0.10760544669545001,0.07300098430561752,259129632,1524,498,2022
763,EHI,0.08457148037919536,0.09621953475402668,234009168,1739,285,2024
764,JBT,0.3766632548618219,0.03545624485414269,4250894848,454,1571,2025
765,LCUT,0.12170240958198787,0.06447940111774356,310464448,1397,628,2025
766,MWA,0.18214139204156982,0.05073613778406539,2233947648,1062,964,2026
767,MYRG,0.1924762944658353,0.04893911304297336,1265171328,1014,1013,2027
768,TM,0.07138976443355978,0.14870340223656558,213702590464,1893,135,2028
769,ECC,0.09205409615840421,0.08469528952709504,397965280,1659,370,2029
770,PKG,0.15456401283172938,0.05505946698770865,13114129408,1200,832,2032
771,AMKR,0.1303064941098227,0.061136439250759525,6157878272,1344,688,2032
772,RPRX,0.1565475095592907,0.054703999100528374,25237602304,1187,846,2033
773,TRMD,0.08278656000355174,0.09806012441861435,680733760,1765,268,2033
774,AMCR,0.23470051441748624,0.04346996382091138,18165827584,818,1217,2035
775,HNW,0.11124442319091518,0.06896571542100917,122825320,1493,542,2035
776,NIU,0.1760733144110547,0.05129175560937513,2730489344,1092,944,2036
777,EPD,0.12147061879256645,0.06410633889078676,49238712320,1401,636,2037
778,BZUN,0.06944096417409705,0.1726506860373099,2856429568,1923,116,2039
779,ATVI,0.29357417211668224,0.03869458096437483,75027169280,624,1418,2042
780,EML,0.132242456027652,0.060386243669081636,167945696,1335,709,2044
781,ETRN,0.0924776148659204,0.08267115954402895,3618984704,1654,392,2046
782,QD,0.06025469233811719,1.817908284392418,568330560,2038,10,2048
783,JOUT,0.16914058874347607,0.051973503625569815,1474257536,1125,926,2051
784,TPC,0.10745170170789725,0.0698768137896296,973473728,1525,526,2051
785,GOOS,0.27820844099913866,0.03937940028832516,4593654784,667,1385,2052
786,AGRO,0.08295094381073334,0.09559728985951485,948932736,1763,291,2054
787,WERN,0.12252172721391306,0.062477960840875806,3272293888,1390,665,2055
788,AIN,0.15189784199876522,0.05485376034852411,2743537152,1221,836,2057
789,NRG,0.10170357751277684,0.07447211113893931,9334847488,1571,486,2057
790,SNFCA,0.06567413509726518,0.19500779885606512,177953376,1966,91,2057
791,JLL,0.21890687751004015,0.04506520724275144,9235210240,889,1169,2058
792,SANM,0.11692051836678641,0.06488406486611192,2663289088,1442,616,2058
793,THS,0.173161699876565,0.05104173711327328,2949147136,1102,957,2059
794,TTC,0.3708447098024035,0.03499614381703829,11278576640,464,1598,2062
795,CTXS,0.7235125946800836,0.030023663453574514,17544503296,214,1850,2064
796,IRBT,0.20333419526331514,0.046502760517309887,3388659200,949,1115,2064
797,ICMB,0.0825628677693836,0.09526988913043487,77923440,1770,294,2064
798,CCF,0.22636879326286327,0.04389079275378739,1107872640,857,1208,2065
799,MGRC,0.12378373529577306,0.06133875101893369,1969826176,1381,684,2065
800,ECCB,0.09205409615840421,0.08111993535825199,421947904,1659,407,2066
801,CENTA,0.1343718269632783,0.058387549344921526,2909334016,1325,745,2070
802,STLD,0.1199891718395826,0.06327490412197154,10789067776,1419,651,2070
803,CENT,0.1343718269632783,0.058382224670623366,2909643264,1325,746,2071
804,CNI,0.13969446531430002,0.0570023933604915,83158540288,1291,781,2072
805,ACU,0.13248085262743395,0.05870508550025286,133187064,1334,739,2073
806,CBZ,0.2441845113933409,0.041139940489866085,1764571136,771,1303,2074
807,GPC,0.243310850361533,0.04127602444818487,16849174528,778,1296,2074
808,DCI,0.2382741823242867,0.0417308925904078,7417352704,801,1276,2077
809,LHCG,1.451888855710954,0.027548106320707953,6115708928,117,1961,2078
810,TXN,0.48073022312373226,0.03224408867133867,178223611904,336,1742,2078
811,PRAA,0.09582624069553704,0.07704371210755645,1664162688,1629,449,2078
812,MKSI,0.23989135448162763,0.04151511824479122,10680810496,792,1288,2080
813,ARRY,1.2296379404451452,0.0279519099123038,3747592960,135,1947,2082
814,NWL,0.2184959349593496,0.04436831163179469,11505203200,891,1193,2084
815,HNP,0.09219756915735888,0.07903432368697652,5545346560,1658,427,2085
816,ICLR,0.31291512407692906,0.03664548698897497,10544950272,575,1513,2088
817,JKHY,0.4868573197374278,0.03168158317353919,11732640768,329,1764,2093
818,MRCC,0.08434597995297098,0.0860754802025442,222408528,1742,356,2098
819,PGP,0.156061398089626,0.052742355136954425,121903792,1194,906,2100
820,SIMO,0.17612237620775018,0.04904578195619588,2278892544,1091,1011,2102
821,AME,0.43120821161860345,0.03268240580759213,29955459072,386,1718,2104
822,MIDD,0.34910171496473613,0.03463890007422184,9087436800,496,1609,2105
823,QCOM,0.3286709595693022,0.03546461458030178,158392467456,536,1569,2105
824,OMI,0.18317427109682574,0.04808867848700543,2750523136,1054,1051,2105
825,VHI,0.07176905361255423,0.10903944696963168,643213056,1883,224,2107
826,VRNT,0.5530050160439641,0.030336402210104058,3038020608,280,1832,2112
827,ADP,0.5964597275876453,0.029822180511447076,81056079872,254,1859,2113
828,CARG,0.2651103794871277,0.038853736454627565,2824224000,705,1408,2113
829,CRMT,0.11735894084891187,0.06222305494254177,962245952,1439,674,2113
830,AMN,0.3305012032229614,0.035137605654001904,3462105088,530,1586,2116
831,OXSQ,0.08304027098021323,0.08608247250776595,247452096,1761,355,2116
832,SPTN,0.09910433421660236,0.07056130188939456,701392000,1600,518,2118
833,OSK,0.17437836680817667,0.04881872476753075,8192451584,1099,1020,2119
834,V,0.8622268343303626,0.028095504709418934,483457466368,181,1939,2120
835,GGG,0.365091327559205,0.03400764142136686,12314937344,467,1654,2121
836,CAJ,0.06683154182876758,0.13096392926207898,23967641600,1955,167,2122
837,TDG,0.29318036966220523,0.037005689392412715,33166084096,627,1498,2125
838,NWPX,0.09131469869998059,0.0761108453245032,338400544,1666,462,2128
839,FOCS,0.5603926073724731,0.03001223545032083,3064326400,277,1853,2130
840,LANC,0.2983806425198018,0.036580928378819384,4913088512,614,1516,2130
841,BR,0.4842309182487408,0.03099120139905144,17911787520,332,1799,2131
842,POOL,0.48251616426230415,0.031036096365976675,14321673216,335,1797,2132
843,DLNG,0.07789235863647162,0.09231302022460713,99359152,1822,313,2135
844,BBU,0.12198335229654471,0.05866903678223562,3271188224,1394,742,2136
845,BSL,0.09676342311978137,0.07089807682634508,215667920,1620,517,2137
846,CNR,0.14285545557220578,0.05367350194595904,1776215168,1268,871,2139
847,TILE,0.10650682340617453,0.06570397038090174,741233664,1536,603,2139
848,MTZ,0.1845033586492139,0.0469897942063264,7224209920,1046,1095,2141
849,PCH,0.11973423354386886,0.05989424295971911,3797946624,1421,721,2142
850,HON,0.2607060298554245,0.03843865933353474,151966973952,717,1430,2147
851,AMSF,0.09941135505489898,0.0687021288765603,1222692096,1599,549,2148
852,ZBRA,5.111940298507463,0.023987327452185056,25963745280,42,2107,2149
853,LWAY,0.1268683640861767,0.05673811373973758,83484072,1364,785,2149
854,SENEA,0.08547064853341485,0.07978884950446881,456987872,1727,422,2149
855,STZ,0.19140556193589753,0.046036851815036126,45581647872,1019,1132,2151
856,SUNS,0.08210523870907803,0.08404584276332841,248278032,1776,376,2152
857,SENEB,0.08547064853341485,0.07904102895896617,464680000,1727,426,2153
858,AJRD,0.17132471728594506,0.04831612724589214,3802638592,1114,1041,2155
859,WNS,0.23947325638107625,0.03985935148595922,3569894144,797,1361,2158
860,SNDR,0.1118276417997948,0.06204093812039108,4515432448,1485,675,2160
861,TRU,0.7453732455595579,0.02777839686535094,17943318528,207,1954,2161
862,PANL,0.07720024203868886,0.08946117566355195,140047760,1828,334,2162
863,BG,0.13690129920496413,0.053975076033420506,11075222528,1304,859,2163
864,RDN,0.09039140860873789,0.07360883554390749,4497023488,1674,493,2167
865,TT,0.3083262400371431,0.035226826534198695,39698427904,586,1582,2168
866,TGP,0.07143971287264769,0.09725654284421588,1279921664,1892,276,2168
867,AVYA,0.262782401902497,0.03794724297764324,2460875008,711,1458,2169
868,ELMD,0.14179407314831655,0.05292566096748691,86954848,1275,895,2170
869,MSA,0.2581702524380215,0.038171775073939,5961493504,730,1446,2176
870,BSM,0.124635904910177,0.056215658467351,1848812672,1377,799,2176
871,HIX,0.10311290030149382,0.0649420892876308,584617920,1561,615,2176
872,AEIS,0.20470351183750418,0.042879211886298,4515668480,942,1235,2177
873,NVEC,0.1971334407487164,0.04471040114670461,354275584,993,1184,2177
874,UI,1.0172455971290666,0.026267697789289137,17454675968,153,2027,2180
875,CTB,0.09797608642386164,0.06690487119555996,2868173824,1609,573,2182
876,SHYF,0.3113819613725858,0.03470781211165506,1340041088,576,1607,2183
877,NDSN,0.3585245421110054,0.03280189778966732,11790797824,475,1711,2186
878,LECO,0.24682047108883362,0.038655416263389475,7254631424,766,1421,2187
879,ET,0.08685212906285664,0.07507601400809,21087223808,1711,476,2187
880,FB,0.26207665527586593,0.03757306526699397,872127463424,714,1475,2189
881,CNS,0.4733895777704018,0.030024703829989514,3148408576,342,1849,2191
882,OTEX,0.30415463780514734,0.03500188326226241,13400466432,595,1596,2191
883,PSB,0.22155977986150505,0.04110477996968745,4352011264,883,1309,2192
884,NATR,0.12068810535068204,0.056756882262077694,398488544,1408,784,2192
885,LPI,0.09655867599988756,0.0670958931511143,463615200,1622,570,2192
886,PHT,0.08832679637801169,0.07316776466357823,276240512,1695,497,2192
887,YNDX,0.05336026139927426,0.4657840115926712,22287267840,2155,37,2192
888,PAE,0.2641588230641462,0.037111883808894144,843212480,706,1487,2193
889,MGPI,0.2014185405052743,0.043169666344457944,1374641152,968,1225,2193
890,BWA,0.11829268292682926,0.057870869310511275,10875455488,1432,761,2193
891,TFII,0.23514338838485924,0.03950655719120138,7121722880,817,1378,2195
892,JELD,0.11970120376873639,0.0573020950185974,2789003520,1423,772,2195
893,LAD,0.15808626540453652,0.04864680020949839,10406141952,1174,1024,2198
894,DAC,0.08060791329840647,0.0809860608130258,1101772928,1789,409,2198
895,WLTW,0.3555785123966942,0.03273082120183012,30673410048,482,1717,2199
896,ZEPP,0.059937026828112694,0.14015268336117087,666576640,2052,148,2200
897,CARR,0.23027944817828086,0.039747851412124446,37109731328,835,1367,2202
898,RSG,0.20503830816792867,0.04202155648319032,32648775680,939,1266,2205
899,STLA,0.1497907949790795,0.05022021896542601,56720330752,1227,980,2207
900,MTX,0.11168109436785295,0.059907355275799656,2619720192,1487,720,2207
901,ARC,0.0879204296345694,0.07163278733886062,96710368,1699,508,2207
902,MEDP,0.6911215281943921,0.026989801069244524,6026734592,222,1986,2208
903,SONY,0.05938446069345736,0.14199255692481375,137208094720,2062,146,2208
904,NTGR,0.11329695008425435,0.05921487594645139,1237186304,1476,734,2210
905,FLS,0.1345028537841192,0.053223647273924896,5178470912,1324,887,2211
906,ROK,0.359165474328686,0.03228960499503152,30347814912,473,1739,2212
907,KAI,0.30289750519526665,0.03461481851582683,2138303872,602,1611,2213
908,GOLF,0.20238659662119135,0.04253285564595353,3222165504,961,1252,2213
909,IBM,0.20169172932330828,0.04262468910207228,120572633088,966,1247,2213
910,MCI,0.0760297216669162,0.08406815456655034,293186816,1841,375,2216
911,KLAC,0.4256585815159894,0.03052541605291375,53624266752,392,1825,2217
912,RHI,0.26935324989529297,0.03644985534071119,9002487808,694,1524,2218
913,SECO,0.07430138386840487,0.08530264544859366,175924976,1853,367,2220
914,CCMP,0.2869660215267346,0.03518096023977101,5709672960,638,1584,2222
915,LCI,0.10197365413973727,0.06317214024597055,219429024,1570,653,2223
916,SRLP,0.19513743276197398,0.043374555203095105,605302976,1005,1219,2224
917,KNOP,0.08343289849771746,0.07594939955569521,595032640,1755,469,2224
918,GRMN,0.2092331386360073,0.041134388226665104,25923389440,921,1305,2226
919,DMO,0.09025976478708463,0.06867213890984834,164083248,1676,550,2226
920,CPTAL,0.07099668384734976,0.09047646412444353,129643392,1898,328,2226
921,EQX,0.07977688749812181,0.07916030021281423,2058599808,1803,424,2227
922,AGCO,0.1891778649028821,0.04407148503583871,10842207232,1027,1201,2228
923,BPMP,0.14430550861777627,0.05042585687158797,1339075584,1256,972,2228
924,NP,0.11912689604143545,0.05605808046101943,880408512,1426,803,2229
925,ARW,0.16532704207589732,0.047097333443048964,8501110784,1142,1088,2230
926,SXI,0.15557848167149974,0.0484469711129631,1178829184,1196,1035,2231
927,JCI,0.25704870010984987,0.036925978033783904,43210018816,733,1499,2232
928,KR,0.1086874764949229,0.05977633886185591,27936577536,1511,722,2233
929,INFY,0.3207813603200753,0.033460010678546134,81178386432,551,1685,2236
930,AMAT,0.31299474605954464,0.03378722082763416,127683346432,573,1664,2237
931,PSEC,0.07969543196058938,0.07844754424670967,3080488192,1804,433,2237
932,PFL,0.10535223185953035,0.06089460309148473,400295072,1544,695,2239
933,BIDU,0.06902896142486112,0.09241741558843977,74725203968,1928,311,2239
934,PPG,0.2339770500979569,0.038678723837812984,35060899840,821,1420,2241
935,PRFT,0.41387817295715373,0.030325872124374695,2027782656,410,1833,2243
936,MFD,0.08841912500885302,0.0683838344826797,80089512,1692,551,2243
937,AMED,2.0887622467699756,0.022837465539249494,8794528768,93,2151,2244
938,WSTG,0.32585830521928955,0.03306179438640531,110824304,544,1701,2245
939,UVV,0.08538148715412648,0.07103559390166517,1436818304,1730,515,2245
940,PLAB,0.07227569864172155,0.08467479464163573,835728640,1875,371,2246
941,FLWS,0.17801946067147922,0.045245783888770166,1755410944,1084,1163,2247
942,ENS,0.15933256495763268,0.04725021586822063,3943851776,1168,1079,2247
943,AINV,0.07738632185295141,0.08007641025005237,934511744,1826,421,2247
944,MTD,0.6488464895160968,0.02652907340973406,27981228032,236,2012,2248
945,PVL,0.06520208221453186,0.09654259913025366,48180000,1970,279,2249
946,LW,0.18662944193244924,0.04374973829831341,11414226944,1040,1210,2250
947,MD,0.12291718944702171,0.05382336224167306,2140214528,1387,865,2252
948,RXN,0.2271129656800742,0.039041470111176604,5718745600,852,1402,2254
949,AEM,0.10969761018677948,0.05821411378322466,14699248640,1504,752,2256
950,SYNH,0.4544785848259373,0.028963831047465406,7967618560,362,1896,2258
951,MMP,0.11606169916584147,0.05616215239782742,10058881024,1458,800,2258
952,CPAC,0.06515628736631549,0.0958482425145301,673950848,1971,289,2260
953,CQP,0.11552855670662256,0.05614835348109323,20682217472,1461,801,2262
954,MRTN,0.11160732339231265,0.05722007375974704,1423290240,1488,774,2262
955,UNIT,0.1207871010488053,0.054024679227030546,2536999168,1407,856,2263
956,ALG,0.1785695279655154,0.0447607274395769,1871625088,1081,1183,2264
957,PCN,0.10771594006498607,0.05867586759523197,718358976,1523,741,2264
958,EGO,0.05896248096469525,0.12037887051688624,1961295616,2071,193,2264
959,PPIH,0.07701083856246435,0.07844412496291732,50214688,1832,434,2266
960,TRIT,0.9438009001762426,0.024086863721190545,627297088,166,2101,2267
961,TSLX,0.08387407932784112,0.07049593604498451,1570544000,1747,520,2267
962,GECC,0.08343063151641779,0.07130821458726917,77341976,1756,513,2269
963,SPLP,0.09734829065345761,0.06311531317591823,349875936,1616,654,2270
964,HAS,0.2326323374549956,0.03818591628446158,13369360384,827,1444,2271
965,PRGO,0.1420763395257153,0.04931862867264848,5397442560,1272,1001,2273
966,CX,0.11942616959064327,0.05431442328577995,10457589760,1425,851,2276
967,PFN,0.10051689277328463,0.06126084061977427,775914880,1591,685,2276
968,CXW,0.07092793495339958,0.08348575295361634,903235264,1901,379,2280
969,PLOW,0.21137648692076366,0.039639621291961434,1046644928,911,1373,2284
970,TEO,0.07161080505207676,0.08220701603387218,2446591744,1888,396,2284
971,WCC,0.15074285156476128,0.04770439945386142,4245694720,1224,1062,2286
972,AVID,0.43214437467541666,0.028812583728677375,960098496,385,1903,2288
973,IAG,0.05372166550559991,0.14552665266715267,1525754496,2148,140,2288
974,CRAI,0.13613850138592265,0.05031898812209872,560027776,1315,974,2289
975,HOV,0.10401236264667275,0.058961220260919316,675391872,1552,737,2289
976,TTEK,0.421601538762515,0.029064052864464444,7500399104,398,1893,2291
977,DECK,0.24212539742084746,0.036740897570651854,9558610944,785,1506,2291
978,III,0.17757776307081402,0.043934084830613666,207445552,1085,1206,2291
979,VMI,0.16482933389996668,0.045689418400374375,4975233536,1146,1146,2292
980,FUL,0.17148032766365798,0.04477709331454077,3287418880,1112,1181,2293
981,UNVR,0.14379354413159087,0.04846349167363866,3750570240,1259,1034,2293
982,SVM,0.11619421090965218,0.05476307465423641,917720640,1454,842,2296
983,JAKK,0.09888017619976383,0.06090523194943407,44001460,1602,694,2296
984,ESI,0.22500470721144794,0.038397738746304616,4660324864,867,1432,2299
985,NEM,0.09601839455148728,0.0622621474240027,49676644352,1628,672,2300
986,NUE,0.11331138133364226,0.055278091212893316,23838367744,1475,830,2305
987,IT,0.8048554376485563,0.023756474633118235,16599793664,193,2114,2307
988,AAP,0.14755845965064773,0.04735729372533282,11949155328,1237,1073,2310
989,TEI,0.06652293055925508,0.08681414839087502,361907936,1961,349,2310
990,IEX,0.31540596685601613,0.03221028924558677,16268939264,564,1748,2312
991,RMD,0.4914936490165073,0.026980802106776322,28682731520,326,1987,2313
992,SCL,0.12367499434508256,0.05160760071744043,2844987648,1382,932,2314
993,SFL,0.07657906448177758,0.07467019952208964,1031406272,1834,481,2315
994,IDT,0.36426472352165046,0.030067154193742656,568014592,468,1848,2316
995,BHC,0.2822085889570552,0.033768825886530726,11270890496,651,1665,2316
996,VFC,0.26319610859488163,0.03468523865996707,32902692864,709,1608,2317
997,NMRK,0.19054689821850135,0.04129762601127727,1919905792,1023,1295,2318
998,FSK,0.07204285915691527,0.07802865827521413,2598875904,1880,438,2318
999,PBA,0.08930947804228892,0.0641537226565901,16268658688,1685,634,2319
1000,NCR,0.1866904868244752,0.041600970308197184,5027842560,1039,1284,2323
1001,VPG,0.09025903105487666,0.06331757859624523,425315616,1677,649,2326
1002,VLT,0.08827947026292861,0.06435907458436729,91186152,1696,630,2326
1003,HALO,0.909902295334271,0.022744109220371157,6068839424,172,2155,2327
1004,APOG,0.13838195989187485,0.048543689061604056,1026263808,1297,1030,2327
1005,UFPT,0.14754830016049986,0.04706492288394179,373893408,1238,1092,2330
1006,FPAY,0.16300370843951018,0.044888741407014925,56646136,1156,1177,2333
1007,WOW,0.15653740400113778,0.04574454912053342,1174573184,1188,1145,2333
1008,TCPC,0.07706427429876797,0.07233566363861371,833582144,1830,503,2333
1009,KBR,0.1862689926842994,0.04135640913611386,5380596224,1042,1292,2334
1010,HWM,0.1641938674579624,0.044773003556192584,13788956672,1153,1182,2335
1011,STNG,0.05527085311019239,0.11544955388721229,1081112576,2126,209,2335
1012,DHY,0.08673285041446888,0.06461233969283951,249451872,1714,622,2336
1013,ATSG,0.0962991426021094,0.060225388698106064,1763318272,1625,712,2337
1014,FDUS,0.06998161614032622,0.07942802698277128,411770208,1915,423,2338
1015,CIK,0.08453713727519634,0.06571845819130064,175744464,1740,599,2339
1016,ATCO,0.0700255630535128,0.07912244279924778,3457808128,1914,425,2339
1017,CPLP,0.06507183755662778,0.0852321824019724,201501936,1973,368,2341
1018,DHR,0.5358851674641149,0.02559818051114157,161203060736,291,2052,2343
1019,MPV,0.07063803330999689,0.0779693978502065,137821520,1905,439,2344
1020,EGY,0.0940601876917524,0.060208680296773995,133778624,1638,713,2351
1021,INFO,2.4453326456936564,0.019520462374025077,42090491904,81,2273,2354
1022,MMAC,0.05943054284360171,0.09511915552935485,111228160,2059,295,2354
1023,QGEN,0.22626662782442522,0.03704496758109451,11566732288,860,1495,2355
1024,XIN,0.10928170747503965,0.05441911404879246,149271264,1506,849,2355
1025,HIO,0.06397455042898778,0.08547712009254908,485956928,1992,364,2356
1026,THO,0.21034653941788686,0.03823681314146086,7487725056,916,1441,2357
1027,KO,0.23650379506641367,0.03592751349992502,229600034816,813,1546,2359
1028,ROL,1.2210998430880797,0.02099968459146022,16968607744,136,2224,2360
1029,CNXN,0.1233341716982629,0.05031344284682932,1205611264,1385,976,2361
1030,LESL,0.4322909855716839,0.027133903022528043,4567176192,384,1980,2364
1031,AEGN,0.14286144646367271,0.0469470484614119,879186880,1267,1097,2364
1032,PAM,0.08588351431391905,0.06404766847404966,1375089792,1725,639,2364
1033,TMHC,0.07938332108533985,0.06796049518290963,4052960256,1808,558,2366
1034,GRFS,0.16218871023181075,0.043815508887719956,15603532800,1158,1209,2367
1035,FCRD,0.0655469729308534,0.08169414881713262,122244160,1967,401,2368
1036,RM,0.0823067825089654,0.06575705081998638,385757184,1773,598,2371
1037,FTI,0.11535211267605634,0.05267276057706656,3610167040,1462,910,2372
1038,PCM,0.12030218321360225,0.050929809416386036,135491840,1414,960,2374
1039,CTAS,0.353064591349659,0.029119362248001542,36800065536,486,1890,2376
1040,EFX,0.4623907094707335,0.02633560420686815,22230792192,356,2021,2377
1041,REGI,0.1253970924754341,0.049155220514609084,2855585024,1370,1007,2377
1042,LEJU,0.08259931506849315,0.06534079389256926,336725216,1768,611,2379
1043,DHF,0.0791342235726742,0.06710903479215673,227575104,1812,569,2381
1044,EC,0.053031080988567125,0.11260272671490082,26191273984,2165,216,2381
1045,PFE,0.20247471314916243,0.038606998280907766,201092759552,958,1424,2382
1046,GTS,0.08330576902522277,0.06460185080744334,617803392,1758,624,2382
1047,CGBD,0.07026752233711803,0.07569481277096637,750865664,1910,472,2382
1048,HAYW,0.40649717514124295,0.027287285585194776,3877218304,416,1971,2387
1049,RPM,0.21013733425654735,0.03768334952834685,11736591360,917,1470,2387
1050,KMPR,0.07449760817216841,0.06943354436987018,5302019584,1852,535,2387
1051,TDY,0.2907833578959302,0.03179034331593707,15366475776,631,1757,2388
1052,PNNT,0.06789823125717687,0.0769141683719816,402941056,1937,452,2389
1053,PZZA,0.41934499947711507,0.026911968729387406,3082590720,402,1991,2393
1054,THR,0.14496054254964189,0.04581382604988447,629088832,1254,1139,2393
1055,CTG,0.1169612174766814,0.051158138664000645,158005120,1441,954,2395
1056,TEF,0.11252628271745173,0.052116173313144575,24528869376,1480,920,2400
1057,BCOR,0.2426642877103979,0.034517039214022875,804621504,782,1619,2401
1058,DQ,0.21050844532697138,0.03711655904443215,4730457088,915,1486,2401
1059,GLAD,0.08044155382342676,0.06536879688521527,337900160,1791,610,2401
1060,CIX,0.08030417320747793,0.06548431304633712,237942432,1794,607,2401
1061,ICE,1.5376712328767124,0.018920831891672298,64571203584,111,2291,2402
1062,BKI,0.8362769834594898,0.0212102717403758,11650240512,188,2215,2403
1063,INS,0.24050848540340267,0.03458543699751448,354476544,790,1613,2403
1064,FRG,0.14808282284516472,0.04496915387933408,1472962432,1231,1172,2403
1065,GAINL,0.0709782517841931,0.07213439826750494,363626656,1899,504,2403
1066,FFIV,0.31834377574677625,0.030077430641944725,13002152960,557,1847,2404
1067,MSCI,0.6419190935595172,0.022484153319932584,36199645184,238,2167,2405
1068,CMTL,0.19806281250516822,0.03868092915467674,667495808,989,1419,2408
1069,KT,0.05625258167229419,0.0940638277840838,5895260160,2108,301,2409
1070,B,0.17519298005924472,0.040808416471959284,2546681856,1096,1317,2413
1071,SPNT,0.05587092861509138,0.09431192039581443,1650088320,2115,298,2413
1072,EBR,0.0522495903217063,0.1068923519634152,9864985600,2177,236,2413
1073,CRVL,0.2819073356921962,0.03172281393460157,1863330176,653,1761,2414
1074,OI,0.10209020902090209,0.05473485319765089,2289231104,1569,845,2414
1075,AES,0.0929900424485262,0.05752690047003224,18099154944,1648,767,2415
1076,IRCP,0.04660754956299138,0.14745523166558125,494124320,2279,136,2415
1077,CBRE,0.22465360085360753,0.035939569013170906,26365999104,871,1545,2416
1078,EA,0.2227342549923195,0.036124681169044985,40845762560,880,1536,2416
1079,TAK,0.12141314220788312,0.04891865014117559,54109470720,1402,1016,2418
1080,HTLD,0.1143789850864439,0.0512078524234275,1577516032,1471,949,2420
1081,SXT,0.15745701096100156,0.04279836948479725,3303487232,1179,1242,2421
1082,OFS,0.06654884449398872,0.07615263649276062,121618720,1960,461,2421
1083,WGO,0.18958975539150077,0.03910207865289894,2681967872,1026,1400,2426
1084,AAME,0.04846529858566177,0.12183019378354905,76557000,2239,188,2427
1085,CORR,0.062359774215567154,0.08040132462199263,97062168,2012,416,2428
1086,AGI,0.06708505272810637,0.07490129436398865,3199046656,1951,479,2430
1087,GBX,0.07403717995785979,0.0667472557090105,1488572928,1857,576,2433
1088,RCM,0.7786796536796536,0.020693488302065112,6401678336,199,2236,2435
1089,CSX,0.11682775056269032,0.049671183609491486,73633136640,1444,993,2437
1090,CRUS,0.17564147046080886,0.04024417394688074,4988967424,1095,1343,2438
1091,FKWL,0.3499409837193774,0.02801838177900996,237314144,494,1946,2440
1092,CPRT,0.30352898908097664,0.030138966965113274,26803073024,596,1844,2440
1093,PPL,0.08117897168053331,0.06285363360399078,22300565504,1783,657,2440
1094,CINF,0.0705075819486062,0.06948402861612195,16949459968,1907,534,2441
1095,USLM,0.12660835108967888,0.047288894411255514,788188672,1366,1076,2442
1096,HRZN,0.07691458174370507,0.06541455305337988,293400448,1833,609,2442
1097,GEO,0.07844593870389105,0.06455819810624708,755322304,1818,625,2443
1098,RFP,0.05246817758460105,0.0976552676689051,911577408,2171,272,2443
1099,ZTS,0.327264969421135,0.028701942987453155,74990788608,538,1907,2445
1100,CSWI,0.35252688296908746,0.027635386063562247,2144365056,488,1960,2448
1101,CBPO,0.12047580899639755,0.04833790896845572,4578159616,1412,1040,2452
1102,HURN,0.23012190802035545,0.03448793939084999,1212327936,836,1623,2459
1103,PTVE,0.10741766697445368,0.0515710754275653,2533359360,1527,934,2461
1104,SKY,0.23872545779070536,0.03382579433560951,2614447104,800,1663,2463
1105,AVNT,0.15572685957544727,0.04195883969205273,4397660672,1195,1269,2464
1106,MDU,0.08667697421689734,0.05835462019883367,6315511296,1715,749,2464
1107,WBT,0.2669794459338695,0.03167689453064777,2209365760,701,1765,2466
1108,JBL,0.16679068956656884,0.04032389121999786,7913077760,1132,1340,2472
1109,SCI,0.07324712068370612,0.0654239379364244,8741288960,1864,608,2472
1110,ARCC,0.0716005575972627,0.06650767404105766,8339520512,1889,584,2473
1111,MORN,0.5016515276630884,0.022594440678299348,10101757952,313,2161,2474
1112,NBIX,0.2115359772639194,0.03549400224149209,8909611008,908,1566,2474
1113,CMI,0.14588737982603386,0.04312204980045223,37833265152,1247,1227,2474
1114,GPK,0.1279336558396683,0.04644260082135502,5274788864,1357,1117,2474
1115,SMID,0.09997606319317003,0.05332644671713371,63466352,1594,883,2477
1116,PPD,0.3601339523663573,0.026679171946630165,13270745088,472,2006,2478
1117,UNP,0.13689917631112503,0.0449497790203042,147568263168,1305,1173,2478
1118,PRAH,0.45680082884749657,0.023560057441345233,10133407744,358,2121,2479
1119,NVST,0.424750499001996,0.0244969895907355,6983281664,394,2085,2479
1120,CMT,0.08785442402679361,0.05676738364985302,98661224,1700,783,2483
1121,ACA,0.12365550959007146,0.04672203308678408,3054282496,1383,1104,2487
1122,PAHC,0.13422472008362712,0.04529512641179021,995563648,1328,1160,2488
1123,MA,0.547858772989663,0.02134560656087933,368616767488,285,2207,2492
1124,AJG,0.3095500966050235,0.0286914501060743,25340999680,584,1908,2492
1125,STE,0.2758852648637607,0.03067644090204765,16540440576,674,1818,2492
1126,PLXS,0.12445036860735059,0.04651098120370241,2657958144,1378,1114,2492
1127,AOD,0.07245758850244655,0.0646928387976301,1020001280,1874,619,2493
1128,CBT,0.11469344608879492,0.04859960885529773,3021056512,1469,1026,2495
1129,BSY,5.878084266159922,0.014400001920776138,13158226944,40,2456,2496
1130,FSV,0.46046308200023855,0.023014010524525133,6662536704,357,2142,2499
1131,EAD,0.0862905806051816,0.05707633920140048,521041344,1721,779,2500
1132,KBH,0.08477524142320707,0.05753773354994815,4792282112,1735,766,2501
1133,CSWC,0.07896538738060187,0.061128363924477326,464310496,1813,689,2502
1134,AAPL,0.3033831282952548,0.02865589828005072,2147198042112,597,1909,2506
1135,PTY,0.10558674947980351,0.05066622973995132,2067431808,1540,968,2508
1136,BKEP,0.05914180265907777,0.07766647210691024,140991536,2066,442,2508
1137,SPXC,0.1562947461174138,0.04070142580439051,2667364352,1192,1322,2514
1138,AROC,0.07655441264316618,0.061349895985301967,1451485952,1836,682,2518
1139,ABST,0.5934177763915395,0.019854464661056555,695553024,257,2262,2519
1140,TRP,0.0834159732103077,0.057817147182705655,46468444160,1757,762,2519
1141,MTCH,0.7704784202581559,0.018100838142710858,38156369920,202,2320,2522
1142,MAT,0.17951081029034213,0.03813117186308251,7161856512,1074,1448,2522
1143,TRTN,0.07570626590663058,0.06146464035643296,3694680576,1845,681,2526
1144,FNF,0.04982849849770002,0.09308909159127003,12552252416,2219,307,2526
1145,TEL,0.20236576597471878,0.03552168329142134,42847924224,962,1565,2527
1146,ERII,0.19986799130563426,0.035839109395988875,1058628480,978,1551,2529
1147,SWKS,0.27203513909224014,0.030171030774823446,30909425664,689,1842,2531
1148,HUDI,0.17879170497832655,0.03809665252709618,71793744,1080,1451,2531
1149,PAG,0.10541696247255196,0.0498311277788456,6585776128,1543,989,2532
1150,UEIC,0.14199332459536074,0.04207649521507817,763339392,1273,1262,2535
1151,DSSI,0.05319391332762229,0.08403365221302234,440792704,2159,377,2536
1152,DORM,0.17061283385930417,0.038614076992702875,3286930432,1115,1423,2538
1153,CMRE,0.06386334905981833,0.06888877370008205,1226465280,1994,545,2539
1154,GAIN,0.0709782517841931,0.06392782445945741,434653440,1899,641,2540
1155,UNFI,0.08805350507709132,0.05476280927370122,1959663872,1698,843,2541
1156,EMN,0.12774243801116447,0.04467355140089429,15232455680,1358,1185,2543
1157,PRTH,0.372932659302253,0.02460017986969772,474138912,461,2083,2544
1158,PDCO,0.15696486032502008,0.039952122563139444,3061396736,1185,1359,2544
1159,ACIW,0.27737305404221596,0.029562795347461028,4541634048,670,1875,2545
1160,CERN,0.20272569908609947,0.035021629737194394,21840369664,955,1595,2550
1161,FL,0.07045759142255409,0.06390077443293342,5794928640,1908,642,2550
1162,ADV,0.33916071056406233,0.02594622141458878,3996547328,514,2037,2551
1163,LNG,0.08734483314525229,0.05444794262924389,18674946048,1706,847,2553
1164,ADI,0.3759305585363236,0.024105755228661655,59653750784,457,2099,2556
1165,ESE,0.2596341224755305,0.030293249096873004,2865969664,721,1835,2556
1166,CASY,0.14585776437280581,0.041117767525115805,7961382400,1249,1307,2556
1167,BLKB,9.888165391502524,0.012368513435417498,3413791488,26,2534,2560
1168,IAA,0.200836820083682,0.03511501758338586,7587387392,973,1589,2562
1169,GLOG,0.06420542960251699,0.06701302770282393,552118272,1990,572,2562
1170,NOK,0.0973849795070138,0.05119860087299336,23114119168,1615,951,2566
1171,CTS,0.13626206394605697,0.042400566343616906,999242048,1313,1254,2567
1172,BAX,0.1596802992942777,0.03899596407071243,42833829888,1165,1405,2570
1173,EDUC,0.1457627048484773,0.040794861169341855,141465440,1251,1319,2570
1174,CVCO,0.15217585641336254,0.03998568346476229,2143354624,1218,1354,2572
1175,APEI,0.08848744112758598,0.05331902875349805,651706816,1690,884,2574
1176,YGMZ,0.25369301531604155,0.030311043689430398,78280120,747,1834,2581
1177,VRTS,0.05537202956469425,0.07641109848907357,1856347776,2124,457,2581
1178,ADBE,0.6351371608454505,0.017580841827715608,235849973760,239,2345,2584
1179,PLBY,0.8948821405818645,0.015625351445263804,883996736,174,2415,2589
1180,CCAP,0.06372950978192761,0.06593341142019749,509548256,1996,595,2591
1181,CRH,0.09141648123153248,0.05191254155497446,37570498560,1665,928,2593
1182,FIS,2.1236263736263736,0.01314799851131319,91231436800,91,2503,2594
1183,AUDC,0.1692611211397651,0.0376404903082657,965024640,1123,1471,2594
1184,CME,0.7445344918818058,0.016363280075945823,73369501696,208,2389,2597
1185,SRCL,0.25929348942287944,0.029578365495539886,6224844800,723,1874,2597
1186,OKE,0.09297519084005884,0.05127306199924034,22756481024,1650,947,2597
1187,HVT,0.08272608753156943,0.05487227661253196,714139200,1766,834,2600
1188,CC,0.08700420398464631,0.05297889518128972,4709709824,1708,893,2601
1189,NMFC,0.06467277718665658,0.06460431548959096,1245198976,1978,623,2601
1190,KTB,0.178865889824162,0.03640475398829216,3047026944,1079,1526,2605
1191,COST,0.20554209466607515,0.033673133189074084,158785634304,937,1670,2607
1192,VRA,0.07077097923187789,0.06050528910622965,355196128,1904,705,2609
1193,IPLDP,0.043577483155835685,0.09787981445275551,354861056,2343,269,2612
1194,AGD,0.06870736852645422,0.06134561936260272,142688944,1930,683,2613
1195,TREX,0.40583497325877177,0.02186205677015631,10976576512,417,2198,2615
1196,FORR,0.4456126819169018,0.020246880392320466,808384192,369,2249,2618
1197,ISDR,0.14847331967612915,0.039321812920558676,92389504,1230,1388,2618
1198,JNPR,0.13584687128531805,0.04119413789490865,8314500608,1318,1300,2618
1199,PKX,0.04298670331153308,0.09814362079644177,23386632192,2351,267,2618
1200,PFLT,0.06271098395954383,0.0650390270440697,476509120,2007,613,2620
1201,DEO,0.2523837041317538,0.029617053129180358,99995574272,751,1871,2622
1202,TRMB,0.42283030795629006,0.020895171556681164,20042090496,396,2228,2624
1203,HLNE,0.33583996769355023,0.02380579162038098,4834416640,519,2113,2632
1204,UNF,0.11682315997216193,0.04457127767692386,4140085248,1445,1189,2634
1205,BOOT,0.20833121235259183,0.032853468968836265,1890236288,925,1710,2635
1206,MSFT,0.2965030345105592,0.02643835293463973,1884800679936,619,2017,2636
1207,WY,0.10272768699954431,0.04730743201968307,27576281088,1564,1074,2638
1208,AZPN,0.3185238633916438,0.024387475600631953,10313845760,556,2086,2642
1209,OFLX,0.5804983229516052,0.016624581415831462,1604990336,262,2381,2643
1210,GNRC,0.35160844023672067,0.022792038196337856,20494073856,491,2152,2643
1211,AZN,0.3046863522844131,0.025712214934742787,129045102592,593,2050,2643
1212,NFG,0.0699356881028375,0.059488586198396316,4572756992,1916,728,2644
1213,XLNX,0.3091678997882756,0.02543034353488804,32361543680,585,2060,2645
1214,LRCX,0.27441519013895943,0.027465419954199682,94144937984,680,1965,2645
1215,WM,0.1668465494254333,0.03658768396195052,55882448896,1131,1515,2646
1216,LMAT,0.2754267373437728,0.027283724847879987,1003995136,675,1973,2648
1217,AZRE,0.05302549584289224,0.07460783144060135,1344482816,2166,483,2649
1218,HIHO,0.056715511350694706,0.06880522263877885,14695734,2103,547,2650
1219,BCPC,0.2692366259648054,0.02764260256273245,3915317760,695,1959,2654
1220,HAE,0.2680338611937767,0.02776175560351875,5808920576,698,1956,2654
1221,TRS,0.1316573958867013,0.04088513922291836,1345361280,1340,1315,2655
1222,ENLC,0.08086342880863429,0.05371191556075707,2161111552,1787,869,2656
1223,SHC,0.2872645425922728,0.026387641240420947,7341255168,637,2020,2657
1224,MXIM,0.27391218268282735,0.02720912455476379,25555027968,683,1975,2658
1225,VRT,0.22427900737759893,0.031226055106439225,7440005632,873,1785,2658
1226,GPX,0.12184419994267193,0.04205589040615488,285045728,1396,1263,2659
1227,CNSL,0.07150948917516464,0.05727222287630175,527559264,1890,773,2663
1228,PAGP,0.07629549937242244,0.05534171430439814,1835188992,1839,825,2664
1229,HLIO,0.25616302739014374,0.028277779612283345,2216214272,738,1928,2666
1230,ENB,0.08040799317365507,0.053546986127961944,74756718592,1792,874,2666
1231,FAMI,0.07276560954910719,0.05627632727614021,29514668,1870,797,2667
1232,SWBI,0.11286118954511798,0.04447762623075677,956886848,1478,1190,2668
1233,TIXT,0.41894925909295017,0.019702880594424512,7598096384,404,2266,2670
1234,PPC,0.10934407722001041,0.04511653063970427,5880879104,1505,1166,2671
1235,BIP,0.10142241811078834,0.04706971765934862,16292290560,1580,1091,2671
1236,SYK,0.26859541845395635,0.027137965985244886,93117857792,696,1978,2674
1237,FELE,0.1948581009376881,0.033726669903379455,3684207360,1007,1667,2674
1238,INT,0.10371784925702691,0.04639834298820381,2230823424,1555,1119,2674
1239,JACK,0.11670360610574029,0.04306267259314987,2600326144,1446,1229,2675
1240,HEI,0.345164838785252,0.02234565019535261,16314024960,504,2174,2678
1241,AVO,0.10979133226324238,0.044904910307299796,1398318720,1502,1176,2678
1242,AVGO,0.45669460563077585,0.01801386448084756,196989386752,359,2324,2683
1243,PSA,0.21062684750453703,0.03158489510781944,44697300992,912,1771,2683
1244,ACGLO,0.06014864345602073,0.06398655603560063,15603462144,2043,640,2683
1245,HMC,0.04442095624125312,0.08574170138726452,51103956992,2324,359,2683
1246,AWI,0.19234913793103448,0.033655456945640726,4549446144,1015,1671,2686
1247,EVV,0.08098821246195093,0.052858326840599566,1477389824,1785,901,2686
1248,WING,0.9832274284927072,0.012520093459553874,4083881216,161,2526,2687
1249,ACGLP,0.06014864345602073,0.06373056229049481,15717597184,2043,645,2688
1250,FSKR,0.05945288753799392,0.0641910409054108,3528885504,2058,633,2691
1251,DCO,0.12016416335105837,0.04170413513040515,750928512,1417,1279,2696
1252,ORCC,0.060875728553861266,0.06246792472629247,5561822208,2031,666,2697
1253,FLY,0.0554711852454967,0.06672467369120938,514825760,2123,577,2700
1254,MKTX,0.40538610717421364,0.01927706890453192,19796244480,420,2281,2701
1255,ATR,0.18820359847810678,0.033681765090588914,9478777856,1032,1669,2701
1256,MANH,0.5532268860283062,0.01535464344303462,7436155904,279,2424,2703
1257,ROLL,0.20307496842987832,0.032037834831485985,4912026624,952,1751,2703
1258,LBTYA,0.053572286320886134,0.06821225175601393,14809870336,2150,554,2704
1259,ACGL,0.06014864345602073,0.06258470031214391,16239924224,2043,662,2705
1260,LBTYK,0.053572286320886134,0.06813718752700011,14845895680,2150,555,2705
1261,INTU,0.3804195804195804,0.019974018196610214,109823524864,450,2256,2706
1262,CAI,0.06821559987882206,0.05730232475475107,776255872,1935,771,2706
1263,GLPI,0.08655641465632168,0.04982814493375845,10179512320,1717,990,2707
1264,TNP,0.042317297128238854,0.08703952455434465,187058768,2363,347,2710
1265,ADUS,0.24553974814957225,0.028031023725490965,1629792384,769,1945,2714
1266,MLM,0.1320683536167894,0.039514578106779275,21002485760,1338,1376,2714
1267,HUBG,0.12757407434460485,0.03996050387515302,2259559168,1359,1357,2716
1268,JBHT,0.15662983061577404,0.036318458364242245,17896912896,1186,1531,2717
1269,CF,0.10439744880832494,0.04501627614849287,9882224640,1549,1170,2719
1270,IDXX,0.4907592762310425,0.016169257655850998,41896038400,327,2395,2722
1271,SAR,0.05975581739821977,0.06243640201434779,287962592,2054,669,2723
1272,SSTK,0.24183790768507873,0.028091717888399714,3249634048,787,1940,2727
1273,SSRM,0.049550369632911845,0.07199667605921406,3342741504,2222,506,2728
1274,AXTA,0.1218658557576453,0.04042548402048678,6879422976,1395,1334,2729
1275,VSH,0.08457233347093736,0.049740508836171336,3682467584,1738,991,2729
1276,GB,0.4192361095805876,0.017952267195995616,2426702848,403,2328,2731
1277,AAON,0.2520584006537232,0.0271346134183046,3612193536,752,1979,2731
1278,A,0.2801180574188355,0.025024188054187588,39409635328,662,2071,2733
1279,ESEA,0.09415302906926484,0.04687996678319806,76786384,1637,1098,2735
1280,VMW,0.21846981470412433,0.030015351751173484,64381612032,892,1852,2744
1281,GIII,0.07969331394673641,0.051463299806164854,1442106368,1805,939,2744
1282,HBP,0.08603491271820449,0.048687676598670446,103639280,1723,1023,2746
1283,ACP,0.06436355400582669,0.05773108498925517,202212368,1985,764,2749
1284,DIT,0.06775089369861878,0.05590449640349573,65331712,1940,810,2750
1285,MDT,0.23927160437763953,0.027828879245517368,162617688064,798,1953,2751
1286,EXLS,0.1804452192747852,0.033465030383075606,3061586944,1067,1684,2751
1287,VRTV,0.06951202558042541,0.05527950200686704,659988800,1922,829,2751
1288,BCEI,0.06010946218087065,0.06063191302190488,1049036800,2047,704,2751
1289,SKM,0.04312001868064166,0.08159412627983942,17748699136,2349,402,2751
1290,INMD,0.2810017784190202,0.024172812919311573,3047251968,657,2095,2752
1291,LBTYB,0.053572286320886134,0.06570768071166368,16056325120,2150,602,2752
1292,FTS,0.07246004566210046,0.05337900097607239,20553521152,1873,881,2754
1293,RNR,0.0639987128011691,0.057802969541853884,8359915008,1991,763,2754
1294,CRS,0.06777213860693035,0.05553980218726053,1978190848,1939,818,2757
1295,TAIT,0.07862737784408802,0.05136308064646918,26153576,1816,942,2758
1296,RYAAY,0.12399093768559048,0.03944988994106362,22053226496,1380,1381,2761
1297,EW,0.2720208324722027,0.025007900794244118,52325666816,690,2072,2762
1298,PPR,0.0670882521060367,0.055844433345416784,573432256,1950,813,2763
1299,WDFC,0.3896910025888563,0.018013749638959853,4169973504,439,2325,2764
1300,TMX,0.2127016129032258,0.02978291613537332,6330598400,904,1861,2765
1301,MAGS,0.06729488629224777,0.05552698802375344,101877600,1945,820,2765
1302,AER,0.05928942562641625,0.06073395628533177,7770476544,2065,701,2766
1303,IPAR,0.19841343989672072,0.031337063495716716,2239765248,985,1782,2767
1304,TPL,0.3938182048704504,0.01775534436575855,12507350016,433,2337,2770
1305,JHI,0.08232962732937714,0.04943052849994086,159860896,1772,998,2770
1306,ENSG,0.11610894172309821,0.040842291252425784,5025440768,1457,1316,2773
1307,BSX,0.24722792607802874,0.026459543164640425,55020146688,762,2015,2777
1308,BDX,0.23461502653384228,0.02765054130051454,70902456320,819,1958,2777
1309,CPTA,0.04714690220475811,0.07131635409255667,44054888,2265,512,2777
1310,TRIN,0.06658114457071745,0.05552913377038585,388569056,1959,819,2778
1311,UGP,0.061082202035633144,0.05828230772752279,4054234624,2028,750,2778
1312,ATC,0.2317151274497246,0.027854588623701406,4263141632,830,1950,2780
1313,EIG,0.09095351536253131,0.04655561581264787,1173225216,1669,1112,2781
1314,ECL,0.2727331616706343,0.024146980639081515,61409509376,688,2097,2785
1315,BDC,0.1279914000450864,0.03843977282311922,1981877760,1356,1429,2785
1316,BCSF,0.05912528835908048,0.06011536406075683,1003943808,2069,717,2786
1317,WWD,0.14785636349670642,0.03571718491988162,7647237632,1233,1554,2787
1318,NSL,0.07400812592035343,0.051691968842402465,218927072,1858,931,2789
1319,EGAN,0.26143744704885624,0.024922393966958088,291606464,715,2075,2790
1320,SCM,0.058001787773191586,0.060638029001240774,256240896,2087,703,2790
1321,FSM,0.07526460089039803,0.051312578473314316,1283338240,1848,943,2791
1322,IRM,0.12850793043398154,0.03821557734537084,10881592320,1351,1442,2793
1323,CANG,0.03374836932480852,0.09829473971997547,1253075840,2527,266,2793
1324,SPNS,0.2397683834562423,0.026788634181587938,1728425344,795,2001,2796
1325,HYB,0.07011595697271035,0.053289719709091264,215461264,1912,885,2797
1326,XPEL,0.443088248761122,0.015451179642651258,1516760064,376,2423,2799
1327,EFT,0.07317211781040633,0.05152175096126452,563672704,1865,935,2800
1328,WRK,0.07870050360422633,0.04994758768373908,13911062528,1815,986,2801
1329,GLT,0.07485501663499865,0.051189593535196073,758345984,1850,952,2802
1330,VTA,0.07281334078761997,0.05157442638571735,720492288,1869,933,2802
1331,AKAM,0.13761380770336276,0.03683745283433795,16728417280,1301,1502,2803
1332,EXP,0.12064087253534653,0.03917477453256127,5756739072,1409,1394,2803
1333,MCD,0.16573719268612164,0.033704209144078234,173427490816,1137,1668,2805
1334,ALV,0.13060825892857142,0.03782731933357449,8296354304,1342,1463,2805
1335,BBSI,0.08615864994994518,0.04714528079586816,541256128,1722,1085,2807
1336,ERIE,0.22703435422265758,0.02776540227429367,11618816000,853,1955,2808
1337,DSGX,0.47932675430042515,0.013856407364687563,5350474240,339,2473,2812
1338,WMS,0.28993619768516227,0.022301693879232795,7767454208,633,2179,2812
1339,VMC,0.14214440724372518,0.036021816065342195,22408275968,1271,1541,2812
1340,TMUS,0.11891537063219551,0.03933968550300798,161588854784,1428,1386,2814
1341,IQV,0.4336188436830835,0.015043394295532047,38660231168,383,2433,2816
1342,DMS,0.2858021801645155,0.022344818768168708,737123328,642,2175,2817
1343,ALTM,0.10792454375312426,0.04124902315995945,903792832,1520,1297,2817
1344,ACH,0.06450912555776019,0.05478483808051244,9562033152,1979,840,2819
1345,ERC,0.07423730672133501,0.050684995045910126,352776544,1854,966,2820
1346,WMB,0.08113333122048616,0.048367583652691185,29300011008,1784,1038,2822
1347,JPS,0.07833620162851457,0.04930463104344962,1972687232,1820,1002,2822
1348,PAYA,0.5933253946444383,0.011026597519625675,1462083328,258,2565,2823
1349,GTEC,0.15471387521477883,0.034457093028311035,123037736,1198,1625,2823
1350,TITN,0.08298999531765326,0.04750375514679803,587505664,1762,1068,2830
1351,KAMN,0.10686529353938569,0.04121639243720106,1455056128,1533,1299,2832
1352,MAV,0.05715815595386557,0.058971523557861755,284637088,2099,736,2835
1353,ENTG,0.26063210367980666,0.023653650885195783,16044470272,718,2118,2836
1354,NESR,0.1150773223965835,0.03967883518813272,1136719872,1467,1370,2837
1355,ENBL,0.04823874755381605,0.06607339388633314,2931399680,2245,592,2837
1356,EMD,0.0672998509344559,0.0529282930494216,820678464,1944,894,2838
1357,GLNG,0.06010549387096475,0.05642775995622998,1162798464,2049,793,2842
1358,BKH,0.07193666859935116,0.050885519474250004,4235051264,1882,961,2843
1359,VAR,0.24753405354626584,0.02427103319631096,16282100736,761,2089,2850
1360,ANET,0.19306925009362555,0.030215055587556907,23500210176,1011,1839,2850
1361,THRM,0.13527711735311285,0.03633846498338779,2487287040,1321,1529,2850
1362,POWL,0.06433981833610963,0.05384923745523471,387022944,1986,864,2850
1363,MITK,0.20624443455031166,0.028413874673653715,647140992,932,1920,2852
1364,PAA,0.06428066870732281,0.0537893775561323,6758406144,1987,866,2853
1365,AMOT,0.13890072685086535,0.03563905294466145,507096064,1296,1558,2854
1366,TOL,0.06605963286484953,0.053047389498366994,7314797056,1965,890,2855
1367,BLL,0.1714324434205177,0.03223856167513453,28387723264,1113,1743,2856
1368,CAE,0.11017080230682547,0.039957040959146234,8631701504,1498,1358,2856
1369,IP,0.08550111912459588,0.04614349569883049,21582354432,1726,1130,2856
1370,PTSI,0.07653426702639736,0.048840966385338754,343725408,1837,1019,2856
1371,SLRC,0.05660316769600184,0.05824049293524365,790276992,2105,751,2856
1372,AIRT,0.10153588383133202,0.04155229120430791,69164400,1575,1286,2861
1373,DSP,0.7038186697707505,0.00845922948299717,2482956800,220,2642,2862
1374,PRPL,0.17278008902689002,0.03179596112922012,2189432832,1107,1756,2863
1375,USAC,0.0844094121569967,0.04633103252977344,1486953344,1741,1122,2863
1376,RMRM,0.020640334254954925,0.17390952774990212,123138136,2750,113,2863
1377,MMI,0.09095568359358855,0.04425358890935096,1366011008,1668,1197,2865
1378,ADSK,0.5799160189404092,0.009862767557747855,62693470208,263,2603,2866
1379,AWF,0.0628447570731395,0.053965176198258406,1032169472,2006,860,2866
1380,ABT,0.25363113181693614,0.023492385039601157,212778467328,748,2124,2872
1381,PRI,0.04490711925834941,0.06835609415122587,5959806464,2320,552,2872
1382,OPCH,0.2553405847554144,0.02318781044396686,3326571008,741,2137,2878
1383,FVE,0.05945754221890857,0.05547868119218404,195773744,2057,821,2878
1384,BMI,0.25507013241785187,0.02315628947176558,2814561792,742,2138,2880
1385,WEN,0.10726682760595453,0.04011113333527524,4764098560,1531,1349,2880
1386,DSKE,0.08379099325278519,0.04601291698042766,550143680,1748,1133,2881
1387,BLBD,0.20086468110265315,0.02864757725376421,717391424,972,1910,2882
1388,PHG,0.1930522130375641,0.0296337475268577,52994097152,1012,1870,2882
1389,KMI,0.08034050385367537,0.04695704982009118,38338830336,1793,1096,2889
1390,SHLS,0.8191660719747171,0.006801026566613626,5537983488,192,2698,2890
1391,MHK,0.09162951558859755,0.043154904946689,13801996288,1664,1226,2890
1392,HPS,0.05976909768274824,0.05481654250463915,582913344,2053,839,2892
1393,QUAD,0.07955641272902604,0.04709778795082893,207074624,1806,1087,2893
1394,AQUA,0.16973779988088755,0.03153475870322883,3211432960,1121,1774,2895
1395,CNTY,0.05309710294850112,0.059242463486587627,335983360,2162,733,2895
1396,FLEX,0.12232583482948178,0.03682000982841365,9137343488,1392,1504,2896
1397,GPN,0.33609504199758145,0.016633623208148922,61874466816,518,2380,2898
1398,KE,0.08734257863104467,0.044399850437699805,627171904,1707,1192,2899
1399,ACLS,0.10744493171884863,0.03956422386069759,1586055168,1526,1374,2900
1400,HOFT,0.08230612622617064,0.04620913437479114,442801920,1774,1126,2900
1401,ACM,0.16158237128813066,0.0322708325162946,9753422848,1160,1741,2901
1402,JQC,0.07556196882078015,0.04799804204170028,893663296,1847,1054,2901
1403,SOHU,0.09364692815411574,0.04212922307718863,617501952,1643,1260,2903
1404,LULU,0.28666845380024547,0.01971549032762025,41490153472,639,2265,2904
1405,AIF,0.07113916597347597,0.04906297156723349,216236800,1896,1009,2905
1406,IX,0.04197630030879488,0.06934825002932056,20125609984,2369,539,2908
1407,TRI,0.23986901350798198,0.023672332619819603,44872273920,793,2117,2910
1408,MAN,0.11829019507841387,0.03751858204074273,5669898752,1433,1478,2911
1409,STM,0.12708175624526874,0.03589193273801647,35544879104,1363,1549,2912
1410,MNRO,0.10160825134691966,0.040302332328099294,2279414784,1572,1341,2913
1411,RVLV,0.31035464164828575,0.017797521107307448,3471476992,579,2335,2914
1412,FTV,0.250276417627547,0.02263190563344408,24138412032,755,2159,2914
1413,CCEP,0.20955352856457032,0.02687547875417562,23753142272,920,1995,2915
1414,AT,0.0897724431107777,0.0428784293952841,269050816,1679,1236,2915
1415,ANSS,0.3391634214666095,0.015747492072848427,31231117312,513,2408,2921
1416,TFX,0.28536586984510426,0.019376122732296046,19615844352,644,2280,2924
1417,HPI,0.058903343632176336,0.05436019333400467,542962304,2074,850,2924
1418,FSTR,0.07175840922444184,0.0482995792199237,191152416,1885,1042,2927
1419,LINX,0.06845985168579537,0.04964632426229516,1170870400,1933,994,2927
1420,LE,0.1291491089875329,0.03525838977339628,792257728,1349,1579,2928
1421,AEL,0.013714893376247636,0.2104668880126702,3076792320,2847,81,2928
1422,PSMT,0.11889281268014319,0.03689055981718073,2940425984,1429,1500,2929
1423,IART,0.17008790392472453,0.030722151567137666,5743903232,1119,1812,2931
1424,OCSL,0.06051062865642897,0.052916635102584715,1170542848,2035,896,2931
1425,NUAN,0.5121348954206636,0.00906515055897843,12898965504,305,2627,2932
1426,BRY,0.0476663795375507,0.06196214122676203,469145920,2257,676,2933
1427,MAR,0.5949044585987261,0.007486579320007663,48446287872,255,2680,2935
1428,WHLRP,0.06156693439126686,0.05226025535634602,11608330,2020,918,2938
1429,HYT,0.07127489428957406,0.04821423710944564,1447000448,1894,1045,2939
1430,ST,0.15320403731599158,0.03251577255703099,9149715456,1207,1733,2940
1431,TNC,0.1332657200811359,0.03461104484989591,1487337984,1332,1612,2944
1432,AMRK,0.16464338255326105,0.03104435847908357,376397152,1149,1796,2945
1433,EZPW,0.03673590560004921,0.07419006358389034,291337696,2457,488,2945
1434,OTTR,0.06941703616110403,0.04870164625710876,1924423168,1924,1022,2946
1435,BKEPP,0.05914180265907777,0.0534018440989284,335522400,2066,880,2946
1436,HPF,0.05933276091104057,0.05321797803002177,453958272,2063,888,2951
1437,ORN,0.08013906102488154,0.04562056902804974,182458992,1800,1152,2952
1438,NGVC,0.05230977509065356,0.05700610016125163,396892160,2174,780,2954
1439,CMBM,0.3327636277738408,0.015199273107647593,1505505664,527,2429,2956
1440,LAMR,0.16595573890214105,0.030666611960527862,9888366592,1136,1820,2956
1441,WHLRD,0.06156693439126686,0.05149431654015882,17014660,2020,936,2956
1442,MHLD,0.02731942605877091,0.09558664825039481,296270880,2664,292,2956
1443,HAIN,0.19702834109348222,0.02738632405575003,4346458624,994,1967,2961
1444,KSU,0.11510073808098943,0.03701938217312442,24008173568,1464,1497,2961
1445,BMBL,0.7806751034664242,0.0039865093269981335,7251677184,197,2768,2965
1446,ALSK,0.046039456177705024,0.06177109025974308,177457840,2288,677,2965
1447,HIG,0.03848136864307476,0.06939557245523119,24349177856,2428,537,2965
1448,WB,0.09948619535255511,0.03970592217607915,11191751680,1598,1369,2967
1449,HSTM,0.2333089165612306,0.022917331327708828,681523648,824,2145,2969
1450,IIIN,0.09190634495622611,0.04113246247791716,609163584,1663,1306,2969
1451,GNW,0.012294430761897195,0.17779389357032116,1712118784,2864,106,2970
1452,ROG,0.14782323125273125,0.03239262526374784,3543137792,1234,1737,2971
1453,UFAB,0.09051125444755218,0.041156219665997335,55349988,1673,1302,2975
1454,TTMI,0.0783468686676256,0.04552543083879791,1587019648,1819,1156,2975
1455,AY,0.1456872911500587,0.03256521783046129,4044685824,1253,1725,2978
1456,NSC,0.09714541087090106,0.03982422614908473,73677774848,1617,1363,2980
1457,WHD,0.12815677607364698,0.034325371498259295,2334491904,1354,1631,2985
1458,CDNS,0.3029505390274372,0.016369366937375087,39784361984,600,2388,2988
1459,FWRD,0.16461455166039127,0.03024919291402183,2399711488,1150,1838,2988
1460,SCSC,0.10159873958810643,0.03877269812580452,759990784,1573,1415,2988
1461,IHIT,0.05060612044597915,0.056729574433353254,218686320,2202,786,2988
1462,UNM,0.016507494419658847,0.12360994830646982,5698356224,2807,181,2988
1463,DFH,0.16186675328125952,0.030356590799496572,2200161536,1159,1830,2989
1464,ACHC,0.11234973732834176,0.03673805014416203,5159938048,1482,1507,2989
1465,AFL,0.02899820779083865,0.08548175249243767,35562672128,2629,363,2992
1466,ETN,0.20244842439356156,0.026090818032928904,55922200576,960,2033,2993
1467,PHD,0.0677393535028989,0.048012494352761954,284241920,1941,1053,2994
1468,AHCO,0.2999300326514293,0.016462912643149544,4359229952,610,2385,2995
1469,ECOM,0.18912801701430215,0.027285163859780616,739027008,1028,1972,3000
1470,DBD,0.17929089443996776,0.028311930571365655,1054626624,1075,1925,3000
1471,KEYS,0.18329794762915783,0.027861609851728926,26773835776,1052,1949,3001
1472,JHX,0.15465812914064728,0.03083526299511717,14102593536,1199,1806,3005
1473,PCAR,0.07935970810222308,0.04425679868116906,32099573760,1809,1196,3005
1474,NWLI,0.007449292663184281,0.21485086257279332,915149888,2928,78,3006
1475,GRC,0.09639475295309542,0.03938978440151737,857165056,1623,1384,3007
1476,HIL,0.08405566193559703,0.04212849894747984,173962096,1746,1261,3007
1477,ROAD,0.1254492187941172,0.03421806469142189,1554786816,1369,1639,3008
1478,RUSHB,0.09243992430665367,0.03997206244527272,2718766080,1655,1355,3010
1479,PSXP,0.08466098555020378,0.04180534453868298,6861616640,1736,1274,3010
1480,RUSHA,0.09243992430665367,0.03997205976756418,2718766336,1655,1356,3011
1481,CWCO,0.0566827872267942,0.052676698822189054,194930656,2104,908,3012
1482,AKU,0.08757558925006986,0.04102580926615262,230185152,1705,1311,3016
1483,MGA,0.09331074297188754,0.03965211711513806,27053150208,1645,1372,3017
1484,SAM,0.28448418117201196,0.01684488720351698,15153174528,647,2372,3019
1485,FN,0.11653354548069365,0.03546467758630081,3264163072,1451,1568,3019
1486,SMCI,0.08519181661716951,0.04138689873659649,1989632256,1732,1290,3022
1487,CLS,0.07303166322940677,0.04554038695203824,1117307136,1867,1155,3022
1488,LFC,0.01905373414809304,0.10337209221621263,152623054848,2776,247,3023
1489,SNPS,0.28961827499259624,0.016337628052675496,39159857152,634,2391,3025
1490,CABO,0.1527072645284297,0.030718423321071903,10735823872,1212,1813,3025
1491,MAIN,0.06970910799462346,0.04663126596036463,2805731584,1920,1110,3030
1492,QLI,0.19172203233458085,0.026473891732529207,175175008,1018,2014,3032
1493,SWX,0.054544340711167774,0.052872097452385816,3983466752,2133,899,3032
1494,TRNS,0.18809701298476153,0.026800503258615143,356058144,1033,2000,3033
1495,NHI,0.07308360334272339,0.04509295104139702,3387603456,1866,1167,3033
1496,WHLR,0.06156693439126686,0.04892324105997117,36400276,2020,1015,3035
1497,MMLP,0.07213305847161464,0.04535411843172209,102289456,1878,1159,3037
1498,GM,0.05886236563576719,0.05075773128156322,87650557952,2075,963,3038
1499,JPC,0.05809904129890182,0.051171966174590675,981872512,2085,953,3038
1500,ACI,0.06667609236325778,0.04715370187539818,8658914304,1957,1084,3041
1501,EIX,0.05038990103857048,0.05482553553680512,22744745984,2205,837,3042
1502,SWI,0.3009111363467519,0.014967209133335595,5573919744,606,2438,3044
1503,BFS,0.07116204763509656,0.04564634720870343,951238080,1895,1151,3046
1504,WEA,0.06395865613082005,0.04798918282704377,165018496,1993,1056,3049
1505,WHF,0.05446401842586611,0.052494727720240233,326681408,2135,914,3049
1506,SUM,0.0800688225978323,0.042615964010464705,3309306624,1802,1248,3050
1507,CSTE,0.04988141828756275,0.05493701557277675,479078464,2217,833,3050
1508,ETSY,0.2796981349209998,0.016384114813209272,25716516864,664,2387,3051
1509,MKL,0.04052301590838623,0.06279625185396494,16109474816,2394,660,3054
1510,NVEE,0.1989065773307051,0.0250012530346927,1447179776,982,2074,3056
1511,NTCO,0.07776052690685012,0.042902703883434874,11939872768,1823,1233,3056
1512,DIOD,0.12019295236270865,0.03419600172533467,3506794752,1416,1641,3057
1513,GTES,0.1126083170944069,0.03528132631249558,4781623296,1479,1578,3057
1514,QLYS,0.21055864899485008,0.02291448504034575,4036432640,914,2146,3060
1515,CLVT,0.9137442822914398,0.00020199862374904384,15992372224,171,2890,3061
1516,ATRI,0.14732572500134242,0.030665327631221637,1171951744,1240,1821,3061
1517,GTT,0.07919463087248323,0.042566282285531096,104698712,1811,1250,3061
1518,NFLX,0.2586617891261376,0.01779530547513088,242259132416,726,2336,3062
1519,MFC,0.009378530806916903,0.13334011212642466,42259968000,2904,158,3062
1520,LOGI,0.2693629444159105,0.0169742548055407,17797961728,693,2371,3064
1521,HEES,0.0662759859397035,0.046796976089756026,1319328896,1962,1102,3064
1522,HNGR,0.12349914655557645,0.03349067516300539,918603840,1384,1681,3065
1523,VTSI,0.1010017418227014,0.037384182090901524,39652652,1585,1481,3066
1524,VVR,0.05314589418004971,0.052539545897430144,645790848,2161,912,3073
1525,SGH,0.13672351686146336,0.03163368070717059,1291340288,1308,1766,3074
1526,OSG,0.041542835244247706,0.06087889770358964,195883696,2378,696,3074
1527,TR,0.1072808374455929,0.035907866405891616,2080610688,1530,1548,3078
1528,SALM,0.09883960559272059,0.03754629635986037,73824304,1603,1476,3079
1529,HZNP,0.17669990284126796,0.026942095681221363,19877912576,1090,1990,3080
1530,FCT,0.06445873657797849,0.046809668863016,319333824,1980,1100,3080
1531,PTC,0.3001125656135899,0.013874255659725644,16729528320,609,2472,3081
1532,UTL,0.053220035778175315,0.05202490125702887,719219712,2157,924,3081
1533,WH,0.2101010101010101,0.02252044589706787,6786051584,918,2165,3083
1534,DLA,0.06716426299164803,0.04596977907485816,195923088,1947,1136,3083
1535,ESLT,0.12038262637301966,0.033624731753044014,6363707392,1413,1674,3087
1536,NEXA,0.0545391518565366,0.05111894292711181,1390608000,2134,955,3089
1537,VIRC,0.04586648400864113,0.056479174550646154,52690564,2297,792,3089
1538,GL,0.03787580148404852,0.06327267334630006,11465603072,2439,652,3091
1539,JWEL,0.3944762055527706,0.008087338388293877,203882336,432,2661,3093
1540,LFUS,0.14889279334465544,0.029723555567503935,6553030144,1229,1864,3093
1541,XRX,0.057356608478802994,0.04927094373106512,4966324736,2094,1004,3098
1542,ATH,0.01274407919925614,0.10397521363995096,9679186944,2857,243,3100
1543,ANAT,0.02090313445130683,0.08626423199032138,2976681984,2748,353,3101
1544,EL,0.23777727478497057,0.01873767005302625,107061067776,808,2297,3105
1545,TRN,0.03381829938570967,0.0666421487440609,3120943104,2525,581,3106
1546,GOOGL,0.1716508023750635,0.026810318113011412,1494415966208,1110,1998,3108
1547,GOOG,0.1716508023750635,0.0268102929735477,1494417408000,1110,1999,3109
1548,GHC,0.05570344009554803,0.04972780726967712,3051656704,2117,992,3109
1549,NAPA,0.15011802330008375,0.02920665183252642,2017924864,1225,1886,3111
1550,GTLS,0.2182073320470093,0.02104011857285333,5181214208,893,2221,3114
1551,SXC,0.0501660170347914,0.05275012399542816,548032448,2209,905,3114
1552,FOXF,0.2044356098525183,0.022416411097894762,5423582208,945,2170,3115
1553,GCP,0.08343463366117804,0.039843135201953504,1807331200,1754,1362,3116
1554,FF,0.05489938757655293,0.0498476299046328,613279680,2129,988,3117
1555,ASML,0.2707144716033071,0.015189144610625031,261883265024,691,2430,3121
1556,DSEY,0.2565359477124183,0.01645871375753491,4484118016,735,2386,3121
1557,QRVO,0.20247810959575727,0.022553342279627034,21937909760,957,2164,3121
1558,BELFB,0.06015004971526711,0.047196036812954104,239596224,2041,1080,3121
1559,UBP,0.06444184270223252,0.04580499017361799,670076928,1981,1141,3122
1560,UBA,0.06444184270223252,0.04580495434143735,670077696,1981,1142,3123
1561,LYB,0.08058675731599173,0.0404007273194933,34616176640,1790,1336,3126
1562,SYY,0.1430259162070301,0.02973608027548686,41164730368,1265,1863,3128
1563,NI,0.05827979849332163,0.04812515296146704,9651511296,2083,1048,3131
1564,HRI,0.07217178770949721,0.042392585236833015,2843452672,1877,1255,3132
1565,BPYPP,0.061325728113386914,0.0466715852631407,16626558976,2026,1108,3134
1566,BPY,0.061325728113386914,0.04666616425884748,16635389952,2026,1109,3135
1567,SITE,0.2046310026234744,0.022012371492658667,7570662400,944,2192,3136
1568,CSTM,0.07761662093296746,0.04097123445220284,2047658880,1824,1313,3137
1569,SLQT,0.15423880230214107,0.028164685626664028,4860379648,1202,1936,3138
1570,PDCE,0.060135940832405435,0.04705790428985257,3510305536,2046,1093,3139
1571,IFF,0.22928918054277914,0.018704062270743213,34465308672,842,2299,3141
1572,NEWT,0.06224072081328407,0.04619927908540606,617805760,2015,1127,3142
1573,INNV,0.27046108807026104,0.014474368853124807,3655436032,692,2455,3147
1574,LNN,0.14390548254347538,0.029132550985006368,1763856512,1258,1889,3147
1575,COOP,0.06520430682806126,0.04488591228622959,2806737408,1969,1178,3147
1576,BELFA,0.06015004971526711,0.046674295409482605,243536448,2041,1107,3148
1577,NPO,0.11340833079963515,0.03362015610885844,1758907008,1474,1675,3149
1578,SGEN,0.19540619371880133,0.022910025355915034,26222286848,1003,2147,3150
1579,TPR,0.12477153301347955,0.03148660972861376,11972039680,1376,1776,3152
1580,AMRX,0.1005782246693541,0.03557249317456023,933605888,1590,1562,3152
1581,KMT,0.09297656498533102,0.03670414511271033,3412322816,1649,1508,3157
1582,IRS,0.04755917368112409,0.05287981999514838,369482976,2261,897,3158
1583,REI,0.048213643784055675,0.05267153713416129,227125856,2248,911,3159
1584,CSIQ,0.08673930947749826,0.03814794026465693,2699386624,1713,1447,3160
1585,EVF,0.07619346506618666,0.040751910662028504,252570224,1840,1320,3160
1586,ITGR,0.1670550918196995,0.026123199689251243,3022772480,1130,2032,3162
1587,ABMD,0.2379495934710377,0.017217317020300903,14501962752,804,2360,3164
1588,HQI,0.16743312195872845,0.02592194199406238,258030960,1127,2038,3165
1589,WRLD,0.06510210455010386,0.044362216770689786,866916224,1972,1194,3166
1590,PDT,0.0729355334433392,0.04115834639000439,733757312,1868,1301,3169
1591,HLIT,0.14230227047779012,0.028902434599680234,796691328,1269,1901,3170
1592,TPCO,0.10302910429002922,0.03456554350903193,674073408,1562,1615,3177
1593,AL,0.04526738140601285,0.05377618265428165,5628109312,2312,867,3179
1594,CLB,0.13531893079857446,0.029789994912524133,1328026880,1320,1860,3180
1595,ABCL,0.20907130460568207,0.019880127394906636,8432592384,922,2259,3181
1596,HPE,0.10297951582867784,0.03452273868888183,20688283648,1563,1618,3181
1597,SLF,0.011092641661592139,0.09332523079359484,30117277696,2875,306,3181
1598,FE,0.060232757854837275,0.045783418896507826,19056564224,2039,1143,3182
1599,ARTNA,0.05097554798850732,0.050020460136315954,373322112,2198,984,3182
1600,CE,0.1036430386896357,0.03441578244900694,17240424448,1556,1627,3183
1601,TACO,0.07017856818910208,0.041815154211103635,361691840,1911,1272,3183
1602,FLNG,0.034812824672634225,0.06124424395624922,474585280,2501,686,3187
1603,CMP,0.08782347793474184,0.037096751708087586,2174393600,1701,1489,3190
1604,CALX,0.22396570631043763,0.01812419806716117,2458883584,875,2319,3194
1605,CTRN,0.10334950023737122,0.034229866069059395,881586048,1559,1635,3194
1606,FISV,0.2586070125337141,0.013951549166872508,82072903680,727,2469,3196
1607,THG,0.06083076808035993,0.04524085633521208,4887720448,2032,1164,3196
1608,FCX,0.0782046124966479,0.03951036201999165,49610801152,1821,1377,3198
1609,XOMA,0.10994031912444437,0.03308979923361296,434377376,1501,1698,3199
1610,OGE,0.05253396766520179,0.048545234127263526,6545678336,2170,1029,3199
1611,NVDA,0.2632136485280999,0.01338124910543983,343765123072,708,2492,3200
1612,ATO,0.05929128386130992,0.04592718890523094,12589255680,2064,1137,3201
1613,SAIA,0.1419279491721475,0.028252000036235174,6042665984,1274,1929,3203
1614,BEKE,0.046266219454158965,0.05209151746107651,66403770368,2283,921,3204
1615,MGI,0.024364741641337385,0.07410380543896491,572057280,2715,490,3205
1616,PEG,0.054000450755014646,0.047537943345160996,30926843904,2143,1066,3209
1617,KAR,0.12152496128604086,0.030768337729143013,1977955456,1400,1810,3210
1618,OGS,0.05882219611800508,0.04599714813828475,4116823040,2076,1134,3210
1619,SSL,0.03454638213284061,0.06068784639974471,9457895424,2508,702,3210
1620,ENPH,0.30681062685545396,0.00922950888554675,20340754432,589,2623,3212
1621,CEQP,0.06685593601772669,0.04223860937356069,1724046720,1954,1258,3212
1622,TTWO,0.2054075772143671,0.019481697289869766,21152438272,938,2275,3213
1623,APD,0.10669857368051203,0.03349289066643869,62508535808,1534,1680,3214
1624,JD,0.05758693819550165,0.04623491589248297,130836070400,2091,1124,3215
1625,BBCP,0.10096867809613781,0.03435493902168783,421826400,1586,1630,3216
1626,FFC,0.05246618339159523,0.04825289274325697,1034827072,2172,1044,3216
1627,JRO,0.0521059780960609,0.0484719729056998,388384704,2183,1033,3216
1628,WLFC,0.047105627253548756,0.051204103012780736,254055792,2266,950,3216
1629,VLGEA,0.03781579503622223,0.05715301789010815,354942784,2441,776,3217
1630,LEA,0.09391469494342011,0.03524648065636933,10766823424,1639,1580,3219
1631,JFR,0.05220157577733873,0.048350576315463994,554955392,2180,1039,3219
1632,SR,0.06262085378551242,0.04356930907164594,3861412096,2008,1214,3222
1633,DY,0.1100756612203633,0.03257486380297413,2791864064,1499,1724,3223
1634,DIN,0.107366081562852,0.03312536209874205,1541172224,1529,1695,3224
1635,CATM,0.1479451788868829,0.026900805076702172,1758117888,1232,1993,3225
1636,CAT,0.11050425788042267,0.03254549997407579,125768843264,1496,1730,3226
1637,FT,0.047954799445597385,0.050260795145936475,190248480,2250,979,3229
1638,WTRE,0.04138834885599061,0.0544313369808153,693061888,2382,848,3230
1639,GASS,0.03216330709333566,0.0624640171667219,112439448,2563,667,3230
1640,PAAS,0.08459620668331364,0.037035697022509986,6787920384,1737,1496,3233
1641,RP,0.27485487749650667,0.011238879601232958,8972865536,679,2556,3235
1642,AWR,0.08007926554916282,0.03831502186373551,2836763904,1801,1437,3238
1643,TROX,0.05585451846353683,0.04628311446437015,3066451712,2116,1123,3239
1644,LILA,0.08358395989974937,0.03707383024688919,3196389120,1749,1491,3240
1645,FTNT,0.23517030233448144,0.015250115175967503,31468122112,816,2426,3242
1646,MASI,0.1961797992788914,0.020443442820616973,12898119680,999,2243,3242
1647,LITE,0.11020267653513491,0.03221959194272534,6843279872,1497,1746,3243
1648,LILAK,0.08358395989974937,0.03705675511212866,3202192128,1749,1494,3243
1649,ATTO,0.07176007681290343,0.03986838457553542,323249984,1884,1360,3244
1650,USAK,0.054911393686046014,0.046501122144459305,159060528,2128,1116,3244
1651,AMP,0.017542035915694275,0.07627875177589817,27567489024,2790,458,3248
1652,KRO,0.05685336335491134,0.045672378445271,1819802240,2101,1148,3249
1653,KIRK,0.07083426849209658,0.04015863793533722,402841568,1903,1347,3250
1654,PSHG,0.02930574825212873,0.0642149960390569,27751706,2622,632,3254
1655,COO,0.20129219673444856,0.019048716107775435,18809634816,969,2288,3257
1656,INSE,0.1392988929889299,0.027527764904749705,214537088,1293,1964,3257
1657,IGIC,0.05016079628284858,0.048169430558367955,354436480,2210,1047,3257
1658,CPK,0.07220039166503901,0.039400177490024745,2018112512,1876,1383,3259
1659,FLOW,0.11612135633551457,0.030863649405943053,2723996160,1456,1804,3260
1660,ULBI,0.06898178958194688,0.04044176337835665,132915136,1929,1332,3261
1661,XYL,0.17294822120464953,0.022695325172288415,19069411328,1105,2157,3262
1662,ILPT,0.05726053402927743,0.045077460437656154,1545024000,2097,1168,3265
1663,KALU,0.05412728039014992,0.04622469439132038,1728747904,2140,1125,3265
1664,WBA,0.0938500156887355,0.03444938899935266,48043020288,1640,1626,3266
1665,DSU,0.06138371022574761,0.042793971534889334,514839392,2024,1243,3267
1666,ORI,0.04583268129323026,0.05053689614389054,6976124416,2298,970,3268
1667,PNW,0.04625298935356352,0.050002634926822845,9274238976,2284,985,3269
1668,BLW,0.0623180990126602,0.04214694955598916,594487232,2013,1259,3272
1669,WST,0.19550446760982873,0.01953732675505939,21356029952,1002,2272,3274
1670,CIF,0.061348284977722246,0.04258272691343799,49322752,2025,1249,3274
1671,NGMS,0.2231691284510092,0.015972447361149784,922635136,877,2403,3280
1672,DGICB,0.07418926832105152,0.038565092509798005,449826944,1855,1425,3280
1673,ETG,0.05354968156497734,0.0461972406364651,1482512896,2153,1128,3281
1674,NHS,0.05080254521242727,0.04716585423237007,251096912,2200,1082,3282
1675,DGICA,0.07418926832105152,0.03844210065596553,455175360,1855,1428,3283
1676,SJI,0.05848306144575223,0.04405797215982577,2450074624,2080,1203,3283
1677,HTD,0.06663490612862251,0.04054806410623736,840060992,1958,1326,3284
1678,CYH,0.07113745831789552,0.039203010805168685,1534749056,1897,1392,3289
1679,PSN,0.12827839968394109,0.02816365884660983,4197824512,1353,1937,3290
1680,WCN,0.1470049438811573,0.025741673213547256,29517445120,1243,2048,3291
1681,MSP,0.20618609211648903,0.017235634600450453,3855875072,933,2359,3292
1682,PERI,0.19798348656465609,0.018375504503802712,594354624,991,2308,3299
1683,BRKR,0.1570374741811744,0.02373056593462674,10206386176,1183,2116,3299
1684,LPRO,0.23764896155609547,0.013264087995619662,4894595584,809,2497,3306
1685,BZH,0.046292637658645844,0.04860655318896163,659565056,2282,1025,3307
1686,PMF,0.05552251510009439,0.04460572249689439,376663328,2121,1187,3308
1687,ARD,0.09231709802323211,0.03396864552624378,6133827584,1657,1655,3312
1688,BCO,0.10526821765045184,0.031598525532345066,3975803136,1546,1769,3315
1689,ICUI,0.10059709814338277,0.03255767689363587,4334687744,1589,1726,3315
1690,BTZ,0.05808231730876621,0.04291636257731748,1346097536,2086,1232,3318
1691,FLC,0.05024472741325707,0.04662217208061709,245204080,2207,1111,3318
1692,MKTY,0.2161198288159772,0.015319167730952784,99888712,898,2425,3323
1693,CMS,0.05689900426742532,0.043229975039937765,17695504384,2100,1223,3323
1694,PFO,0.05025296956994248,0.046436605001931947,170412080,2206,1118,3324
1695,TTGT,0.2277423051735429,0.013592679023825025,1929079552,846,2482,3328
1696,ZBH,0.16808406911868262,0.021492297597913435,33903591424,1126,2203,3329
1697,LIN,0.1474909299903014,0.02426170351847476,147099910144,1239,2090,3329
1698,RCS,0.14007021979863216,0.025864246814400645,327418240,1287,2045,3332
1699,AMD,0.2271445163431226,0.013555402702453877,99840942080,851,2485,3336
1700,GBDC,0.048451674145237926,0.04679941267628594,2549042432,2240,1101,3341
1701,ABB,0.15131526023650552,0.02364431333943904,62748012544,1223,2119,3342
1702,PRMW,0.14145408163265305,0.025217854429399115,2677177856,1277,2066,3343
1703,BXG,0.05622460926125627,0.04285985756700934,791528576,2109,1238,3347
1704,IOSP,0.11475644699140401,0.029397444607639288,2577626624,1468,1881,3349
1705,EVRG,0.05132524858160296,0.045504494443037294,13905590272,2193,1157,3350
1706,MRCY,0.14705406952767527,0.023866293751236046,4179771648,1242,2111,3353
1707,GTY,0.06172371406881721,0.040400407034047264,1296368768,2019,1337,3356
1708,FSLR,0.05750167220352732,0.04203498945153189,8610786304,2092,1265,3357
1709,EEIQ,0.17314146488926951,0.01988053903749749,65855040,1103,2258,3361
1710,NGG,0.062069641981363416,0.04023237199181466,43173138432,2017,1344,3361
1711,ZYXI,0.16515195462309454,0.021128040186658,514145952,1143,2219,3362
1712,SCS,0.05828160731786998,0.041690910959640864,1635155072,2082,1280,3362
1713,SMLP,0.03980109362930439,0.051055378473529096,133810968,2407,956,3363
1714,ELF,0.2028607702073635,0.015715058998296963,1396317312,954,2410,3364
1715,CCRN,0.1273035092920561,0.026704946779366724,463279392,1361,2004,3365
1716,HDSN,0.11154987057645437,0.029550678332217375,85395368,1490,1876,3366
1717,DOW,0.07055312799744218,0.03787188013522386,47686950912,1906,1461,3367
1718,AFG,0.021892242778318728,0.06430640142419498,9919693824,2739,631,3370
1719,USCR,0.0773444347063979,0.03594308856479659,1105516288,1827,1544,3371
1720,PME,0.04939563006050855,0.04565894744526746,81274800,2224,1149,3373
1721,FOR,0.044151725820221976,0.04821005083992243,1155761536,2330,1046,3376
1722,CNP,0.056556463595839525,0.041850014443244,12884932608,2106,1271,3377
1723,ED,0.04614635790104274,0.04708346752484493,25807833088,2287,1090,3377
1724,PYN,0.05531728331522464,0.04247483753740552,56420804,2125,1253,3378
1725,PFG,0.005844139037709967,0.07884181948744837,16950117376,2953,429,3382
1726,WYY,0.12327467949131177,0.026845964857585683,81581928,1386,1997,3383
1727,CSOD,0.28035355019553765,0.0054933724136152235,2893655040,661,2729,3390
1728,EPAM,0.19047619047619047,0.017069241542202695,23053817856,1024,2368,3392
1729,CFX,0.14004324453989905,0.024016617325641625,5929447936,1288,2105,3393
1730,NICE,0.1990800895410003,0.015638425205076224,14564174848,981,2413,3394
1731,CHH,0.16629498080166713,0.019873953732473647,6187897344,1135,2260,3395
1732,CORE,0.08645243746576593,0.03359691898414974,1837710848,1719,1676,3395
1733,KODK,0.04788732394366197,0.04567540533536882,630383104,2253,1147,3400
1734,AFT,0.04656183703119292,0.04638524865118018,234063696,2280,1120,3400
1735,CCOI,0.11808938737398376,0.027420942199289502,3309077760,1436,1966,3402
1736,LINC,0.058618191398274386,0.04067510807696133,174079040,2078,1324,3402
1737,ECHO,0.15255314232902034,0.02210337691635464,844541056,1214,2189,3403
1738,CODA,0.09066872398007488,0.032542937179856395,97842296,1672,1731,3403
1739,PKE,0.0700766595987604,0.03708195780363892,286358688,1913,1490,3403
1740,NNA,0.03807116074904929,0.05067641769950979,66874296,2436,967,3403
1741,DE,0.09626211742793041,0.03145776170817552,117473812480,1626,1778,3404
1742,SLB,0.12679938744257274,0.025905080279783717,38242684928,1365,2040,3405
1743,CARS,0.1792206581523259,0.017922970544654377,899312192,1077,2329,3406
1744,GRA,0.09005863079841352,0.03255487204876199,4183958272,1678,1728,3406
1745,RAVE,0.11313246162592382,0.028208740712201245,26467204,1477,1933,3410
1746,AMT,0.1446999104210212,0.022722130267241982,108243066880,1255,2156,3411
1747,ZI,0.29411764705882354,0.003059475683505102,18812903424,622,2793,3415
1748,GTIM,0.04979347026537656,0.04421329599319517,61529060,2220,1198,3418
1749,OEC,0.07713247861417269,0.03509841313186705,1136413568,1829,1591,3420
1750,RYI,0.06336561962523762,0.03863143253969978,615595968,1999,1422,3421
1751,CTRE,0.07163281579682902,0.036103973942607566,2325720576,1886,1537,3423
1752,MOV,0.04696622706572955,0.045589428951545136,661953984,2269,1154,3423
1753,SO,0.05207089997612795,0.04282975643023209,66355105792,2185,1240,3425
1754,SPSC,0.20058225560061105,0.01449049972353705,3531000320,974,2452,3426
1755,PMX,0.05369103051394465,0.04170478231700618,413774400,2149,1278,3427
1756,BAM,0.05237747461964309,0.04231756254156052,68583841792,2173,1257,3430
1757,EXPO,0.18329476574317288,0.01667161567603611,5073674240,1053,2379,3432
1758,FORM,0.15230335843558682,0.02120343411811879,3863042048,1216,2216,3432
1759,LEO,0.058564911198346455,0.03999040380012704,539358976,2079,1353,3432
1760,TSI,0.04952679462490185,0.04370600588897727,270255936,2223,1211,3434
1761,DTE,0.052674701342636646,0.04200852191460337,26288754688,2168,1267,3435
1762,RMAX,0.0866492188175582,0.03266714578036923,1265981568,1716,1721,3437
1763,KN,0.1352670100298184,0.023597841778277364,1965100160,1322,2120,3442
1764,ES,0.055879300095115145,0.04047497617242817,30074918912,2114,1329,3443
1765,PFD,0.05022875506162961,0.042860828480652084,204627424,2208,1237,3445
1766,COMM,0.1629476500273606,0.019025446956704044,3136397056,1157,2289,3446
1767,SIGI,0.09787989912846123,0.030266343211578207,4474159104,1610,1836,3446
1768,ARKO,0.048942150092699574,0.04343180896970387,1241791360,2228,1218,3446
1769,FCPT,0.06906487930528647,0.036457200445372824,2141729664,1927,1521,3448
1770,HCAP,0.04127519197359328,0.04760302153478386,51864524,2384,1065,3449
1771,OCN,0.04679364743808785,0.044850988233553664,242301344,2272,1180,3452
1772,VALU,0.10973754738392448,0.027836266261156678,302544416,1503,1951,3454
1773,PNF,0.05316140828301726,0.04122842741702789,95513800,2160,1298,3458
1774,TCS,0.07870415553374495,0.03409550289083852,805798080,1814,1649,3463
1775,DMF,0.05475412571818221,0.04042812573315943,182814560,2130,1333,3463
1776,BTA,0.06914939423335222,0.036058179659902274,173210880,1926,1539,3465
1777,EYE,0.11992675642135119,0.025840395396818556,3762301952,1420,2046,3466
1778,WEC,0.05939511352168674,0.038878545663007504,29467938816,2060,1406,3466
1779,EXPI,0.2563068509157004,0.005458930909614971,5786914816,737,2731,3468
1780,CXDC,0.05115864840961545,0.041808315226208315,76192704,2196,1273,3469
1781,TDS,0.03916922219124617,0.04799454116305898,2712832512,2417,1055,3472
1782,MCHP,0.2022737900397475,0.013030551474440974,43003838464,964,2509,3473
1783,BECN,0.11849587282176705,0.025874201416404518,3738186240,1431,2042,3473
1784,MTRX,0.06246394544325518,0.03779732958042314,364648224,2010,1465,3475
1785,RACE,0.19935403604208823,0.01319754023369596,51629764608,980,2499,3479
1786,CMD,0.13428291053567962,0.02279133091182461,3461995008,1327,2153,3480
1787,VICI,0.054111378670178394,0.04026445963596863,15654161408,2141,1342,3483
1788,MT,0.04702914376082536,0.04354825037693023,31111661568,2267,1216,3483
1789,MPW,0.05590507418417364,0.039655771505779015,12643999744,2113,1371,3484
1790,XRAY,0.1768929503916449,0.016071708085288957,14005928960,1089,2398,3487
1791,MOHO,0.055602129451764085,0.03971582595491772,71766000,2119,1368,3487
1792,TECH,0.22299827827969967,0.00958780330622929,15402735616,878,2612,3490
1793,EXC,0.04008885914524195,0.04713848521355921,43905363968,2404,1086,3490
1794,GNSS,0.11521809616448285,0.02621908365964902,238179696,1463,2028,3491
1795,USX,0.06297701644739696,0.037102009704034,567954816,2004,1488,3492
1796,ASC,0.026992418551227453,0.05545164702069097,142416576,2671,822,3493
1797,LMRK,0.042189168128469276,0.046145092767381116,304593536,2366,1129,3495
1798,KWR,0.1409078685121281,0.021062191155016074,4269125632,1278,2220,3498
1799,CTVA,0.09427059006694691,0.029721564122708065,34624827392,1636,1865,3501
1800,FAM,0.04623228628845534,0.04355844673517063,99847480,2286,1215,3501
1801,NSSC,0.15202621596965477,0.01927666090206481,655736128,1220,2282,3502
1802,PCF,0.04559567542548838,0.04432789661427936,49305988,2307,1195,3502
1803,ARLP,0.03575055975681705,0.04851584926512843,747906624,2473,1032,3505
1804,TRV,0.08775460122699387,0.03089550548840698,38294990848,1704,1802,3506
1805,COG,0.0716196671623151,0.03451265189613554,7381281280,1887,1620,3507
1806,XELB,0.09254440031045975,0.029759059379996792,46346712,1653,1862,3515
1807,EVOL,0.12479307271106584,0.022971251712881856,36652020,1375,2143,3518
1808,AEE,0.0483325937809332,0.041726965432154074,20815890432,2242,1277,3519
1809,VEEV,0.21230452977845912,0.009535067282465825,39636086784,905,2615,3520
1810,SRE,0.051265204985733594,0.040653610877023585,40417304576,2195,1325,3520
1811,CLH,0.08097393532713698,0.03248920613252288,4767852032,1786,1735,3521
1812,ICHR,0.11462333231003055,0.025591182725633457,1679331072,1470,2054,3524
1813,TXT,0.06288113565930221,0.03646882323183217,12950608896,2005,1520,3525
1814,MGEE,0.060108646556880745,0.03752041567448701,2615336192,2048,1477,3525
1815,NWN,0.044561384360036094,0.0439706195144249,1644188416,2322,1204,3526
1816,NGD,0.03686525772210003,0.04737037989496383,1165999360,2455,1071,3526
1817,CYBE,0.08901323992162917,0.030195262901498814,196353312,1687,1840,3527
1818,INOV,0.18758355677847702,0.013303082787878003,4652073472,1035,2494,3529
1819,HQY,0.19441568856163885,0.012700685580099302,5499072512,1010,2520,3530
1820,BDL,0.036221334627396816,0.04750589947875698,44607600,2464,1067,3531
1821,BGT,0.05547995566276783,0.038839938989856514,282857696,2122,1410,3532
1822,ALRM,0.1649101114060928,0.01620301152147939,4251076608,1144,2393,3537
1823,YUMC,0.0997952218430034,0.028080259925452263,25123522560,1597,1941,3538
1824,FOE,0.06785308486310006,0.03488119135478015,1399457536,1938,1602,3540
1825,ALTO,0.05392136607336549,0.039127366953646915,422549280,2145,1397,3542
1826,LUNA,0.12492223267982197,0.0223839043977755,319313600,1373,2172,3545
1827,PAYC,0.22219025539768453,0.007760166368800992,22388969472,881,2669,3550
1828,CTLT,0.14046753959004593,0.019671942189619356,18071300096,1282,2268,3550
1829,RXT,0.14346197687673018,0.018905934798259298,5224524800,1264,2292,3556
1830,AMK,0.18670586999894992,0.012679003931746284,1632508032,1038,2521,3559
1831,RHE,0.07701863354037267,0.03255137430582669,8711215,1831,1729,3560
1832,BLK,0.047436130933655646,0.04113967934993314,120275591168,2262,1304,3566
1833,NOVT,0.18889299697581602,0.012144294340022805,4737962496,1029,2540,3569
1834,VTRS,0.12137412247904553,0.022510634035938237,16162800640,1403,2166,3569
1835,MOD,0.06196388261851016,0.03578939669669266,784173888,2018,1552,3570
1836,PNI,0.04579024127115201,0.04186567067123943,128429576,2300,1270,3570
1837,MSD,0.03944539734349211,0.04550197121877659,182053360,2413,1158,3571
1838,DMB,0.042960349748899444,0.04323723851768808,264965312,2352,1222,3574
1839,DNB,0.23732424371538133,0.004071340957090072,9954396160,810,2766,3576
1840,ASTE,0.08493827160493828,0.030157412717293976,1698922112,1734,1843,3577
1841,RZA,0.01786910479029787,0.05641869051619755,9447708672,2787,794,3581
1842,INFU,0.14051928618049253,0.018546417091073627,433213984,1280,2302,3582
1843,CEE,0.0458789452672393,0.041543460016929934,160170096,2296,1287,3583
1844,ATNI,0.05174469116844806,0.03912563861296759,737849408,2188,1398,3586
1845,ORA,0.05939126471923228,0.036284399766746266,4184751616,2061,1532,3593
1846,TYL,0.19799629027456547,0.00985194665528135,17591816192,990,2604,3594
1847,SBRA,0.04545935201529353,0.04159014743258164,3860390400,2309,1285,3594
1848,GSBD,0.04664269735281681,0.04073615913938768,2047219840,2276,1321,3597
1849,DLTH,0.057819271498668834,0.036694087224344134,538443584,2088,1510,3598
1850,PESI,0.08857286087438326,0.028547897299819627,89418848,1689,1913,3602
1851,BKR,0.08592518868706975,0.029476749805923713,22307344384,1724,1879,3603
1852,IDA,0.04376523720750921,0.04205034146810998,5065694208,2340,1264,3604
1853,CVGW,0.11792669564910048,0.02241991232364866,1385910016,1437,2169,3606
1854,TBA,727.1538461538462,-0.00011628682324864867,1299479936,1,3611,3612
1855,CNMD,0.15941063885208212,0.01474129646577125,3876598784,1167,2445,3612
1856,XP,0.08515874456088308,0.02937487855383913,21512591360,1733,1882,3615
1857,R,0.046963783541957335,0.04017340852479152,4151145984,2270,1346,3616
1858,OPK,0.15272502956426817,0.01584739379988435,2861049344,1211,2406,3617
1859,FTF,0.04536278590847218,0.04111566803785366,275770016,2310,1308,3618
1860,PUBM,0.1831093120210355,0.011061033646032104,2760502016,1055,2564,3619
1861,MMT,0.05140692139255113,0.03836692734067535,388247936,2192,1434,3626
1862,TA,0.016745780412803744,0.055327298793038146,409817504,2800,827,3627
1863,WPM,0.08777108210999471,0.02829584144266268,18339319808,1703,1927,3630
1864,TBCP,11.519103180050331,-9.717098254142755e-05,518034432,22,3609,3631
1865,MUA,0.05220321135021588,0.03800374205932983,562921344,2179,1455,3634
1866,BH,0.04352008099898751,0.0413827779025156,421582720,2344,1291,3635
1867,HRB,0.07598958543022774,0.031060561713338253,4134812928,1842,1794,3636
1868,TOPS,0.046233661269988534,0.040033552680863144,71697600,2285,1351,3636
1869,TGH,0.04596307522733535,0.04019181449432859,1457308800,2291,1345,3636
1870,POW,37.277870216306155,-0.0003319229216662705,337065024,6,3633,3639
1871,LHC,11.447848614552827,-0.00022240865669095032,456562496,23,3621,3644
1872,OLED,0.15630789259302258,0.014483135897830209,11341563904,1191,2454,3645
1873,IVAN,8.393044367727912,-0.00019137281038595827,342585024,29,3617,3646
1874,OIA,0.04397464464036981,0.04089064077832577,379006848,2333,1314,3647
1875,PACX,20.982021574111066,-0.0004251660529136955,493566240,11,3639,3650
1876,SWBK,14.435145570280705,-0.00035069650137319286,394126080,18,3634,3652
1877,GMII,5.9525405550341866,-0.00015568408620991546,570084992,39,3613,3652
1878,FREE,0.09843922694735102,0.025818733999699778,517607648,1606,2047,3653
1879,LTC,0.05913392584896498,0.03513505044450494,1708605440,2068,1588,3656
1880,NNN,0.05507143120404525,0.03627670601689161,7981866496,2127,1533,3660
1881,KAIR,9.816942374113797,-0.0004014010482028339,268824000,27,3637,3664
1882,QRHC,0.13785309551094982,0.017158067794410568,72732928,1300,2364,3664
1883,XPO,0.0999622783855149,0.025043390121021667,12950268928,1595,2070,3665
1884,MX,0.08257344850700021,0.02891482188951556,1235327744,1769,1900,3669
1885,HSC,0.08345237555364081,0.028471065356206283,1372907008,1753,1918,3671
1886,RGCO,0.047596981563397193,0.038806946015596644,183368624,2260,1411,3671
1887,AEAC,14.811979673478215,-0.0006129009704035706,223100000,17,3659,3676
1888,PBI,0.07256400201614388,0.030835940946396554,1495292928,1872,1805,3677
1889,WEYS,0.044276342500587644,0.04004533472043776,215096432,2327,1350,3677
1890,AGO,0.03542108661562587,0.04445432219483614,3323080192,2487,1191,3678
1891,ISSC,0.09880756293783721,0.02487797806529327,109313648,1604,2077,3681
1892,HGBL,0.10353188763839327,0.023408908004956937,106068600,1557,2126,3683
1893,MIT,4.285699592004663,-0.0004079448696878513,612500032,49,3638,3687
1894,ARYD,3.0,-0.0001979775031227628,205103680,68,3619,3687
1895,IGT,0.12586770473305248,0.018071293733533507,3360359936,1367,2321,3688
1896,LITB,0.17576254958282042,0.010124438940624932,345387840,1094,2595,3689
1897,DNZ,7.483228255947612,-0.0006132482237193095,350074400,31,3660,3691
1898,GSAQ,2.469716885743175,-0.00015295594989502364,318909856,80,3612,3692
1899,SIG,0.048223268928834634,0.038174461515966686,2969526272,2247,1445,3692
1900,CNEY,0.09446521496248601,0.025518687775472237,72385000,1635,2058,3693
1901,ULTA,0.10810488622716634,0.022338841051898733,17767151616,1518,2177,3695
1902,ORGO,0.16919638309474302,0.010815716165013096,2573778432,1124,2573,3697
1903,AXL,0.04790947352503843,0.03812814165858824,1090118656,2251,1449,3700
1904,PZC,0.041926737697957656,0.04048953955118697,239924320,2372,1328,3700
1905,AWK,0.06380989865197284,0.03292363375365837,27728193536,1995,1708,3703
1906,CGNX,0.14624367889197115,0.014282705545541806,14561494016,1245,2460,3705
1907,COLM,0.08682131852635457,0.02689160525494008,7056178688,1712,1994,3706
1908,SVFA,4.952199581032184,-0.0006710422315489282,774309888,44,3663,3707
1909,KLAQ,4.598056762976221,-0.000615073713034229,350390624,46,3661,3707
1910,DLB,0.1023457155611073,0.02314336486173079,10335057920,1568,2139,3707
1911,OMEG,26.11532787984444,-0.0011240383752480173,172845424,8,3700,3708
1912,ADM,0.06938681420009221,0.03129727847295522,32303697920,1925,1784,3709
1913,BENE,12.23993685872139,-0.0010425943490740878,148640112,21,3693,3714
1914,GLOB,0.16000503598075724,0.011521683211847338,8430661120,1164,2550,3714
1915,WEX,0.1590936436974696,0.011929107393943298,9512554496,1169,2545,3714
1916,PCK,0.043961134748314576,0.03947906379045958,294466208,2334,1380,3714
1917,PML,0.04499686866404912,0.03914995916760026,934608384,2319,1396,3715
1918,HIMX,0.11214254877172876,0.02074090003913666,2573035264,1483,2234,3717
1919,CUB,0.10653213745594854,0.02219445586759471,2374481920,1535,2184,3719
1920,SCD,0.0465032419640336,0.03826402463782552,231344128,2281,1440,3721
1921,ITT,0.08836909871244635,0.026154918054637245,7848124416,1693,2029,3722
1922,LMNX,0.07924280302535254,0.0286268617057928,1501438464,1810,1912,3722
1923,WOR,0.0891977566447208,0.025918721236735828,3505149440,1686,2039,3725
1924,WRB,0.08690334416295561,0.026448501633014748,13937105920,1710,2016,3726
1925,MFM,0.049950369861581335,0.036667375186323216,282547424,2214,1512,3726
1926,GLW,0.06540074220444358,0.031695035292511956,34066276352,1968,1762,3730
1927,CLFD,0.11127470953206317,0.020493924454608306,415131680,1492,2240,3732
1928,CBB,0.06254826254826255,0.032555522519240494,782974272,2009,1727,3736
1929,DSM,0.03967259268626961,0.040546798856294516,393395136,2409,1327,3736
1930,PAIC,39.99230346344145,-0.0016035661392282533,90703968,5,3732,3737
1931,FND,0.11631098726036969,0.019133061134783254,10616868864,1453,2285,3738
1932,NM,0.04550180536400859,0.0384222923221237,160867440,2308,1431,3739
1933,TMKR,3.134663891269744,-0.0007589477499301672,337065024,65,3675,3740
1934,ATEN,0.09804712985591224,0.02326384592794983,737756736,1608,2132,3740
1935,CRK,0.044400181506493,0.03869853100124683,1282908800,2325,1417,3742
1936,KEP,0.023172851782862998,0.048860116562887176,13635840000,2728,1018,3746
1937,MRVI,0.1544941771232324,0.011689256059859198,8455115776,1201,2548,3749
1938,EXR,0.0806903572263332,0.027545383093714945,18395469824,1788,1962,3750
1939,LSCC,0.1724435759767964,0.008325964118903092,6707006976,1108,2646,3754
1940,EPM,0.04201820180241372,0.03933478473630817,109179352,2368,1387,3755
1941,SEB,0.04576703987428796,0.038064850093785,4414132736,2303,1453,3756
1942,CAPL,0.06421006886212699,0.03156959844715491,736911232,1989,1772,3761
1943,ELS,0.09112036456301141,0.024110004374741884,11969818624,1667,2098,3765
1944,NYT,0.10697931169842799,0.020582163529984657,8273561600,1532,2238,3770
1945,SWN,0.059024390243902436,0.03306486166785537,3169947904,2070,1700,3770
1946,PYPL,0.15793595945634648,0.010024985349830325,299353636864,1176,2596,3772
1947,NKE,0.13807012100527458,0.013840071310627358,215729094656,1299,2474,3773
1948,DUK,0.045043510701280584,0.03798910645975528,75244806144,2317,1457,3774
1949,KNSL,0.0893718258863487,0.024253634277136484,3754828800,1684,2091,3775
1950,HMN,0.014940591909323208,0.05141544501560895,1757970816,2835,940,3775
1951,SBAC,0.12522671328975946,0.01585617972300757,31047188480,1371,2405,3776
1952,NMZ,0.05215579482524716,0.03504473446165842,1232593280,2182,1594,3776
1953,MPWR,0.15800354708417738,0.009863715573563284,17086880768,1175,2602,3777
1954,SMTC,0.12254853699838539,0.016358939717987256,4544583680,1389,2390,3779
1955,ODC,0.054030080337744146,0.03422555436934153,267028400,2142,1637,3779
1956,PCQ,0.050434445254546795,0.03530470167602001,342544576,2203,1576,3779
1957,AEP,0.04403268966924813,0.03806496386205083,43095334912,2331,1452,3783
1958,PRLB,0.1086252468920646,0.019572237887848346,3134536448,1513,2271,3784
1959,WSC,0.07581070556062831,0.02806019616135557,6533165568,1843,1944,3787
1960,MFT,0.05726336889451973,0.03328917273743617,125074248,2096,1691,3787
1961,ALB,0.08545695166616026,0.025443525537777997,17845096448,1729,2059,3788
1962,NWE,0.04233447849586017,0.03854677567413646,3336441088,2362,1426,3788
1963,SYNA,0.10236062280261175,0.021036789851567848,4776594944,1567,2223,3790
1964,PQG,0.06493250071759181,0.030696447050827743,2238919936,1974,1816,3790
1965,RBBN,0.10022393075012909,0.02173765779181478,1200842368,1592,2199,3791
1966,CNO,0.013801064853734907,0.05123995970913873,3368307968,2844,948,3792
1967,MFH,0.18192797387253884,0.005440152315481001,83388960,1063,2732,3795
1968,NTR,0.06308546795987731,0.031116113822597165,31840563200,2003,1792,3795
1969,NXJ,0.04819480928466281,0.03590792424424181,602332928,2249,1547,3796
1970,VIAV,0.09072978303747535,0.023400696491004923,3636806912,1671,2127,3798
1971,DGII,0.10346221402376736,0.0204891623188639,621013952,1558,2241,3799
1972,CLEU,0.10002458862269964,0.021356757330560982,24319986,1593,2206,3799
1973,MYTE,0.16543256906581588,0.008059130014374843,2299849472,1140,2662,3802
1974,WWW,0.10096095365527308,0.02113938355544472,3155220736,1587,2218,3805
1975,INSI,0.04044136578760727,0.03880400504402825,216984608,2395,1412,3807
1976,WOOF,0.09676677514766391,0.02208931990491033,6390447104,1619,2191,3810
1977,W,0.15261584066169767,0.009981364273291621,33803120640,1213,2598,3811
1978,SPG,0.06969213243058794,0.029109878948857106,38401392640,1921,1891,3812
1979,SQM,0.08972730156280809,0.023259208826370135,13883640832,1680,2133,3813
1980,RAD,0.04696260970331406,0.036017426508538786,1178488704,2271,1542,3813
1981,FLL,0.07148530579825259,0.02835142442129103,300246016,1891,1924,3815
1982,NATI,0.11729870322633762,0.01668601101356763,5848608768,1440,2377,3817
1983,ETR,0.03693222981390593,0.03976805175394995,20452636672,2453,1366,3819
1984,ZM,0.16729192621995562,0.007130531393802023,94893113344,1129,2691,3820
1985,VER,0.048799318910356375,0.035104627010127565,9424584704,2232,1590,3822
1986,MLAB,0.13361598301089683,0.013336681441952828,1245484928,1331,2493,3824
1987,MTOR,0.06711822660098522,0.029480594208996083,2101347456,1948,1878,3826
1988,RGLD,0.07387952451510121,0.027351173196324633,7248862208,1859,1969,3828
1989,MHI,0.03874073121758423,0.03878970561803329,284642272,2420,1413,3833
1990,NTP,0.037825507428559044,0.039181535569560375,482526976,2440,1393,3833
1991,VBF,0.03676300543610256,0.0394306981855747,222038704,2456,1382,3838
1992,ABCM,0.14609323703217333,0.01013499378074875,4418427904,1246,2594,3840
1993,DLCA,7.618838968691654,-0.0027901854483612302,252540000,30,3811,3841
1994,MUE,0.05229338283958721,0.03372687517875406,300877312,2175,1666,3841
1995,MYD,0.04502323063657584,0.036411504374200446,680334848,2318,1525,3843
1996,BCOV,0.18258971871968963,0.003226067931308145,872176320,1060,2785,3845
1997,VOD,0.0541771455025462,0.032967034514524964,53128327168,2139,1706,3845
1998,CWT,0.0518054881625736,0.03393966398528937,2894506496,2187,1658,3845
1999,MTW,0.05425400739827373,0.032756424017162555,735747968,2138,1714,3852
2000,AA,0.03635829086632693,0.03925626059605832,5833721856,2463,1390,3853
2001,AMZN,0.13099215156854221,0.012955843843563014,1651385958400,1341,2514,3855
2002,OSTK,0.1115606108650512,0.017015063369375315,2711548416,1489,2370,3859
2003,BNL,0.045768816550316414,0.03566064599264261,2736159232,2302,1557,3859
2004,AVA,0.03871920834964694,0.03830912075856487,3308300032,2421,1438,3859
2005,VNDA,0.06107933204921506,0.030338145704200098,892941568,2029,1831,3860
2006,BSD,0.0459223141073309,0.03547370406452644,108014752,2294,1567,3861
2007,FC,0.14716132302623242,0.009295663810777252,409304352,1241,2621,3862
2008,MHD,0.04442940757506254,0.03604544554967424,229771584,2323,1540,3863
2009,NVMI,0.09754616196138527,0.02013618773765376,2752270080,1614,2250,3864
2010,NQP,0.049965300150187915,0.03403236470342252,537198848,2213,1651,3864
2011,MRM,0.03373273087355528,0.040372400640106824,54607308,2528,1338,3866
2012,CASA,0.08413601868067717,0.023538184906741505,790877952,1745,2122,3867
2013,DCUE,0.04851385050886298,0.034289012482086816,60382736384,2237,1633,3870
2014,MATW,0.08415352006009877,0.02328740236389913,1289793792,1744,2131,3875
2015,FNKO,0.10995544429602921,0.016678645707400457,1145112448,1500,2378,3878
2016,MTDR,0.0514989830745881,0.03320825041523454,2867748352,2191,1692,3883
2017,GROY,3.9916268112342648,-0.003045809703708964,184528992,56,3828,3884
2018,PAI,0.03596998947332428,0.03871197151741696,143209984,2469,1416,3885
2019,MNR,0.056810280945881406,0.0311991765664988,1767444096,2102,1787,3889
2020,OHI,0.054731833825647454,0.03172600282216225,9076347904,2131,1760,3891
2021,SJW,0.050749895295025736,0.0333067029637491,1888587520,2201,1690,3891
2022,MCR,0.044233341196049644,0.035565396424623294,375791168,2328,1563,3891
2023,NVG,0.04823173998677124,0.034153206960516616,3620893184,2246,1646,3892
2024,PSO,0.07855973813420622,0.024913259504383587,8258424320,1817,2076,3893
2025,GO,0.07370561274676364,0.02614146533712348,3530906112,1862,2031,3893
2026,PMO,0.04106217006378313,0.036818347959464266,462868608,2388,1505,3893
2027,D,0.04851385050886298,0.033949131398785866,61433548800,2237,1657,3894
2028,PTR,0.02276258602619447,0.045272119741064015,112374890496,2732,1162,3894
2029,ARNC,0.04054669703872437,0.036833041520733883,2868617472,2393,1503,3896
2030,IHG,0.11972207375734902,0.013837894928183776,13079433216,1422,2475,3897
2031,SNN,0.08818737270875764,0.021722115128370835,16800602112,1697,2200,3897
2032,NEOG,0.11809427534052035,0.014176814648231579,4780697600,1435,2463,3898
2033,ALX,0.05277076730123377,0.032521071353057956,1450470400,2167,1732,3899
2034,PW,0.10139654121761037,0.018162187771673284,165456384,1582,2318,3900
2035,BFK,0.045137661356496724,0.03516663552992631,677138368,2315,1585,3900
2036,PMM,0.03975949399723329,0.037063930371874186,404726400,2408,1493,3901
2037,MTN,0.10443263784290559,0.017309851130759116,12209472512,1547,2356,3903
2038,MU,0.06728084254963611,0.027731803514596157,105368625152,1946,1957,3903
2039,BRKS,0.1283539177197658,0.011290979263773267,7175599104,1352,2554,3906
2040,MVT,0.04313283858757945,0.03562523748052619,321379008,2347,1559,3906
2041,ATRS,0.09690617484239138,0.01880565564096374,689460032,1618,2293,3911
2042,NEN,0.06056649987797228,0.02936716887645806,208167056,2034,1883,3917
2043,NHTC,0.007923160737126345,0.049367651304102964,84412384,2922,1000,3922
2044,IPGP,0.08848586771647524,0.020768281348597643,11774180352,1691,2232,3923
2045,HIW,0.04860699957012417,0.03317827264099395,4508226560,2235,1693,3928
2046,MYJ,0.03946762131583434,0.0365727854586128,354387488,2412,1517,3929
2047,MOXC,0.18143936842052732,0.0008592407427107958,82738568,1064,2866,3930
2048,LMRKP,0.040266361460826135,0.03632466158117333,395134272,2400,1530,3930
2049,ITRI,0.10863364770053921,0.015503627495263237,4138562304,1512,2420,3932
2050,VPV,0.03557359530223652,0.037990381203731306,309068608,2478,1456,3934
2051,JMM,0.046677686047590906,0.03387477740419051,69075160,2275,1661,3936
2052,YORW,0.05840785489310418,0.02984170693000989,634750592,2081,1857,3938
2053,BHK,0.044824906177600723,0.0345311600843155,846781056,2321,1617,3938
2054,LMRKO,0.040266361460826135,0.036085531749322775,400994144,2400,1538,3938
2055,HRMY,0.13046884601204375,0.009945412531215106,1607765120,1343,2599,3942
2056,DD,0.06981155416271494,0.026301444804525304,40410087424,1919,2023,3942
2057,JYNT,0.13754529629765674,0.00836863961407998,650011200,1302,2645,3947
2058,MAX,0.13926315639391476,0.008165012748420816,2125956352,1294,2654,3948
2059,BGR,0.0394290497567388,0.03617086606315135,254408288,2414,1535,3949
2060,MTRN,0.05953649294305014,0.02903182067505247,1356123392,2056,1894,3950
2061,CASS,0.09761069738982495,0.017742099731557034,663255936,1612,2339,3951
2062,BV,0.10142513418471219,0.016810944656308703,1833781120,1579,2374,3953
2063,ADN,0.8817868061503403,-0.0021257846689397017,634878272,176,3778,3954
2064,LAKE,0.06864886967696711,0.02627739722756108,225281232,1931,2025,3956
2065,PNM,0.041935737024328186,0.03513676455770421,4243677184,2371,1587,3958
2066,NID,0.038258052084558035,0.03639321902082648,669400384,2433,1527,3960
2067,EHTH,0.06044238799744279,0.028296216693676605,1843807872,2036,1926,3962
2068,XEL,0.04239913109940062,0.03493419897161928,36587016192,2361,1601,3962
2069,GIM,0.034684578857880455,0.03787224195114057,719011840,2502,1460,3962
2070,NMCO,0.038370232058957385,0.036267319816620215,759184448,2429,1534,3963
2071,ILMN,0.12165220671444738,0.011016743781331599,58440245248,1398,2566,3964
2072,OLP,0.04378440555418618,0.034391612313635085,475186432,2337,1629,3966
2073,DVD,0.03353426940135754,0.03835826943184802,77993584,2531,1435,3966
2074,AFGC,3.5331793687451887,-0.005033215169802288,27316904,62,3905,3967
2075,NWS,0.08310991957104558,0.021298238614230955,15174233088,1759,2210,3969
2076,NZF,0.03718586569901392,0.0364517249011086,2303862272,2448,1523,3971
2077,ALGN,0.13217667801336408,0.00876118877062002,43826847744,1337,2635,3972
2078,NWSA,0.08310991957104558,0.021259856654762706,15205766144,1759,2213,3972
2079,FCO,0.04148802129112753,0.034998572557145856,73821816,2380,1597,3977
2080,CWEN,0.04897375941803066,0.03199764074757592,5490118656,2227,1752,3979
2081,MUI,0.053085951560604965,0.030674242613651682,579421760,2163,1819,3982
2082,BLE,0.04155984266354329,0.034773294935777375,369860608,2377,1605,3982
2083,EDU,0.10378929526818016,0.015061041411917043,24810203136,1553,2432,3985
2084,AVAV,0.09297343099930927,0.017744788069508056,2797574912,1651,2338,3989
2085,VRRM,0.10888658192580415,0.013647239295109645,2212966912,1509,2481,3990
2086,LPTH,0.07381497776167009,0.023232402341376485,81265952,1860,2134,3994
2087,ON,0.08639884333367757,0.019454415667814678,17948045312,1720,2277,3997
2088,JHS,0.04732965863191538,0.03250531548721199,178309456,2263,1734,3997
2089,CDR,0.0380828808441818,0.03555182900285075,209102912,2434,1564,3998
2090,CAMT,0.09840158319378901,0.016132100408086807,1450852224,1607,2396,4003
2091,PCTY,0.1383058322380402,0.006183698369444507,10041136128,1298,2708,4006
2092,EVG,0.04260365514660727,0.03410246059072543,238169584,2359,1648,4007
2093,JEF,0.037242522832203646,0.035610042554000854,7731672064,2446,1561,4007
2094,BEPC,0.05109160477155075,0.030764067926879836,7983952384,2197,1811,4008
2095,CPSH,0.14038746150706502,0.005566519702207428,162470288,1283,2728,4011
2096,GMED,0.08780953713533096,0.01832021450577399,6421587968,1702,2309,4011
2097,PROS,0.03146934321820757,0.03820857869081211,554478656,2574,1443,4017
2098,VFL,0.035167333677864114,0.03645183315843604,59775408,2496,1522,4018
2099,CYAN,0.04141104294478527,0.034211660035517746,20851980,2381,1640,4021
2100,WPC,0.05217346186680202,0.030171036497519125,12538164224,2181,1841,4022
2101,CRNC,0.12008042012804572,0.009660022204021821,3557438976,1418,2608,4026
2102,KRA,0.053202440012303606,0.029668825528661718,1143399808,2158,1869,4027
2103,BNY,0.052248036109800035,0.03001796744306545,202816448,2178,1851,4029
2104,MGP,0.055567780093887166,0.028628400216120328,10439919616,2120,1911,4031
2105,WLK,0.0467408274785324,0.03178530190986203,11459858432,2273,1758,4031
2106,MYF,0.04149350969467331,0.03402990984285514,192955664,2379,1652,4031
2107,BBF,0.04111645509764737,0.03415503727478012,145811696,2386,1645,4031
2108,GSKY,0.040934539511269415,0.034166219844223834,1117971200,2389,1643,4032
2109,LNT,0.04416209214827607,0.032958706386609235,13712153600,2329,1707,4036
2110,LMRKN,0.040266361460826135,0.034226107985882166,449353088,2400,1636,4036
2111,ATCX,0.1113764183522447,0.011773507618627601,158920352,1491,2546,4037
2112,DBX,0.11778425655976676,0.009912177894488696,11454483456,1438,2600,4038
2113,SP,0.0947867298578199,0.015936152286844807,760208896,1634,2404,4038
2114,APTV,0.08428720083246619,0.018715837745681887,38056853504,1743,2298,4041
2115,MQY,0.04252955272265481,0.03347992413970644,490998400,2360,1682,4042
2116,VITL,0.09623824895231622,0.015610924044893467,874494528,1627,2417,4044
2117,OIIM,0.06350465677819937,0.02565199065020936,218990928,1998,2051,4049
2118,NSA,0.053057597077046346,0.029207238430051238,2937858048,2164,1885,4049
2119,MUJ,0.037251998708112084,0.03480538366879386,449803584,2445,1604,4049
2120,COUP,2.1517978143652146,-0.007169996960524277,19180578816,89,3961,4050
2121,MET,0.010887275444735061,0.04491917945737891,54638166016,2878,1175,4053
2122,NMI,0.036529156115159944,0.035068814572839745,105315728,2461,1593,4054
2123,BHE,0.0437100277121216,0.032735709392683505,1118036224,2341,1716,4057
2124,UHAL,0.04288447220367376,0.03305300905228095,12097816576,2355,1703,4058
2125,FAX,0.03430642928285717,0.03600760600265748,1050230976,2515,1543,4058
2126,CMU,0.034862006739040496,0.03561069081516728,128030352,2499,1560,4059
2127,MQT,0.04191216983597946,0.03340832428412254,312702048,2373,1687,4060
2128,MEN,0.04135756118995382,0.033571684976249135,355584352,2383,1677,4060
2129,RVI,0.030858557136680318,0.03770377710026642,421455168,2594,1469,4063
2130,BKT,0.045916680274166774,0.03156198903698321,390438240,2295,1773,4068
2131,POWI,0.09571082125525149,0.014953841481681917,4909986304,1630,2439,4069
2132,NEP,0.062192723697148476,0.025563537576500654,5496908800,2016,2056,4072
2133,AVT,0.04668589514728241,0.03102344848841822,4274593024,2274,1798,4072
2134,CXE,0.03541280644680648,0.035187191487101734,165015056,2489,1583,4072
2135,ISRG,0.10741651300962918,0.011725289171742833,90088030208,1528,2547,4075
2136,LRN,0.06705293367858202,0.023501703696150598,1362481920,1952,2123,4075
2137,BKN,0.04209922136082071,0.03288358045599823,304073408,2367,1709,4076
2138,CVGI,0.057280653910236776,0.026853741838532598,312450880,2095,1996,4091
2139,KMX,0.05257069838204347,0.02837593414208456,20575989760,2169,1923,4092
2140,USM,0.03135662063363119,0.03661458230066299,3184123904,2578,1514,4092
2141,VCV,0.03388677466862849,0.03546098112294597,617462336,2523,1570,4093
2142,BXP,0.045198995284147635,0.03134422737915174,16340946944,2313,1781,4094
2143,EAT,0.06676783004552352,0.023134482757181857,3182206976,1956,2140,4096
2144,ASH,0.05871615454822026,0.02641255273576809,5375131648,2077,2019,4096
2145,IQI,0.03396720455857886,0.03530220457138249,693835456,2519,1577,4096
2146,ECOL,0.06799615470021696,0.022578569676170845,1295889408,1936,2163,4099
2147,SEMR,0.6005081598749145,-0.0035685593385528865,1714604416,252,3848,4100
2148,MVF,0.03453039739234869,0.03507959909853564,604274624,2509,1592,4101
2149,NNY,0.03370570506969923,0.03537589140217552,149609376,2529,1574,4103
2150,MUC,0.04766407719473543,0.030094714002749625,619547776,2258,1846,4104
2151,KTF,0.03539981232006379,0.03456839613123813,464135584,2490,1614,4104
2152,KSM,0.035478010026883985,0.034398337901371805,132206024,2482,1628,4110
2153,FDP,0.03855849127065634,0.03343804737192946,1339639936,2425,1686,4111
2154,PEO,0.03696275485093248,0.03391023167766789,358288096,2452,1659,4111
2155,DSGN,0.7457475380483438,-0.005068629733373038,1643491200,206,3907,4113
2156,IHC,0.027218652319657047,0.038123627313234425,595823616,2666,1450,4116
2157,GENC,0.034050928773526876,0.03497540147666954,185352672,2518,1599,4117
2158,LSI,0.053372933155230125,0.027351443243228895,6710853632,2154,1968,4122
2159,IDCC,0.06440706460319981,0.023015313059654915,2206732800,1983,2141,4124
2160,SLP,0.10416764064999207,0.010555098549336603,1277341440,1551,2579,4130
2161,VMO,0.03386324776014317,0.03472999843838783,891219648,2524,1606,4130
2162,CUBE,0.06000885260093467,0.024683611714363993,7912561152,2050,2081,4131
2163,ADS,0.05187278748429828,0.027927419562404087,5614552064,2186,1948,4134
2164,BYM,0.039494321822009786,0.03258861047178672,403488256,2411,1723,4134
2165,OFC,0.04316686981134099,0.031183002119596726,3036132352,2346,1789,4135
2166,RGA,0.009672570420233971,0.04284340628842567,8752202752,2896,1239,4135
2167,CWST,0.08122154756536724,0.017243058113599014,3322356736,1782,2358,4140
2168,NXN,0.03485381392814673,0.034188737065067136,55105476,2500,1642,4142
2169,HUN,0.04504826599928495,0.0305011998997748,6347970048,2316,1828,4144
2170,AVD,0.07037289808634764,0.02064641209182402,621136256,1909,2237,4146
2171,VKI,0.03374951023042698,0.03451163899353367,526928288,2526,1621,4147
2172,COR,0.07205561561951723,0.019623315398629226,5221400064,1879,2269,4148
2173,SKT,0.047777351465070825,0.029101593011853322,1607520000,2256,1892,4148
2174,VKQ,0.03347896730139376,0.03456269256474186,726354240,2535,1616,4151
2175,NXGN,0.08951237669830635,0.013895529677944872,1250268032,1682,2471,4153
2176,ICL,0.049857335936326776,0.028169013778581897,7990000128,2218,1935,4153
2177,OCDX,0.09335483323432063,0.01302327021411101,4415519232,1644,2510,4154
2178,RAND,0.027003160051193915,0.03712823625897412,47382820,2670,1485,4155
2179,FFG,0.007741628346077359,0.04301400046542841,1364984192,2924,1231,4155
2180,IR,0.09296467863346844,0.013059653383488199,20996876288,1652,2506,4158
2181,MHF,0.03433082382624262,0.03415557866091756,168520656,2514,1644,4158
2182,RAVN,0.0908514612012425,0.013450062812392527,1364116992,1670,2489,4159
2183,EVA,0.05606841608546563,0.025723822005599185,1906700416,2112,2049,4161
2184,AIRTP,0.10153588383133202,0.010235327865814109,604636416,1575,2587,4162
2185,SCVL,0.04877443606084643,0.028251108097518757,859313152,2233,1930,4163
2186,DAVA,0.12052656930674727,0.004650847590808577,4920822784,1411,2754,4165
2187,NXR,0.03518147792279691,0.033651381858420974,221645216,2495,1672,4167
2188,NEA,0.039990413723418286,0.03169132147320779,4455664128,2405,1763,4168
2189,IIM,0.03304767165508734,0.03449273592962963,746316096,2546,1622,4168
2190,VCF,0.033933633158419754,0.03413864405726175,69702608,2522,1647,4169
2191,RNP,0.04312625807393012,0.03059616943529697,1181465984,2348,1823,4171
2192,TEAM,0.14021082388541056,0.0002517163832883057,54420996096,1285,2887,4172
2193,APPH,0.8636946058456816,-0.008561343202342414,1791052032,180,3994,4174
2194,RGEN,0.11194412594358949,0.0071470953286227375,11026010112,1484,2690,4174
2195,SSTI,0.11823235130628126,0.005051035645160923,406165760,1434,2741,4175
2196,AVNW,0.08653050762545002,0.014387387333216338,463864032,1718,2457,4175
2197,VTN,0.03195388459176859,0.03462331516983539,254769616,2567,1610,4177
2198,NSS,0.038565569761196794,0.03187000725319056,1923786624,2424,1755,4179
2199,MMD,0.035427150109465455,0.033066229398042504,611987712,2485,1699,4184
2200,CGNT,0.08200143731922147,0.01567046395269599,1683138816,1777,2412,4189
2201,STOR,0.0439453171925465,0.029828804635313552,9091167232,2335,1858,4193
2202,VGM,0.03320775187868514,0.034029677203267154,741259840,2542,1653,4195
2203,POR,0.033464317403980225,0.033888676036054464,4346212864,2536,1660,4196
2204,DSWL,0.02329998889889359,0.037628894401330465,58408784,2726,1472,4198
2205,SILC,0.05655315495779081,0.02424267181292128,317377920,2107,2093,4200
2206,NXP,0.036530480278614275,0.03227290759292618,295115232,2460,1740,4200
2207,SMSI,0.08946397432333392,0.012732086515347905,295421696,1683,2518,4201
2208,GIGM,-0.0397908353332535,0.43218274030140824,37798524,4164,39,4203
2209,MMX,0.05462895688612801,0.025003926313438972,784054016,2132,2073,4205
2210,NAC,0.03237297390917574,0.034047821269144025,2182603264,2558,1650,4208
2211,NMM,0.028642345672398706,0.03541552074052799,307454912,2636,1573,4209
2212,HMY,0.01265303891560997,0.04000992862884101,2906127616,2858,1352,4210
2213,TSEM,0.05040070646140899,0.02665166941386952,3207891456,2204,2007,4211
2214,BRX,0.04284571901351976,0.029986512483013518,6122779648,2357,1855,4212
2215,NUV,0.03538738879894977,0.032669713225673094,2308885504,2492,1720,4212
2216,NXQ,0.03535126919086489,0.03268186024545224,287316512,2493,1719,4212
2217,RTX,0.0835013440860215,0.014147297729818556,117643919360,1752,2464,4216
2218,NBH,0.03467871023658967,0.03275015101584303,301654464,2504,1715,4219
2219,NMY,0.03457187561300666,0.032790532689443076,330094336,2507,1712,4219
2220,FDX,0.04831943928211119,0.027018840869801244,74059603968,2243,1984,4227
2221,NAN,0.03293646275866624,0.0335539330088744,443950880,2549,1678,4227
2222,NAD,0.03327605408355434,0.03330830780610262,3219175680,2540,1689,4229
2223,LYTS,0.05993976213237939,0.02219568366390374,231576736,2051,2183,4234
2224,TTD,0.11377742992464439,0.004349570344417632,32117209088,1473,2762,4235
2225,ERF,0.04593650085508216,0.02806726173441194,1098246784,2293,1942,4235
2226,NXC,0.03443883686980963,0.03265881010861127,102362976,2513,1722,4235
2227,FIVE,0.08238145920919589,0.013995789868806651,10893796352,1771,2467,4238
2228,CULP,0.035399364746335635,0.03221928788944759,188441616,2491,1747,4238
2229,GATX,0.033429090695901977,0.03306039242329111,3321412096,2537,1702,4239
2230,PCG,0.02976565940278257,0.0343113787878275,22506270720,2611,1632,4243
2231,FINS,0.04028751661383358,0.03013228586488886,268944128,2399,1845,4244
2232,FMN,0.0323444458405821,0.03331977891223727,168773024,2559,1688,4247
2233,TYHT,-0.05425818973060939,0.9787810885199774,17458784,4230,17,4247
2234,CXH,0.03168142094959879,0.0335435677906511,90355360,2571,1679,4250
2235,EPAC,0.07477161039985503,0.01599555271070578,1545698048,1851,2401,4252
2236,UHT,0.05963577199378462,0.021871193694044395,959997312,2055,2197,4252
2237,RDNT,0.058915728463717267,0.022193849929193765,1136918144,2073,2185,4258
2238,SBUX,0.0895164133007324,0.010596530273303598,133258584064,1681,2578,4259
2239,CCI,0.07201184493898062,0.016575565272406615,76177276928,1881,2383,4264
2240,NEE,0.05210453307412695,0.02471271910654052,151835852800,2184,2080,4264
2241,FMY,0.030698430440366905,0.033637407801129816,56540072,2596,1673,4269
2242,MERC,0.03448355334209831,0.03174320126919599,1030835712,2511,1759,4270
2243,PGNY,0.10834846180265933,0.004408562709075949,3999720704,1515,2759,4274
2244,DRVN,0.06619651855884529,0.018271323181430897,4260584704,1963,2311,4274
2245,MHN,0.03393813771746474,0.03193507317145235,441763072,2521,1753,4274
2246,MPA,0.03544405181766892,0.031111494925262204,196275328,2483,1793,4276
2247,GOODM,0.04377573089984633,0.028064974513463663,646820480,2338,1943,4281
2248,TIL,0.7564251919830722,-0.011885608090139232,2905283840,204,4079,4283
2249,PACK,0.09378531073446328,0.008458211454242836,1511289856,1641,2643,4284
2250,SHOO,0.076423323619018,0.014484832895925613,3201905408,1838,2453,4291
2251,RICK,0.06476032735775526,0.018199137940758916,583644160,1976,2316,4292
2252,NBW,0.031143015992121614,0.03296725098639582,76271368,2587,1705,4292
2253,BBDC,0.030583539276976053,0.03311453487174421,667530560,2597,1696,4293
2254,LGL,0.03561450756336362,0.030677815382251217,61058536,2477,1817,4294
2255,NCA,0.030964829242836833,0.03300817839748567,289337696,2590,1704,4294
2256,MMU,0.032573762824949754,0.03223099059957211,567251200,2555,1744,4299
2257,WTRG,0.043979005379578995,0.027347715856033922,11212279808,2332,1970,4302
2258,TUYA,0.44130357864941366,-0.005975823672641415,11754959872,377,3926,4303
2259,PCTI,0.04781030461126523,0.025526935190766677,129714800,2255,2057,4312
2260,PRT,0.025981765627627645,0.034477420470189,68006264,2690,1624,4314
2261,TY,0.031994626455309476,0.03211186979439066,1737354624,2566,1749,4315
2262,CTOS,0.060995549560321084,0.019131111166027084,457158240,2030,2286,4316
2263,QADA,0.09202316160217991,0.00812339182687239,1514332160,1661,2657,4318
2264,EEFT,0.06710682196922417,0.017056785152932807,7521448960,1949,2369,4318
2265,LAUR,0.03327345162735251,0.031484190719155765,2652136704,2541,1777,4318
2266,BFY,0.03445217366677976,0.030819873244576922,77941120,2512,1808,4320
2267,AMRC,0.05716805802644201,0.02098686653599936,2395997952,2098,2225,4323
2268,MIY,0.03249400443246833,0.03162118150199657,444709440,2556,1767,4323
2269,QADB,0.09202316160217991,0.008000769807884745,1538289280,1661,2664,4325
2270,IIVI,0.06690690067710583,0.01681487574121704,7793961472,1953,2373,4326
2271,PPT,0.04827341241677558,0.024562668025281526,482440608,2244,2084,4328
2272,JP,-0.03031261906636308,0.11044757542386474,77205744,4107,222,4329
2273,MYI,0.0345978615478091,0.03050864827784124,970466368,2505,1826,4331
2274,PETQ,0.08220155787073884,0.011157524853325627,1011226432,1775,2560,4335
2275,AFB,0.03214747466616967,0.03142674542945324,412776768,2564,1779,4343
2276,ISNS,0.030473135525260625,0.03222730084906216,25424992,2598,1745,4343
2277,SHLX,0.053317176613147534,0.022110386724814465,5506059776,2156,2188,4344
2278,KLIC,0.0673423889596836,0.0159747539861266,3411131136,1943,2402,4345
2279,MCA,0.036034938167025424,0.02943687903252828,512300896,2467,1880,4347
2280,PTNR,0.033531260915124,0.030709720685058527,863046016,2532,1815,4347
2281,NAZ,0.03213345020983414,0.03133279165393717,175997440,2565,1783,4348
2282,ELY,0.07369237387809766,0.013464065745972423,5048932352,1863,2488,4351
2283,BFZ,0.041721187297933074,0.027166374599141258,451633888,2375,1976,4351
2284,MFL,0.033551547451961185,0.030638085903173004,542673984,2530,1822,4352
2285,PNTG,0.06861232450339973,0.015476328098553427,1230262272,1932,2421,4353
2286,MZA,0.032472083724330074,0.030988870153379772,70061560,2557,1800,4357
2287,AEVA,0.49268843547831415,-0.010258054702181968,2528295168,325,4035,4360
2288,SAND,0.04790815592579588,0.023933990924705426,1404401152,2252,2109,4361
2289,GSHD,0.09637904623694925,0.005071658550001329,3696495104,1624,2739,4363
2290,JDD,0.03773572608858362,0.02840280571982722,187834176,2442,1921,4363
2291,ALGM,0.08183827846516822,0.010262645777126173,5194280448,1780,2585,4365
2292,MOS,0.034988396038309416,0.029687542370757176,11676063744,2498,1867,4365
2293,CIR,0.056095778019730695,0.01991889252814549,667943296,2111,2257,4368
2294,EIM,0.03045189273428843,0.0315949834000892,964172864,2599,1770,4369
2295,FWP,-0.06810710464231845,0.18593201033363868,48588388,4272,98,4370
2296,NARI,0.09865470852017937,0.003715654445183812,5417354752,1605,2775,4380
2297,GOOD,0.04377573089984633,0.025870079053097756,758427008,2338,2043,4381
2298,ERH,0.03697326180131737,0.028217364593783493,122894544,2451,1932,4383
2299,EVN,0.030766997290478007,0.031198807927952727,550977408,2595,1788,4383
2300,AIR,0.03643080058594994,0.028394271013031342,1436090880,2462,1922,4384
2301,VMM,0.02990150072763364,0.03151681121475087,153016496,2609,1775,4384
2302,GURE,-0.08534469146226865,0.48623830862821055,46088384,4350,36,4386
2303,GDS,0.015138142941298515,0.03569924806365495,14970708992,2832,1555,4387
2304,OBAS,0.03180129104074472,0.030526930011198796,56192400,2569,1824,4393
2305,BOSC,0.05812599258867125,0.01827282222241453,18333620,2084,2310,4394
2306,OPINI,0.029150628768922247,0.031605671588554755,1274593664,2626,1768,4394
2307,CELH,0.10153336167950734,0.0021151630304979043,3757020160,1577,2819,4396
2308,NMRD,12.616592650483437,-0.028563069387133645,166016304,20,4377,4397
2309,EWTX,0.5144225014961101,-0.01249476763435861,1476509952,303,4094,4397
2310,SWCH,0.057436954277777674,0.01845197283118341,4159218944,2093,2305,4398
2311,NKX,0.02974568408097811,0.03121055171034091,736565120,2613,1786,4399
2312,NMT,0.03034303591159332,0.03090251080067368,134154360,2601,1801,4402
2313,BSE,0.03426216431041117,0.02913310154660846,95773800,2516,1888,4404
2314,CB,0.05430394775897893,0.01959121834992554,72375353344,2137,2270,4407
2315,CHY,0.033490816985039466,0.029593041660312663,1145636224,2534,1873,4407
2316,NVGS,0.024423529221359114,0.03315772779713692,503042400,2713,1694,4407
2317,MYN,0.032694232628586346,0.02989110313021152,536397664,2554,1856,4410
2318,NRK,0.029658432805897722,0.031054993050431443,1188145152,2616,1795,4411
2319,JTA,0.037904474461231734,0.027142179796202703,149174192,2437,1977,4414
2320,CRHM,0.7539036754312778,-0.017887632805290717,284703776,205,4212,4417
2321,AIZ,0.04514844190677917,0.02403404838260772,8678431744,2314,2103,4417
2322,SEDG,0.0776097456759671,0.010140894455765857,13537591296,1825,2593,4418
2323,FLR,0.04593988281550811,0.02334791481868937,3125616640,2292,2129,4421
2324,ENV,0.08134645041212443,0.008287372894826337,4006303744,1781,2649,4430
2325,ROIC,0.035227458372838825,0.028157775155976908,1946032768,2494,1938,4432
2326,NUVB,0.8330336648814078,-0.01953421847143857,2252676352,189,4244,4433
2327,TEN,0.045615414864333466,0.023384237409989475,867212992,2306,2128,4434
2328,OPI,0.029150628768922247,0.03081495186852176,1365478016,2626,1809,4435
2329,DXCM,0.08189549096278471,0.008096426168997835,35527929856,1779,2659,4438
2330,BROG,0.05768460201628011,0.01747449092924882,1099167616,2090,2350,4440
2331,NOM,0.03143790546329778,0.02969558285384261,34774008,2575,1866,4441
2332,O,0.0428618440504012,0.024383705220618786,24482992128,2356,2087,4443
2333,SFUN,0.02583615717318602,0.03209752329563026,112925456,2693,1750,4443
2334,BEP,0.028990792232655667,0.030714418898040396,11677330432,2630,1814,4444
2335,CHI,0.033002649170053,0.02895504493507663,1062438464,2548,1898,4446
2336,NKG,0.029344084299295702,0.0305035759619815,136549888,2620,1827,4447
2337,EQIX,0.062256441069776486,0.015025797073219908,61113106432,2014,2434,4448
2338,EXEL,0.06033201872026136,0.01567799266843672,7306806272,2037,2411,4448
2339,PCYG,0.06439860232639151,0.014078384474491275,115788088,1984,2465,4449
2340,NPV,0.03305346355406044,0.028804956218566245,292209536,2545,1904,4449
2341,RUHN,-0.10192428578297205,0.5624407553691417,281027008,4421,28,4449
2342,PCRX,0.06243478197637426,0.014763259730224451,3023072256,2011,2443,4454
2343,BYD,0.05385436127890357,0.018218935347225382,7010666496,2146,2314,4460
2344,AI,0.41820159917642996,-0.011124756101038314,6378902528,406,4057,4463
2345,DTF,0.026225385080551365,0.03134998938360187,101894320,2686,1780,4466
2346,ESP,0.03726368135640782,0.02629146256795662,43242080,2444,2024,4468
2347,TCX,0.0765716111510504,0.00876649006411174,817095104,1835,2634,4469
2348,VNOM,0.049176953003554354,0.02042529549227001,2283898624,2225,2244,4469
2349,RE,0.02663303105261727,0.03113855766598532,10228277248,2679,1791,4470
2350,KDNY,3.0529051987767586,-0.03091700767664686,621836416,66,4407,4473
2351,MHE,0.03132319624724786,0.028974162590944832,32720142,2580,1895,4475
2352,GOCO,0.3983018482498912,-0.010775970509432312,3782129920,429,4049,4478
2353,CSGP,0.07374167033417597,0.009195650666393067,33888215040,1861,2624,4485
2354,STAY,0.03994980040773886,0.024796982370461233,3531687936,2406,2079,4485
2355,IGD,0.027933782582184416,0.030377748180770565,557834368,2658,1829,4487
2356,BTT,0.0311976786694494,0.028773500984911164,1806353536,2584,1906,4490
2357,LDL,0.047623279200823466,0.020743385834932838,583977600,2259,2233,4492
2358,STKL,0.07564941291793637,0.00831663750783275,1520642816,1846,2647,4493
2359,FR,0.0459939935677699,0.02146012377362993,6081881600,2289,2204,4493
2360,PFX,0.020274537105433633,0.032418930696970646,89661776,2760,1736,4496
2361,FNV,0.06146542231528783,0.013794604108976727,25164564480,2023,2478,4501
2362,ALE,0.03115599484314568,0.02852585147080535,3582919424,2586,1915,4501
2363,SRC,0.036008841133129195,0.02589267062632398,5028658176,2468,2041,4509
2364,WSR,0.03091273272725633,0.028500503931700453,408645088,2592,1917,4509
2365,INOD,0.06423982869379015,0.012559844906628129,180757904,1988,2523,4511
2366,NXPI,0.07948860478043357,0.006515007146017024,58496970752,1807,2705,4512
2367,SAFE,0.042311689713819885,0.022865553818233166,3717375488,2364,2150,4514
2368,CEV,0.02782175265161508,0.029996856756150044,95447304,2660,1854,4514
2369,ENX,0.028316106325871122,0.029686560138837005,224304560,2647,1868,4515
2370,NIM,0.02963663325565935,0.02895325606891785,132667064,2617,1899,4516
2371,KTCC,0.03544398417790513,0.025994200506562554,87045976,2484,2035,4519
2372,DAN,0.0396505376344086,0.023916886629957713,3523628800,2410,2110,4520
2373,NERV,0.04663907908359105,0.02038614641894499,112785032,2278,2246,4524
2374,EVK,0.030030008263144923,0.0284521651321635,38507820,2607,1919,4526
2375,NBO,0.02810795150146477,0.029594695042508862,63289988,2654,1872,4526
2376,LBPH,2.600297176820208,-0.034041051329275825,257815072,75,4453,4528
2377,MMSI,0.06312772079193095,0.012283046477233092,3368725504,2001,2536,4537
2378,FLMN,0.04863675698075493,0.018402846024002974,393509920,2234,2306,4540
2379,VG,0.08018837687340544,0.004980257224181071,3051866880,1796,2745,4541
2380,SGMS,0.0648820326678766,0.01098434747383974,3920524800,1975,2568,4543
2381,AMSWA,0.06837529535459509,0.009595338188709841,662662080,1934,2611,4545
2382,QUMU,2.3079868708971554,-0.03443199723799723,110753376,84,4462,4546
2383,CBLI,0.8738185608037689,-0.027804047985325514,94669664,179,4367,4546
2384,RSI,4.864867821330902,-0.038694180560903076,3302671872,45,4505,4550
2385,CIO,0.031892006376171844,0.02702907751245131,483877664,2568,1983,4551
2386,COUR,0.3187573905009024,-0.008727064470323644,7555718144,554,3999,4553
2387,EQR,0.04174112794696904,0.022218998832018687,26958440448,2374,2182,4556
2388,NYV,0.02649010337297783,0.02949714611455941,34758984,2681,1877,4558
2389,AGR,0.026763911047439196,0.029329971571479038,15941939200,2677,1884,4561
2390,SLG,0.028176460455190715,0.02853132102062656,5018224128,2651,1914,4565
2391,ARAY,0.050100688839521165,0.017322707346935542,459846592,2211,2355,4566
2392,EVM,0.027816223938821313,0.02880199245514081,291933440,2661,1905,4566
2393,HY,0.04664137469314885,0.0187564886681516,1436762112,2277,2294,4571
2394,AAT,0.0322829996829319,0.0265700571657355,1997439616,2560,2011,4571
2395,EGP,0.04889664063670762,0.017708609949662026,5848997888,2230,2342,4572
2396,WTI,0.03550101625277683,0.024245197669014465,512297952,2480,2092,4572
2397,PKOH,0.03618925831202046,0.02396326028125816,422674528,2465,2108,4573
2398,HE,0.03095813843258627,0.027079428053077878,4677226496,2591,1982,4573
2399,TLSA,1.9949728534084055,-0.036017537959747666,268298144,97,4477,4574
2400,NRO,0.031171605694420255,0.026955859293086193,220030576,2585,1989,4574
2401,RADA,0.0674399784192069,0.008737646477111212,640397120,1942,2637,4579
2402,EVY,0.02762301012269991,0.028520987237743132,76868040,2663,1916,4579
2403,MSEX,0.04108712663671695,0.02191934810199342,1394295040,2387,2196,4583
2404,KELYB,0.02815115394369769,0.02822247011438735,870614528,2652,1931,4583
2405,IGA,0.026056615470409397,0.028958553627975635,170808544,2687,1897,4584
2406,LOTZ,0.2978224018776894,-0.007362088105138285,893446208,616,3969,4585
2407,TIGO,0.040348612007746934,0.022133228590443702,3941234176,2398,2187,4585
2408,KEX,0.0313683082225563,0.026650279584115037,3710917376,2577,2008,4585
2409,BKTI,0.04528261490151299,0.01946415742131971,62309760,2311,2276,4587
2410,TDC,0.0630952380952381,0.010189571118383086,4340396544,2002,2588,4590
2411,SUP,0.03514349207540348,0.024170958640348458,146385664,2497,2096,4593
2412,MYC,0.03101490204864784,0.02670096289581005,314867040,2589,2005,4594
2413,DCP,0.02929427430093209,0.027236725453886657,4642260992,2624,1974,4598
2414,MPAA,0.03706516921007086,0.02288669385444516,437722016,2450,2149,4599
2415,AQN,0.035615141462507036,0.02347796807027217,9803667456,2476,2125,4601
2416,LSEA,0.024376838289907603,0.02918720240006905,450752256,2714,1887,4601
2417,PETZ,17.663253867423958,-0.045373348333757973,126087552,15,4587,4602
2418,OMCL,0.06609631624316305,0.008668412667204538,5739595776,1964,2638,4602
2419,CLPR,0.02850315707973462,0.02752784350091956,144247536,2639,1963,4602
2420,UMH,0.04280929880929881,0.020404035327102697,828780672,2358,2245,4603
2421,CHCT,0.042949824195498296,0.02008352421551729,1162871424,2353,2252,4605
2422,VOR,1.041575597454065,-0.0341849445260159,1306902144,150,4456,4606
2423,LGND,0.06312915189305947,0.009671829103956926,2548176128,2000,2607,4607
2424,LAZR,0.29891395154553047,-0.008592078650994664,7298278400,612,3996,4608
2425,OUST,1.1798035634963724,-0.03558946098868023,1267377024,139,4471,4610
2426,EVI,0.06983345474641413,0.006966685211080538,341324000,1918,2695,4613
2427,KEN,0.03808073115003808,0.02216659742176298,1720646144,2435,2186,4621
2428,STAR,0.029758892292450868,0.026608750163946236,1365655168,2612,2009,4621
2429,BIO,0.0344952251408879,0.023848952190544063,17168822272,2510,2112,4622
2430,PAVM,36.42901716068643,-0.048939098593737906,474149056,7,4616,4623
2431,ZTR,0.03349775337899047,0.024213685646503016,447876896,2533,2094,4627
2432,BHV,0.03089211048213233,0.025953937848071082,26606180,2593,2036,4629
2433,PFGC,0.055674593417401386,0.012922362991025498,7808258560,2118,2515,4633
2434,BRBR,-0.08912646395186419,0.09843554250332566,952566848,4370,265,4635
2435,VC,0.051303616484440706,0.014799368694838144,3444797440,2194,2442,4636
2436,HAL,0.04291239030194854,0.01921796986300023,19033982976,2354,2283,4637
2437,ELYS,0.4864727984005048,-0.023470307326933556,116315000,330,4309,4639
2438,AVK,0.03288885482483146,0.024291932274906534,625251392,2552,2088,4640
2439,KELYA,0.02815115394369769,0.026979462241664115,943096256,2652,1988,4640
2440,ENVB,1.2676820116570922,-0.039667828097223,56017444,130,4514,4644
2441,ICCH,0.024522068042031418,0.028208269180758704,48920952,2710,1934,4644
2442,ETH,0.038868524951901594,0.020927839386050858,698050048,2418,2227,4645
2443,TPIC,0.056206953551159844,0.012228123303634085,2044063488,2110,2537,4647
2444,MAA,0.04196846639321402,0.019429213691773656,16966707200,2370,2279,4649
2445,TSE,0.03756873813810891,0.021313638759558415,2454393856,2443,2209,4652
2446,ESS,0.040623265433240865,0.019801773767448252,18382393344,2391,2263,4654
2447,ETM,0.049903543176314735,0.01487920948142268,719848768,2216,2440,4656
2448,AVB,0.0385273430860336,0.020880152218540008,26200381440,2426,2231,4657
2449,TZOO,20.02333931777379,-0.05171982875816504,195019632,12,4647,4659
2450,ALOT,0.040417296543017095,0.01973056914412116,102251192,2396,2264,4660
2451,VECO,0.04579602679381946,0.017184487882984743,1056284288,2299,2363,4662
2452,ADC,0.03395813428207174,0.022898252670643944,4338221568,2520,2148,4668
2453,SNR,0.030088056482235472,0.025315924506286426,536094720,2605,2064,4669
2454,CMG,0.06366129714611975,0.007699517494694434,42274164736,1997,2673,4670
2455,KIM,0.03033915322759785,0.025044008839262135,8408755200,2602,2069,4671
2456,FPI,0.028039435947962623,0.02641506646148963,348182464,2655,2018,4673
2457,AGFY,1.6386928104575162,-0.044364458185818675,262821536,106,4570,4676
2458,GLUU,0.057719469031528366,0.010181687885089153,2198585856,2089,2589,4678
2459,JT,-0.18174659282650954,1.3912153172828106,54103552,4664,14,4678
2460,SATS,0.02560852723264238,0.026999468564709708,2203735296,2695,1985,4680
2461,EYES,18.84970238095238,-0.054048287107504984,232409504,13,4669,4682
2462,AG,0.048561877856237966,0.0147349021925075,3738779648,2236,2446,4682
2463,AHH,0.030392368808876868,0.024638079278362174,769662080,2600,2082,4682
2464,CRESY,0.02684543049116338,0.026571942346330302,542628928,2674,2010,4684
2465,NHC,0.030019498712706344,0.024806243799221212,1144373760,2608,2078,4686
2466,XTNT,0.06984779925956397,0.003966102705859323,190756048,1917,2770,4687
2467,LANDM,0.02684226361631711,0.026500887023943695,407264448,2675,2013,4688
2468,DIS,0.05895836581942929,0.009403106197779136,340470169600,2072,2619,4691
2469,AENZ,0.03141818222714388,0.023737429201185087,418176960,2576,2115,4691
2470,FEO,0.02596703577731874,0.02675700815359142,73030032,2691,2002,4693
2471,BRID,0.03227455841338705,0.023223530370847782,132794024,2561,2135,4696
2472,DLPN,0.5308145150270517,-0.030656478623499267,88105368,295,4402,4697
2473,OZON,-0.18413052721088435,0.5465523203751644,11795955712,4668,29,4697
2474,FRT,0.037231454305367166,0.020081271719712263,8163067392,2447,2253,4700
2475,GNL,0.02860758626584885,0.02532313044104384,1729067136,2638,2063,4701
2476,BZM,0.027863768739076814,0.025866070342897642,31901448,2659,2044,4703
2477,MNP,0.025458409485884032,0.02674663005473824,149576336,2700,2003,4703
2478,BOXL,1.0952314943166066,-0.043614823029474455,146391008,145,4561,4706
2479,CLPS,0.052273027968054143,0.012437589009208138,99101664,2176,2530,4706
2480,SKX,0.035848480198444936,0.02072876793019296,6849331200,2472,2235,4707
2481,CPNG,0.24715394457568157,-0.006501424744806732,77747298304,763,3945,4708
2482,EM,-0.04110665429401024,0.06938934851056937,2100251136,4170,538,4708
2483,RRR,0.04171590897313786,0.017805417324084433,4049679360,2376,2334,4710
2484,DDF,0.03312275495677989,0.022441084263690483,79993296,2544,2168,4712
2485,SBLK,0.02327952003188666,0.026904119597856557,1457831040,2727,1992,4719
2486,HCCI,0.03885462792796304,0.018589791711941032,662074816,2419,2301,4720
2487,DOC,0.03133158153668647,0.022917556579677194,3889721344,2579,2144,4723
2488,GLTO,-0.20259591640065047,4.3637445824546255,150307712,4718,5,4723
2489,CAAP,1.2796639037129556,-0.046110356030101336,799792768,129,4597,4726
2490,NUO,0.02460887286735983,0.02626809520167273,287942528,2709,2026,4735
2491,DRI,0.04700854700854701,0.013914338443218117,19070367744,2268,2470,4738
2492,SANA,0.6594324533591052,-0.03946850003107132,6005816832,232,4512,4744
2493,IMXI,0.053987647464701034,0.009878221360963942,559896640,2144,2601,4745
2494,CGEM,0.7778336427392739,-0.042788033453557486,1563968512,200,4547,4747
2495,AEF,0.025581807687254564,0.025309757496254214,438495584,2697,2065,4762
2496,ONTO,0.051660093044868426,0.01071509251073831,3502833152,2189,2575,4764
2497,JRS,0.03123119359944519,0.02224106960029609,283146496,2583,2181,4764
2498,EPRT,0.03157116008355003,0.021993703664168064,2565370624,2572,2194,4766
2499,FANG,0.03018278800494373,0.02258047416254939,13792727040,2604,2162,4766
2500,RYAM,0.02219908443503164,0.02607140442633523,607850624,2734,2034,4768
2501,LXP,0.031488445389453945,0.021721833770887256,3180780288,2573,2201,4774
2502,LAND,0.02684226361631711,0.02408396380546557,514022432,2675,2102,4777
2503,MIN,0.023611638194661198,0.025388904599259667,425466784,2720,2061,4781
2504,JTD,0.02423716234953406,0.025151080323922357,219292304,2716,2067,4783
2505,LNTH,0.049910762871715635,0.010944902099056382,1419028992,2215,2569,4784
2506,UVE,0.0382811025108552,0.01740247334395652,435319520,2432,2352,4784
2507,VSTO,0.04598574645746643,0.013294168861392305,1885592448,2290,2495,4785
2508,DAR,0.048843881512735034,0.01127306080826782,11541371904,2231,2555,4786
2509,CDAY,0.06469046839174582,0.0022962596972453835,12873987072,1977,2814,4791
2510,MARK,2.343945720250522,-0.058463115983323835,212822992,83,4714,4797
2511,AMPH,0.03669881922116282,0.017715378801908686,841459648,2458,2341,4799
2512,RYN,0.035417434596520934,0.01825844778218163,4593774592,2488,2312,4800
2513,MFV,0.028317195556204273,0.022788705362763468,45891948,2646,2154,4800
2514,STAG,0.03459704813274326,0.018755152729203875,5496283136,2506,2295,4801
2515,ACVA,0.23793853829414574,-0.008647726046582026,4727811584,805,3997,4802
2516,CUZ,0.026962832222560483,0.02333392996737235,5367507968,2672,2130,4802
2517,UGRO,0.3724384151424043,-0.02672211077803837,87366656,462,4352,4814
2518,PIM,0.04219754311610546,0.014667527377025862,216472784,2365,2449,4814
2519,REG,0.029483135042507966,0.021963831776760253,9895934976,2619,2195,4814
2520,INTG,0.03542303402523285,0.017845060421601392,84375448,2486,2332,4818
2521,IIPR,0.040565262333120626,0.015225951664226625,4534512640,2392,2427,4819
2522,SGA,0.020417496978210447,0.02508421070544346,127083288,2755,2068,4823
2523,TEX,0.036596207032793364,0.01713634021943174,3101443840,2459,2365,4824
2524,PNRG,0.019579715376869145,0.02556989349872617,93128208,2771,2055,4826
2525,APPF,0.06077803480182295,0.002933001246143363,4892024320,2033,2796,4829
2526,BW,0.05007944968521834,0.00940609420972295,762379648,2212,2618,4830
2527,KRC,0.02797409802923752,0.022341942687860647,7816505344,2657,2176,4833
2528,SGMA,0.027127506633605594,0.022392244100962046,23799482,2668,2171,4839
2529,DXPE,0.0383427437572824,0.01572077177688495,579184896,2431,2409,4840
2530,VTGN,10.324349811395672,-0.06890632010629677,300464672,25,4817,4842
2531,FLUX,6.886937431394072,-0.06748043583628029,169582192,37,4807,4844
2532,GMRE,0.03124601106047696,0.019689149034978707,835312320,2581,2267,4848
2533,CMLS,0.028480725623582767,0.021270231105802735,193670704,2640,2211,4851
2534,GLRE,0.025887026642905805,0.022599726458420732,309597760,2692,2160,4852
2535,HYRE,3.6790550571817326,-0.06650956664324911,223431088,60,4794,4854
2536,COHU,0.05155570071372993,0.007980554509804364,2353392640,2190,2666,4856
2537,PDM,0.026318739091680587,0.022366295816726244,2195295744,2684,2173,4857
2538,PLD,0.034679846111814544,0.017203039653315468,81098244096,2503,2362,4865
2539,DNP,0.024956786570742854,0.02263797268702443,3074471680,2707,2158,4865
2540,CLAR,0.04563276713518207,0.011127794403062496,552069312,2305,2561,4866
2541,CNA,0.02717657569382403,0.02142640872263506,12544108544,2667,2205,4872
2542,COMP,0.4494638776586395,-0.039357065005486455,6655127552,365,4511,4876
2543,BFLY,0.5702033227373599,-0.04819335122774291,3290170880,269,4610,4879
2544,NUVA,0.043839521776080595,0.012036077438065706,3424410368,2336,2544,4880
2545,CHDN,0.05094510616261005,0.007443131817222123,8598406144,2199,2683,4882
2546,BDN,0.02515835894186255,0.022264076918024796,2206672640,2703,2180,4883
2547,GTBP,0.5984642707898036,-0.05029618778339182,208112624,253,4631,4884
2548,CVA,0.031136857349746562,0.01873999929042518,1805114368,2588,2296,4884
2549,SITC,0.02843615220679611,0.020472127964115364,2943798528,2642,2242,4884
2550,EVT,0.026410293980011847,0.02164647291466459,1954567040,2683,2202,4885
2551,PLXP,4.249232341001609,-0.07133466006534782,207581968,50,4836,4886
2552,WIW,0.02833037462174305,0.020332064250836557,749505216,2645,2247,4892
2553,NTCT,0.049104671374384436,0.007753653332724198,2109160320,2226,2670,4896
2554,MSTR,0.048367195087432646,0.008149430009391499,6291002880,2241,2655,4896
2555,PLNT,0.04963063237284858,0.007568551358857475,7053340672,2221,2676,4897
2556,COLD,0.035511119793054054,0.015606937162074298,9983599616,2479,2418,4897
2557,TAL,0.05380387628674022,0.004737702574843877,34936520704,2147,2752,4899
2558,WIA,0.025721990286776797,0.021267208939148786,299704416,2694,2212,4906
2559,AWP,0.025587624696951826,0.021242399400984505,509885728,2696,2214,4910
2560,RIG,0.012436320047947258,0.025595983036734073,2194088960,2861,2053,4914
2561,RPAI,0.025539054839279714,0.021039624886150438,2366357760,2698,2222,4920
2562,AP,0.016126864276029735,0.024007139694635794,137588944,2814,2106,4920
2563,SCPS,5.545921097755167,-0.07746830059828465,129123600,41,4887,4928
2564,TSLA,0.05430607359572454,0.0030132753241700486,644033216512,2136,2794,4930
2565,BOE,0.021509968432183033,0.022090559561246188,754437120,2743,2190,4933
2566,WNC,0.03604497713180397,0.013983542018359165,959835520,2466,2468,4934
2567,CPT,0.03338854225951605,0.0161059441311042,11035181056,2538,2397,4935
2568,LEVI,0.03863826049921101,0.012836801166325112,9779719168,2422,2516,4938
2569,DEA,0.026303011262692553,0.020008121619440992,1716491904,2685,2254,4939
2570,SNP,0.013898181641620742,0.024100796522740935,75393294336,2843,2100,4943
2571,SQFT,0.02190922811315626,0.021327994263813897,36688376,2738,2208,4946
2572,PUK,0.004693708337438019,0.027111602199864547,56973029376,2970,1981,4951
2573,CXDO,0.04037222101527989,0.011233098870854946,112403232,2397,2558,4955
2574,TOT,0.025147240931468785,0.0200877958527678,121365258240,2704,2251,4955
2575,OVV,0.02897781551852245,0.017958120305734196,6422036480,2632,2327,4959
2576,MGF,0.022121675151474653,0.020894445021158625,143053872,2735,2229,4964
2577,DNLI,0.04092312249727747,0.010616231567056326,6343191040,2390,2577,4967
2578,BOLT,0.5163898280170514,-0.053857185435534784,907470912,302,4666,4968
2579,VTR,0.028276945315149668,0.01805585930069963,20418916352,2648,2323,4971
2580,PGRE,0.01732502853359686,0.022316720018315504,2274900992,2793,2178,4971
2581,TRQ,0.012141016558724687,0.02402370721776078,3517862400,2868,2104,4972
2582,VICR,0.048928629784261025,0.005001179746281697,3594009600,2229,2744,4973
2583,CYCCP,-0.30994288378598905,0.7097441884689791,15934319,4951,23,4974
2584,TRNO,0.03300456113542173,0.01522204689727379,4096963072,2547,2428,4975
2585,WELL,0.026918894448778374,0.018500447058265354,31387201536,2673,2304,4977
2586,UTF,0.028181317210986996,0.017879067281660416,2739836160,2650,2330,4980
2587,CHPT,0.23235386184209264,-0.015291902288711938,7914878464,828,4160,4988
2588,AMH,0.028442807785437424,0.017454768498788083,10880661504,2641,2351,4992
2589,CMMB,0.26770665232203694,-0.022301056798237424,278148000,700,4293,4993
2590,DRE,0.03291759200123655,0.014726304576922417,16075675648,2550,2447,4997
2591,INVH,0.028354400275497155,0.01734322590283414,18459977728,2644,2354,4998
2592,TDUP,0.2781532472804996,-0.025959321895818847,1765423488,668,4336,5004
2593,JFU,-0.331449182049822,0.8461018361673208,327920896,4983,21,5004
2594,CTO,0.02038473070213694,0.020317530227241743,314613536,2757,2248,5005
2595,DEN,0.03176700840109332,0.015003469092597218,2297045760,2570,2436,5006
2596,RXDX,0.3552820135954437,-0.040271480452536874,751833408,484,4527,5011
2597,NISN,0.04784953667923737,0.004385655972919961,415747552,2254,2761,5015
2598,GLU,0.02038709467775282,0.019857031695274033,106994424,2756,2261,5017
2599,IKNA,0.5064560668821217,-0.058201103369748854,707670464,308,4710,5018
2600,LNC,0.0022576119860738,0.026333152081044073,12243081216,2997,2022,5019
2601,HTA,0.026568379451060203,0.01773568283545335,6234260992,2680,2340,5020
2602,AVCT,2.026917553191489,-0.08311663185483378,114765512,95,4931,5026
2603,ARE,0.026735136406355053,0.017510945379008932,23374489600,2678,2349,5027
2604,WDC,0.03590944574551132,0.011235500520630623,22106324992,2471,2557,5028
2605,ADT,0.04121590537085233,0.008373611150918898,7387943936,2385,2644,5029
2606,ALCO,0.019031010498820528,0.019999765077902423,217062416,2777,2255,5032
2607,PCYO,0.03861783139995207,0.009598863848400379,321743552,2423,2610,5033
2608,WRI,0.026004680444567625,0.01753457794250024,3476232448,2688,2347,5035
2609,IRT,0.026436146688288274,0.017280734354953795,1577491968,2682,2357,5039
2610,MTL,-0.1061526836600992,0.06565972537002955,501488384,4435,604,5039
2611,OR,0.020207996557619175,0.019435538968192716,1988125440,2762,2278,5040
2612,SSNT,0.044376720483178526,0.00596311939388429,36389884,2326,2715,5041
2613,SRAX,2.00570736769284,-0.08656766616080157,115001568,96,4949,5045
2614,MKGI,10.56005712142018,-0.09849327747440342,56672716,24,5022,5046
2615,HNRG,0.015852000517933444,0.020966934566174815,68572224,2822,2226,5048
2616,MAXR,0.039291217257318954,0.008780370191756343,2712411136,2416,2633,5049
2617,IGR,0.023333389247766623,0.018000775579907244,923392832,2725,2326,5051
2618,BGY,0.018586569069073723,0.019487728894678046,638978944,2780,2274,5054
2619,ITRM,3.6072310801706715,-0.0944572688675969,277070464,61,4996,5057
2620,KTOS,0.03849423193685489,0.00887691601819591,3453260032,2427,2631,5058
2621,BDJ,0.019828197764388975,0.018984953649798304,1776328704,2769,2290,5059
2622,UTG,0.023807834883011105,0.017656848109660044,1884783104,2718,2344,5062
2623,ARES,0.02799740097424763,0.015776328123280343,8339264000,2656,2407,5063
2624,SLAB,0.04368954952561711,0.005749904251958728,6411131392,2342,2723,5065
2625,GWRS,0.028733831099132696,0.015158944853779815,376993728,2634,2431,5065
2626,DHC,0.01558394291721675,0.020504584591125054,1146069120,2826,2239,5065
2627,MCRI,0.03331040050414935,0.012483612132234156,1182860288,2539,2529,5068
2628,NLSP,1.257097201734221,-0.08421860876846629,45868160,132,4938,5070
2629,CPE,0.023565353255246058,0.017373970759396277,1797224960,2721,2353,5074
2630,MDJH,0.04017426326175892,0.00770807663302029,52383600,2403,2672,5075
2631,KRMD,0.035677058438199724,0.009800335180653074,152551312,2474,2605,5079
2632,UPST,0.04727879943239641,0.0021639180830144503,9281449984,2264,2818,5082
2633,VSTA,0.028622166509975976,0.014717574008900088,786119872,2637,2448,5085
2634,VNO,0.020176607328756015,0.01806474184661887,8788935680,2763,2322,5085
2635,EPR,0.018351661598228767,0.018622399402903972,3677021440,2785,2300,5085
2636,CHUY,0.03006378440968494,0.013714768800759487,929478208,2606,2480,5086
2637,SUI,0.030229412089410726,0.0134781296049639,17188823040,2603,2487,5090
2638,NH,0.3286870792952109,-0.0433008889212324,375143040,535,4556,5091
2639,RQI,0.01922922520552904,0.01817807770095014,1902223488,2774,2317,5091
2640,FNCH,0.4054740435332463,-0.05515094005082188,801471808,419,4675,5094
2641,SNSE,0.33573145789228176,-0.04464179299342228,430380192,520,4574,5094
2642,EPSN,0.018571606747741432,0.01825632281565086,92345328,2781,2313,5094
2643,RFI,0.020139873632764267,0.017866132513905363,387983872,2764,2331,5095
2644,ADAG,0.4998313380192043,-0.06548965750044543,714947648,316,4782,5098
2645,MOVE,0.41297638966350625,-0.05581440018962122,192103824,412,4687,5099
2646,AFIN,0.016108842076295503,0.01913466115782478,1060072384,2815,2284,5099
2647,CLOV,0.2627310058691999,-0.02929401052297912,2986415360,713,4388,5101
2648,CALT,-0.41582266087024633,1.6894243080335312,670727232,5093,11,5104
2649,VVPR,0.04578465424692137,0.0027887721647765072,167194832,2301,2804,5105
2650,EQOS,3.17489587445322,-0.10334711004647293,388474144,64,5048,5112
2651,EOLS,1.4406626821851736,-0.09444362960574985,609204864,119,4995,5114
2652,OMEX,0.9248332992128077,-0.08567920528282585,88263528,168,4946,5114
2653,PHUN,0.6298090900281035,-0.0763120243326743,143847024,241,4874,5115
2654,SELF,0.019394412639425176,0.017658794774072763,45845380,2773,2343,5116
2655,AFINP,0.016108842076295503,0.018510640693156406,1153095424,2815,2303,5118
2656,SPE,0.016619147557840813,0.01820440657509716,124794240,2804,2315,5119
2657,CNHI,0.025991280880215902,0.01502221011015497,21297631232,2689,2435,5124
2658,CET,0.01745288824288732,0.017812447656250462,1016028352,2791,2333,5124
2659,UFS,0.016,0.018397171118509185,1885795712,2820,2307,5127
2660,USFD,0.03595638078396699,0.008122201472846887,8478558208,2470,2658,5128
2661,SBLKZ,0.019855671569500303,0.017210660511348272,1637654528,2768,2361,5129
2662,VNET,0.019900181349730303,0.017104709548803568,4276132608,2766,2366,5132
2663,VIRX,0.4546334146319069,-0.06479607773969735,327032256,361,4772,5133
2664,CCLP,0.02083722474731752,0.016549848809041333,95462688,2749,2384,5133
2665,FUND,0.017653943499025455,0.017542825087321686,240321616,2788,2346,5134
2666,HCI,0.02919231577866548,0.01301806036800671,663438144,2625,2511,5136
2667,UE,0.020271809111693136,0.01677857523011667,2008148992,2761,2375,5136
2668,LIVX,1.3483124905830948,-0.09690510724865471,313990976,125,5013,5138
2669,MELI,0.04574993389669828,0.001605720595573874,76899074048,2304,2835,5139
2670,BKNG,0.03934337267670601,0.005651030474963197,98744147968,2415,2726,5141
2671,HL,0.02303943762659359,0.01551427658225098,3212004096,2730,2419,5149
2672,HXL,0.029305222027758558,0.012509485873640837,4740532224,2623,2527,5150
2673,UPS,0.03548151689775787,0.007731977323702529,149495562240,2481,2671,5152
2674,QNST,0.03790030479052523,0.005926893468333773,1068594816,2438,2718,5156
2675,BTO,0.02369697209436849,0.014971680523420426,721243264,2719,2437,5156
2676,CBRL,0.029686315023757563,0.012075229856912811,4135047424,2615,2542,5157
2677,IVC,0.02870649084875478,0.0125478956792951,288329472,2635,2524,5159
2678,STRR,2.8513684210526318,-0.1142066186614357,16095038,70,5092,5162
2679,TTP,0.01719228853963314,0.017095926017233358,48692024,2795,2367,5162
2680,LABP,0.5708331007275907,-0.07862891029906463,381518400,268,4895,5163
2681,ACCD,0.20202375752229654,-0.017116351404100474,2725181184,965,4199,5164
2682,SCHN,0.02504098647627372,0.014324219615935227,1146192000,2706,2459,5165
2683,MILE,0.25480096872121977,-0.03190712499684132,1341340928,744,4428,5172
2684,NOW,0.04338404400558316,0.0019148202287150322,100154155008,2345,2828,5173
2685,EQNR,0.01844975262009895,0.016200112466315447,64855293952,2783,2394,5177
2686,NFJ,0.01681448440346003,0.0166034066988544,1343338112,2798,2382,5180
2687,GMTX,0.35063142498094396,-0.05610990885429922,581342464,492,4690,5182
2688,CHW,0.01986217178983756,0.015623837403778403,639392320,2767,2416,5183
2689,DEI,0.021701894141529728,0.014754608472649878,5707843584,2741,2444,5185
2690,DLR,0.02905433332513421,0.01106548979657796,40172187648,2628,2563,5191
2691,FUBO,0.5038776939337815,-0.07700868940934859,2906938880,311,4881,5192
2692,NEXI,0.40162722325461464,-0.06452526284623601,409640384,424,4769,5193
2693,SIF,0.02419883168641153,0.013836215542672762,80687976,2717,2476,5193
2694,HPP,0.017324348511967964,0.0160263901421458,4236356096,2794,2400,5194
2695,FSP,0.016021491128254524,0.016708038835274885,602110080,2819,2376,5195
2696,LFMD,21.964547547693186,-0.13595091800949938,420985504,10,5194,5204
2697,ANGN,0.9186882300089847,-0.10115996466343102,472341696,169,5037,5206
2698,ESRT,0.02551177931140811,0.013058002624598738,3252795904,2699,2507,5206
2699,VOYA,0.003790003864806573,0.020892856256088922,8202855936,2980,2230,5210
2700,JJSF,0.03290392393584173,0.008093261788274207,2984731904,2551,2660,5211
2701,LHDX,0.8574152656174464,-0.09933649383006646,346043392,183,5029,5212
2702,OUT,0.027763451951177583,0.011384686402066836,3223388928,2662,2553,5215
2703,PAVMW,4.148271398469283,-0.13096057605499414,58394600,51,5169,5220
2704,MP,0.03410500306915936,0.006515649167231934,5829023744,2517,2704,5221
2705,GRIL,1.900630057481757,-0.12109573260746694,25850004,100,5128,5228
2706,MGU,0.015004739471631964,0.016065980549473828,279165664,2833,2399,5232
2707,ACC,0.01909410176088124,0.01435848201640883,6093677056,2775,2458,5233
2708,SOR,0.01546470143945998,0.01562713089300927,369836736,2828,2414,5242
2709,MG,0.029337723670563594,0.009116468142000648,345547968,2621,2625,5246
2710,VNCE,0.023413861811253413,0.012672636531500107,136905520,2724,2522,5246
2711,CCJ,0.015635879695666263,0.015475587209161416,6908826624,2824,2422,5246
2712,HR,0.021987858108245474,0.013000295386892012,4384267776,2736,2513,5249
2713,VLON,3.7700787401574805,-0.13537559347693212,33238266,59,5192,5251
2714,BRG,0.016378353674277604,0.014800252543053753,227707024,2810,2441,5251
2715,OGCP,0.02053820124429235,0.013150058446470207,3187613696,2752,2502,5254
2716,ESBA,0.02053820124429235,0.013145274010925467,3189409024,2752,2504,5256
2717,CLF,0.020291409671940645,0.013165368246007409,9035206656,2758,2501,5259
2718,FISK,0.02053820124429235,0.013040462716090549,3229069312,2752,2508,5260
2719,GRWG,0.035665079036411536,0.003192410420754443,2864525312,2475,2787,5262
2720,PENN,0.020280727010977145,0.013061462991925664,16019472384,2759,2505,5264
2721,GUT,0.02179805768368693,0.012539608319488055,392209920,2740,2525,5265
2722,GEL,0.016798894061527132,0.014075120517389052,1181661568,2799,2466,5265
2723,ALTR,0.03712662838369381,0.002174854077705837,4778014720,2449,2817,5266
2724,NPTN,0.02706484626943429,0.010021839255386845,603290176,2669,2597,5266
2725,REXR,0.023082349314186512,0.012210192726961803,6917160960,2729,2538,5267
2726,RELI,0.9149793570089632,-0.1154918471814794,16398753,170,5098,5268
2727,ALEX,0.01592793980337233,0.014539195344377186,1235608320,2821,2450,5271
2728,XEC,0.024824311340966316,0.010988650472028665,6492496896,2708,2567,5275
2729,SYN,1.4395012751487672,-0.12724200156277224,83108848,120,5156,5276
2730,CSQ,0.01696222774045388,0.013589815006925611,2797136128,2797,2483,5280
2731,CRKN,1.0892786662338039,-0.12318294016857494,56327376,147,5134,5281
2732,HOG,0.01733173293942117,0.013416984611435053,6213775360,2792,2491,5283
2733,IRMD,0.029819827652962934,0.0075397972054116755,302971264,2610,2678,5288
2734,ETO,0.016278589528058794,0.013827228501421544,430448960,2811,2477,5288
2735,STAA,0.03688516934112944,0.0015741092174135654,5128657920,2454,2836,5290
2736,OSCR,0.35336054694259755,-0.06762374866948821,4966833664,485,4809,5294
2737,MOR,0.024478452276389562,0.010427585403209047,2895004416,2712,2582,5294
2738,QTS,0.023419745334007,0.01084907385741794,4169533952,2723,2571,5294
2739,CNFR,0.01625498968575026,0.013587026195988044,38533284,2812,2484,5296
2740,RPT,0.014986042495712991,0.01419640938715447,959324224,2834,2462,5296
2741,BLIN,0.3570829840737636,-0.06925986888098813,15708244,478,4823,5301
2742,CHGG,0.03315839945752586,0.004418310681835405,12409779200,2543,2758,5301
2743,YQ,-0.6107921340109759,4.347320582388639,1322576640,5295,6,5301
2744,COMS,1.2662102219643034,-0.13284539127409642,170412064,131,5177,5308
2745,DENN,0.03123303986009769,0.0054898892285434615,1150116224,2582,2730,5312
2746,ATI,0.018515361271183552,0.012406757754672343,2849347072,2782,2533,5315
2747,SPOK,0.02127543604651163,0.010912934539353943,205896720,2747,2570,5317
2748,AGE,3.8888483965014577,-0.152041329025016,61454864,58,5263,5321
2749,Y,0.012417372792186583,0.014252998455420392,9243470848,2862,2461,5323
2750,CUEN,1.2097087378640776,-0.13482227913275732,49197776,138,5187,5325
2751,WRE,0.016385866463396646,0.01279352761045135,1935557888,2809,2517,5326
2752,GVA,0.021276528785822466,0.010320921668662953,1782569728,2746,2583,5329
2753,CGO,0.0160976326706102,0.013003233990203365,142417872,2817,2512,5329
2754,BMTX,0.3267659127132151,-0.0664269670654601,145061568,541,4793,5334
2755,IVAC,0.018416409351565945,0.011495438100782915,185249024,2784,2551,5335
2756,BCV,0.014465704675488942,0.013266141620079006,166361360,2840,2496,5336
2757,GOGL,0.013427485448045328,0.013509629403482614,1418082304,2851,2486,5337
2758,AKTX,9.410253181339838,-0.16676461466503079,98876376,28,5310,5338
2759,APG,0.029736618521665252,0.005725254513015949,4390265344,2614,2724,5338
2760,CRY,0.028798517893622477,0.005989609386643357,873156160,2633,2712,5345
2761,KTRA,1.7930353682543863,-0.1486317422069949,54514280,103,5244,5347
2762,DIAX,0.013231351503509216,0.01321677713960646,599326464,2852,2498,5350
2763,NWHM,0.009584750796479292,0.014496603996962818,105032928,2899,2451,5350
2764,KERN,1.3572542711918827,-0.14417065676154261,112729992,124,5233,5357
2765,SIC,0.025402023449177177,0.008127594329551908,180872288,2701,2656,5357
2766,MDLY,0.015425109549157427,0.01248907191325474,27228862,2829,2528,5357
2767,HRTG,0.027255795034280484,0.006862533391126757,303142784,2665,2697,5362
2768,MOGU,-0.6830797213083797,3.360382295210729,216935520,5358,8,5366
2769,PODD,0.03225604409369911,0.002747009080835818,18403362816,2562,2805,5367
2770,NVCR,0.03283349549378657,0.0022331681152690658,13487660032,2553,2815,5368
2771,GLV,0.014911705172870762,0.012407063940411224,102658264,2836,2532,5368
2772,TREC,0.010720006421787373,0.013436752975074557,196710016,2881,2490,5371
2773,ASRT,1.4480233267783278,-0.15129799566502972,98217368,118,5256,5374
2774,BBIG,1.5081087600319938,-0.15176387113381093,44722584,114,5261,5375
2775,CRC,0.014470082127493155,0.012117887504837199,2011337472,2839,2541,5380
2776,FTAI,0.01658220263682844,0.010645559908114378,2413732096,2806,2576,5382
2777,SB,0.010661950634293465,0.013171171366497942,247685296,2882,2500,5382
2778,FAT,0.17887857957522887,-0.02318732275263657,107181064,1078,4305,5383
2779,DBTX,0.798804780876494,-0.13514641378262446,275411712,195,5190,5385
2780,POAI,5.015141191642194,-0.18177552407022368,60016988,43,5346,5389
2781,ATIF,0.8496614767123767,-0.13979580939240965,71907496,185,5204,5389
2782,PLIN,0.023477106904240243,0.007969603135757454,30728232,2722,2667,5389
2783,AXTI,0.02055723677345299,0.008625517257383246,490311200,2751,2639,5390
2784,IAF,0.013710241029760921,0.01206599113219392,138615120,2848,2543,5391
2785,VRPX,1.3134163382905912,-0.15327164454904177,22747690,128,5266,5394
2786,SMED,0.028986430528126394,0.003957578515835341,218613584,2631,2771,5402
2787,SHIPW,0.011614748492196729,0.01241385127246561,212609,2873,2531,5404
2788,TAST,0.010150691041994921,0.01271096863234302,315222240,2889,2519,5408
2789,BNSO,0.022439871063724276,0.007564235824956395,48390784,2733,2677,5410
2790,JOF,0.012401743268165052,0.011679312613530824,266055328,2863,2549,5412
2791,ECF,0.012276635580948301,0.011402389265360472,186563088,2865,2552,5417
2792,VYNT,0.326401282004589,-0.07662776281475782,115938000,543,4878,5421
2793,SVVC,0.006084634732572481,0.013776475036144742,39428300,2949,2479,5428
2794,MNRL,0.013780428374459183,0.010282842538746837,883226944,2846,2584,5430
2795,GGN,0.011703383350305416,0.011168011941769071,590181632,2872,2559,5431
2796,APOP,-0.8433676851684445,5.546145084365293,11454806,5435,2,5437
2797,GHM,0.015361122909208583,0.009558436239327839,142638208,2830,2613,5443
2798,CNDT,0.021455223880597014,0.006581316521887165,1444741504,2744,2702,5446
2799,KRG,0.012186394931283994,0.010531860822013692,1667757568,2867,2580,5447
2800,BCTX,1.0640110945880465,-0.16398815195360752,24668746,149,5304,5453
2801,IMMR,0.019690898683457355,0.007384269774370374,283669568,2770,2685,5455
2802,UXIN,2.163679787859896,-0.19191761348787534,488240608,88,5368,5456
2803,BTBT,0.029492777221850508,0.0015015598925466889,744876992,2618,2838,5456
2804,GDV,0.010491523509650564,0.01072298325063582,2210165504,2884,2574,5458
2805,METX,1.481465334938348,-0.1810857934046101,125238072,116,5343,5459
2806,YELL,0.01188858695652174,0.010163465886548605,462153568,2869,2591,5460
2807,NL,0.007216790953480208,0.012337344910263275,383969600,2933,2535,5468
2808,BXMX,0.010588951243174693,0.01024357763800215,1420787456,2883,2586,5469
2809,AIRC,0.01658386259941386,0.007764172924488128,6373620736,2805,2668,5473
2810,ADX,0.009778469298811253,0.01045834303649359,2075419648,2894,2581,5475
2811,TANH,0.008541902857345431,0.011083522587945507,54200092,2913,2562,5475
2812,ORPH,-0.9457921207562184,2.7738315751733547,317088096,5467,9,5476
2813,IMTE,1.1200887692875812,-0.17839605191027086,44292224,142,5336,5478
2814,AIG,0.006381902165929456,0.012147858361171875,40599203840,2944,2539,5483
2815,MGLN,0.014478049637919514,0.008301295559380452,2436611840,2838,2648,5486
2816,PINE,0.01159233698120175,0.009549549045875492,137008560,2874,2614,5488
2817,CIDM,0.12257264451396523,-0.012813130639368443,225697440,1388,4101,5489
2818,KXIN,15.782712765957447,-0.24793669773303226,191488384,16,5474,5490
2819,MRC,0.018726591760299626,0.005995007166191766,1009054720,2779,2711,5490
2820,ABUS,2.6187297087201062,-0.21151735233415525,313463200,74,5417,5491
2821,TNL,0.016415868673050615,0.007396336289484115,5563974144,2808,2684,5492
2822,GES,0.012254603896769701,0.009105422585350804,1637068672,2866,2626,5492
2823,GCV,0.00956165851313977,0.010147741668363785,118010176,2900,2592,5492
2824,SAIL,0.02819298748806876,0.0012873695887950704,4609990144,2649,2845,5494
2825,BIVI,0.11653955479346086,-0.010773192369362928,226416576,1450,4048,5498
2826,BALY,0.01882435620701772,0.005807299738538727,1921119360,2778,2722,5500
2827,MLND,-1.0350463256028084,5.07798659215038,23042090,5498,3,5501
2828,ROST,0.021679076531448318,0.00415982530758386,44009365504,2742,2763,5505
2829,TH,0.016199990564257406,0.007029602277028155,368499040,2813,2694,5507
2830,CTT,0.013175695351565425,0.008184084964189181,506672512,2854,2653,5507
2831,CVLG,0.010153286066105535,0.009349227277472538,344400000,2888,2620,5508
2832,CARA,0.02131204635221669,0.004110588218166554,1323231488,2745,2764,5509
2833,TLC,-1.0373535659592974,3.8168729467226514,260497360,5503,7,5510
2834,EAST,0.6806207719856745,-0.15932382907325285,22560842,224,5288,5512
2835,HIMS,0.1013702114556907,-0.006146793694081955,2475839488,1583,3933,5516
2836,URBN,0.012903504376351453,0.008011180036773697,3742060032,2856,2663,5519
2837,MXF,0.010161693353337222,0.008787258984147056,219376992,2887,2632,5519
2838,BNFT,0.018085724563490967,0.005362657983772925,454407296,2786,2734,5520
2839,HYFM,0.024508513001362538,0.0023511524126593507,1847220224,2711,2813,5524
2840,PEAK,0.013498141281828586,0.007635525566346171,17583427584,2850,2674,5524
2841,CRM,0.02508130753541701,0.0020914387004930582,203347591168,2705,2820,5525
2842,STFC,0.014374952961541357,0.0071917081734409515,850636352,2842,2688,5530
2843,SPXX,0.00941564579523082,0.008967265833613718,288650336,2903,2629,5532
2844,CHX,0.017168040707459656,0.005255339844547212,4249520384,2796,2737,5533
2845,TERN,0.31763666312068906,-0.09102613360910544,458784320,560,4974,5534
2846,SAFM,0.015269637226110267,0.006442890914995333,3651020288,2831,2706,5537
2847,AVIR,0.021928055242709053,0.002861444905539228,4732550656,2737,2801,5538
2848,NEW,0.20780111661528855,-0.04822093846168411,356758560,928,4611,5539
2849,EEA,0.008142608796545417,0.009036561909757088,78019664,2918,2628,5546
2850,SHOP,0.025247083334787448,0.0012295956837145836,142712209408,2702,2847,5549
2851,EMF,0.009486801340036677,0.008257407390417127,312575776,2902,2650,5552
2852,MIME,0.02286314620995877,0.002086917008063419,2562431488,2731,2822,5553
2853,TTCF,0.019992891416385286,0.0031672366593337464,1591076736,2765,2789,5554
2854,DARE,249.3630572668784,-0.3284740637264394,80431760,2,5554,5556
2855,UAN,0.009899240803815426,0.007990433554899586,505318080,2892,2665,5557
2856,GNK,0.006659292272611929,0.009533676747976158,453073056,2941,2616,5557
2857,ETB,0.00911659926706157,0.008242218117096278,422674784,2908,2651,5559
2858,VINO,0.7737359314811176,-0.1891193500127078,30498490,201,5361,5562
2859,TECK,0.005617040209109616,0.009779659143718545,10786116608,2957,2606,5563
2860,ETW,0.008431304292065863,0.008228209558533497,1118939648,2915,2652,5567
2861,PTVCA,0.007338454603403333,0.00857808247409886,323591424,2929,2640,5569
2862,RDWR,0.01553832206789326,0.0050129342492936085,1230630912,2827,2743,5570
2863,PTVCB,0.007338454603403333,0.008562854944657887,325221504,2929,2641,5570
2864,BTRS,0.08833996912326318,-0.0044327121632545385,2358964480,1694,3880,5574
2865,HROW,0.016711722782010323,0.0037366316507647344,181104288,2801,2774,5575
2866,ARDS,3.0477551020408162,-0.28461043855697565,64223584,67,5510,5577
2867,KFS,0.013187781420389854,0.005702518176609694,103108392,2853,2725,5578
2868,BRQS,0.5386835665432641,-0.1597156370830104,62683344,289,5290,5579
2869,INTT,0.016620396076253933,0.0036551021513947543,124262984,2803,2776,5579
2870,PTPI,4.113843616689285,-0.29940007857631823,32967878,53,5527,5580
2871,TWTR,0.01756815618790761,0.0030670939164477422,55064576000,2789,2792,5581
2872,COHR,0.016635151731186418,0.0035931240822661237,6410983424,2802,2779,5581
2873,QTT,6.905951618999438,-0.3192245679746657,666981440,36,5546,5582
2874,OXBR,0.010442624896167083,0.006877052370316767,15484180,2886,2696,5582
2875,VSAT,0.010006975008217383,0.007075320231008283,3359957248,2890,2693,5583
2876,PSTL,0.010735630649054985,0.006320367651824741,228348272,2880,2707,5587
2877,MAC,0.009545477645255995,0.007225796054747787,2299845120,2901,2687,5588
2878,TS,0.009338055986277133,0.007169741878245487,13347191808,2905,2689,5594
2879,MKD,1.0412125414400555,-0.23131898128378015,138714160,151,5449,5600
2880,GPM,0.007712015863549123,0.007632426337417028,352900992,2926,2675,5601
2881,JAN,0.8789447972642892,-0.21620661315368733,21390348,177,5425,5602
2882,TXRH,0.015595346545003809,0.0036243109065618602,6870137344,2825,2778,5603
2883,HCHC,0.0015387385617705316,0.010175653780992357,303173568,3013,2590,5603
2884,INDT,0.011746067590168446,0.005398027208988835,459458784,2871,2733,5604
2885,ANY,0.5741562198649952,-0.17999424163534655,26581836,266,5339,5605
2886,EOI,0.008110086391138834,0.007321356302634563,678337280,2919,2686,5605
2887,JRVR,0.009670370335956188,0.0059491219459859275,1449977984,2897,2716,5613
2888,ETY,0.007995026156781116,0.0071118537624571205,1972320896,2921,2692,5613
2889,IRDM,0.011080220823745391,0.00518256133227084,5373827584,2876,2738,5614
2890,AZRX,3.498640530689381,-0.32751559036464045,71223616,63,5552,5615
2891,PLMR,0.015767243760118982,0.002909087212820922,1849795968,2823,2799,5622
2892,OSMT,0.011760191717378427,0.00468055157784582,211990608,2870,2753,5623
2893,EXK,0.014776669495918472,0.003160066135579341,841304896,2837,2790,5627
2894,LGI,0.007286928490955244,0.006776794034071172,254209552,2931,2699,5630
2895,CHNR,0.20320098715250054,-0.055384067288783034,68686056,951,4681,5632
2896,SVT,0.005927304790829823,0.00747042883224973,20778392,2951,2682,5633
2897,CSR,0.008054878186275299,0.005974383677753466,899739584,2920,2714,5634
2898,FFA,0.0067699184930882445,0.006595670056102854,379473376,2940,2701,5641
2899,VWTR,0.01097665363119115,0.0040786350866391895,169315760,2877,2765,5642
2900,CII,0.006888210963941462,0.006564309343563666,870956416,2939,2703,5642
2901,WPG,0.0064406923534858366,0.006757355435002205,56147552,2943,2700,5643
2902,CLMT,0.009697209578468237,0.00440174848229509,474988000,2895,2760,5655
2903,DAO,1.3635618138900594,-0.30813667655017984,3075968512,123,5534,5657
2904,GAB,0.00693327485286688,0.005812680267244963,1824550784,2937,2721,5658
2905,NXRT,0.007722988188337513,0.0052977616215056315,1170921600,2925,2736,5661
2906,JEQ,0.005699343825035994,0.0061240787746016144,122151432,2955,2710,5665
2907,CONE,0.009092565295881018,0.004628061003256747,8419019264,2911,2755,5666
2908,STON,0.002901618192248658,0.007512246872733375,224044192,2988,2679,5667
2909,YALA,0.016094921413378212,0.001167896653316633,3434169856,2818,2852,5670
2910,DVN,0.009624258404746209,0.0038728408193038936,15158212608,2898,2772,5670
2911,UPLD,0.014419145371684193,0.0018072381325464214,1385104128,2841,2832,5673
2912,WORX,7.22525632297758,-0.5311066964899119,19822078,33,5642,5675
2913,AACG,1.934525892996074,-0.3633018213288164,125088496,98,5577,5675
2914,ADNT,0.009784735812133072,0.0034368133129167194,3959852544,2893,2782,5675
2915,ASR,-1.5355119621485702,0.20648540473197768,5530325504,5590,86,5676
2916,GRF,0.005166158843671217,0.005862479755860466,34224288,2962,2720,5682
2917,CXP,0.005084498558001163,0.005937169255622594,1981542016,2965,2717,5682
2918,PLYM,0.0072632346160139225,0.00475251446849159,483559104,2932,2751,5683
2919,BOOM,0.010446887343143765,0.002802486543282432,826110912,2885,2802,5687
2920,AVNS,0.010799926780157423,0.002569120810699292,2061705472,2879,2810,5689
2921,PXD,0.00814675887938108,0.003767241864866794,33273020416,2917,2773,5690
2922,REVG,0.009972008397480756,0.0029067046453227978,1184583552,2891,2800,5691
2923,BKD,0.0050561918127264025,0.005647386849230915,1232864640,2966,2727,5693
2924,MCN,0.0057328779117797836,0.005025402787080774,163595280,2954,2742,5696
2925,VCNX,1.1135961636728116,-0.3319625976542544,81625952,143,5558,5701
2926,HLT,0.01352145796590241,0.0010431372271048883,34567745536,2849,2858,5707
2927,NAII,0.005314025347143305,0.004893879950951961,103001392,2959,2749,5708
2928,LINK,0.012521343198634035,0.0012006201312124997,96697320,2860,2849,5709
2929,SPRT,0.00854386510877868,0.002914381418490812,113231048,2912,2798,5710
2930,NCTY,0.39261112330610115,-0.15580295213590872,386140352,438,5274,5712
2931,CD,0.0020704917806728088,0.0059799659396325144,5700980224,3000,2713,5713
2932,SWZ,0.004335449556005874,0.005053041083205492,118646448,2975,2740,5715
2933,TGB,0.004843757371789831,0.004792166881998209,515655168,2967,2750,5717
2934,DXYN,0.004635494321939845,0.004949512103789461,56366176,2971,2746,5717
2935,VCEL,0.012952901023890784,0.0009317642515518487,2556845312,2855,2864,5719
2936,ETV,0.005101284839591031,0.004604729361439822,1445629568,2963,2756,5719
2937,GORO,0.006930132729660755,0.0033263328292751733,208429760,2938,2783,5721
2938,BLCM,25.119832791453785,-2.9656032139916064,29030762,9,5713,5722
2939,CNX,0.00416958685233969,0.004918636562965611,3254668032,2977,2748,5725
2940,VAC,0.007907979870596693,0.002790265631339991,7296830976,2923,2803,5726
2941,LAIX,2.7413713759779106,-0.6073803882279821,118095160,71,5658,5729
2942,BIF,0.004511611446845497,0.004517785285665049,1262782336,2972,2757,5729
2943,ANPC,4.071203327087427,-0.7195175031061005,63735968,54,5676,5730
2944,ANDE,0.0063418501455431795,0.003177059556029593,917173504,2945,2788,5733
2945,CALM,0.005942170455945487,0.0032198169724980633,1932262656,2950,2786,5736
2946,TIRX,0.013784544098390522,0.000143364305282898,721600000,2845,2892,5737
2947,KF,0.005207029896114275,0.003651144524763039,224091904,2960,2777,5737
2948,HHR,-3.333453436676979,0.23932809231526206,1803393536,5678,67,5745
2949,BWEN,0.006249537208441318,0.0027011048056315707,102252368,2947,2807,5754
2950,CLM,0.004492412887620078,0.003253505500192447,1059381632,2973,2784,5757
2951,Z,0.009095102645587334,0.0011949029139022556,33419730944,2909,2850,5759
2952,ZG,0.009095102645587334,0.001194582513082345,33428914176,2909,2851,5760
2953,ANIK,0.005903965649654402,0.002674320893270142,564872832,2952,2808,5760
2954,USA,0.0037372079239736153,0.003474874515687486,1693317632,2981,2781,5762
2955,AXS,0.002616484470331308,0.003557168552743408,4346159616,2991,2780,5771
2956,AUUD,0.15948637981661987,-0.04807478837077271,34268356,1166,4608,5774
2957,CRF,0.0041468787342992044,0.0029271112543284,553103552,2978,2797,5775
2958,EDAP,0.00821690059788343,0.0009734339054437969,266062816,2916,2860,5776
2959,BPYU,0.0035507308448426886,0.0029774056195541656,688084928,2982,2795,5777
2960,SCKT,0.00700595243333304,0.0013214718259229343,55808696,2936,2844,5780
2961,GAM,0.002853809355324517,0.00307390576724849,1001557312,2989,2791,5780
2962,MIC,0.0048,0.002402291768409951,2798422528,2969,2812,5781
2963,RLX,0.008440218807649795,0.000801799623883254,15016753152,2914,2868,5782
2964,CTRM,0.0071222732030822465,0.0012200331544331574,357444672,2935,2848,5783
2965,FRPT,0.009268143156551622,0.0005507210999626956,6787090432,2906,2879,5785
2966,GEG,0.004071493361919683,0.0027110282956406143,63800172,2979,2806,5785
2967,MTSI,0.007475626188966392,0.0009867447265576171,3970131712,2927,2859,5786
2968,SRI,0.005206610268286151,0.0019436092750924308,812137792,2961,2825,5786
2969,FTFT,0.10556422095197916,-0.019561753083542542,317393504,1541,4246,5787
2970,HFFG,0.00559965044528888,0.0016799288281196998,367546880,2958,2834,5792
2971,RDFN,0.006502010747713441,0.0011434738437205323,6642338304,2942,2853,5795
2972,TLIS,0.8398946263102629,-0.42474888557452095,337134432,187,5610,5797
2973,EPAY,0.007133402749589679,0.0009294477608268826,2035795456,2934,2865,5799
2974,AEO,0.004262184396438616,0.001934018971818948,5189401600,2976,2826,5802
2975,KINS,0.0025593425234125625,0.002640185348200759,87002384,2993,2809,5802
2976,AEG,0.00040181543116490166,0.003971745446199948,10263226368,3033,2769,5802
2977,CLNY,0.003508887720617219,0.0020851619604553757,3255871744,2984,2823,5807
2978,COE,-0.1651908374955437,0.044111070341071375,428362080,4609,1200,5809
2979,TYG,0.002372798053645066,0.002204670420525395,309307456,2995,2816,5811
2980,AWX,0.002036358858982149,0.0024739745360584484,15207777,3002,2811,5813
2981,HSKA,0.006127726557229593,0.0007353930100817929,1773846784,2948,2870,5818
2982,GPP,-2.099048756558461,0.12175568892619044,287549600,5631,190,5821
2983,GLO,0.0023380801106102278,0.0019267495048588637,408605408,2996,2827,5823
2984,CHN,0.0020499520392537377,0.00204925570359996,315648736,3001,2824,5825
2985,TWN,0.0019393435127355158,0.002090653730614501,213161552,3006,2821,5827
2986,GLQ,0.002255444311484058,0.001853715265737932,206532784,2998,2831,5829
2987,ALJJ,0.0030074867222660666,0.0013488538129074327,67290392,2987,2843,5830
2988,AXON,0.005641999965138862,0.0006477549079049625,9393440768,2956,2875,5831
2989,NTST,0.0019447463250014299,0.0018982514507203268,525719712,3005,2829,5834
2990,HBIO,0.005085135757017948,0.0007149185026550196,250104144,2964,2872,5836
2991,RVT,0.001918683210758671,0.00186538835818699,1866105856,3007,2830,5837
2992,VTVT,0.15698844971919043,-0.05214097017821583,226663856,1184,4655,5839
2993,TTM,0.0019502774367342744,0.0013735207842130977,14587435008,3004,2841,5845
2994,GGT,0.0018968304453164748,0.001544618054479551,251630432,3009,2837,5846
2995,IHRT,0.003078107839994537,0.0009531332363680061,2496431616,2986,2861,5847
2996,ELAN,0.004426987983889758,0.0006237113073928115,14094168064,2974,2876,5850
2997,TJX,0.003549579713689475,0.0008034764608358913,81740644352,2983,2867,5850
2998,SLCA,0.0018474715240460334,0.001468844359180687,890932544,3011,2839,5850
2999,VRDN,0.6678678180006642,-0.4567248881598067,123282576,228,5623,5851
3000,DNK,0.57099638152929,-0.3778112282768574,432888800,267,5584,5851
3001,ANF,0.0014934999246634076,0.0013771826786827968,2342247168,3015,2840,5855
3002,CKX,0.0015321917390601597,0.0012377371680597868,25895856,3014,2846,5860
3003,AIV,0.0013359014704743231,0.0013673250441872595,957915392,3018,2842,5860
3004,CZR,0.001918610522064021,0.0011116192930064601,19284365312,3008,2855,5863
3005,KRP,0.0018913794021449977,0.001048042893080297,616685504,3010,2857,5867
3006,EVRI,0.0033896617232503983,0.0003610410526473441,1255457792,2985,2885,5870
3007,TCMD,0.002724907854186543,0.0003928647776377046,1031666816,2990,2882,5872
3008,RYB,0.00136510912649463,0.0010817420039586022,96276184,3017,2856,5873
3009,KSS,0.001218026796589525,0.0011253020400699711,9666754560,3019,2854,5873
3010,PRTS,0.0025653512357166463,0.00038500633420251665,730044160,2992,2883,5875
3011,CWK,0.002107867845850708,0.0005763977576455173,3599300096,2999,2878,5877
3012,ZEUS,0.0012033669072000403,0.000935895392649375,324826912,3020,2862,5882
3013,APHA,0.0020260656333252604,0.0005133758767200026,5140923904,3003,2880,5883
3014,SEAC,0.001416139421210114,0.0007966560593197298,69804304,3016,2869,5885
3015,BBGI,0.0017456493722636784,0.0006531029436198624,84835376,3012,2874,5886
3016,VCTR,-12.038335082196573,0.12466806678064561,1822546048,5711,175,5886
3017,TLS,0.002524329607751477,0.00013483355508565238,2269814784,2994,2894,5888
3018,BVH,0.0007822196644013561,0.0009330442574673476,380180288,3026,2863,5889
3019,TBI,0.001083526118870134,0.000606545256038281,794289728,3023,2877,5900
3020,TRUE,0.0005148595748491097,0.0007211576976545098,485582304,3030,2871,5901
3021,IIN,0.0011779920357494974,0.00040899773681991457,214885120,3022,2881,5903
3022,ASLE,0.0006140115589257338,0.0003642991100917655,518823968,3028,2884,5912
3023,PCOM,0.0010805657079294454,0.00014196770919401258,238674080,3024,2893,5917
3024,DJCO,0.0005223543937127526,0.00023277041434200264,440431648,3029,2888,5917
3025,ARGO,0.0007462358983363329,0.00017041544613653894,1829821568,3027,2891,5918
3026,SONO,0.001186049745865226,9.375052713930249e-05,4817140224,3021,2898,5919
3027,SVC,0.0003146255000166754,0.0003065111882651826,2030631680,3034,2886,5920
3028,OPRA,0.0004684028035621462,0.00021783679715329314,1217905792,3032,2889,5921
3029,BFAM,0.0008534514422389301,0.00011735415233150149,9663857664,3025,2897,5922
3030,ORBC,0.0004890905632692987,0.00013037852836771674,598976256,3031,2895,5926
3031,BME,0.00012612455867326065,0.00012190625024459902,556422912,3036,2896,5932
3032,GBS,0.11429670241866394,-0.03433422277119699,67688640,1472,4461,5933
3033,CVLT,0.0001593349304097703,1.8348061191147172e-05,3066123264,3035,2899,5934
3034,AACQ,0.0,0.0,932793728,3037,2901,5938
3035,ABCB,0.0,0.0,3615314688,3037,2901,5938
3036,ABTX,0.0,0.0,807890048,3037,2901,5938
3037,ACAC,0.0,0.0,268523872,3037,2901,5938
3038,ACBI,0.0,0.0,498107648,3037,2901,5938
3039,ACEV,0.0,0.0,287212480,3037,2901,5938
3040,ACNB,0.0,0.0,248552368,3037,2901,5938
3041,ADER,0.0,0.0,335843776,3037,2901,5938
3042,AFBI,0.0,0.0,82075192,3037,2901,5938
3043,AFCG,0.0,0.0,289259712,3037,2901,5938
3044,AGBA,0.0,0.0,56317060,3037,2901,5938
3045,AGC,0.0,0.0,1477124992,3037,2901,5938
3046,AGNC,0.0,0.0,9087497216,3037,2901,5938
3047,AGNCM,0.0,0.0,9150441472,3037,2901,5938
3048,AGNCN,0.0,0.0,8802649088,3037,2901,5938
3049,AHAC,0.0,0.0,137934144,3037,2901,5938
3050,AKIC,0.0,0.0,289688512,3037,2901,5938
3051,ALRS,0.0,0.0,521186240,3037,2901,5938
3052,ALTA,0.0,0.0,787764032,3037,2901,5938
3053,ALTU,0.0,0.0,377250016,3037,2901,5938
3054,AMAL,0.0,0.0,514021472,3037,2901,5938
3055,AMNB,0.0,0.0,354404960,3037,2901,5938
3056,AMRB,0.0,0.0,97247880,3037,2901,5938
3057,AMTB,0.0,0.0,682947008,3037,2901,5938
3058,AMTBB,0.0,0.0,681249984,3037,2901,5938
3059,ANDAU,0.0,0.0,46089312,3037,2901,5938
3060,ARBG,0.0,0.0,283187520,3037,2901,5938
3061,AROW,0.0,0.0,520066240,3037,2901,5938
3062,ASRV,0.0,0.0,66899504,3037,2901,5938
3063,ATAX,0.0,0.0,350344512,3037,2901,5938
3064,ATLC,0.0,0.0,447606464,3037,2901,5938
3065,ATLO,0.0,0.0,231717840,3037,2901,5938
3066,AUB,0.0,0.0,3006558976,3037,2901,5938
3067,AUBN,0.0,0.0,137909968,3037,2901,5938
3068,BANF,0.0,0.0,2290945024,3037,2901,5938
3069,BANR,0.0,0.0,1880696704,3037,2901,5938
3070,BCBP,0.0,0.0,232164832,3037,2901,5938
3071,BCML,0.0,0.0,200912192,3037,2901,5938
3072,BCOW,0.0,0.0,68072152,3037,2901,5938
3073,BCYP,0.0,0.0,147034464,3037,2901,5938
3074,BFC,0.0,0.0,551049216,3037,2901,5938
3075,BFIN,0.0,0.0,150421888,3037,2901,5938
3076,BFST,0.0,0.0,490550400,3037,2901,5938
3077,BGCP,0.0,0.0,1964429312,3037,2901,5938
3078,BIOT,0.0,0.0,278587488,3037,2901,5938
3079,BKSC,0.0,0.0,117917240,3037,2901,5938
3080,BLTS,0.0,0.0,281175008,3037,2901,5938
3081,BMRC,0.0,0.0,522089280,3037,2901,5938
3082,BMTC,0.0,0.0,900858624,3037,2901,5938
3083,BOCH,0.0,0.0,213887520,3037,2901,5938
3084,BOKF,0.0,0.0,6225304576,3037,2901,5938
3085,BOKFL,0.0,0.0,5266101760,3037,2901,5938
3086,BOTJ,0.0,0.0,64829352,3037,2901,5938
3087,BPFH,0.0,0.0,1082320384,3037,2901,5938
3088,BPOP,0.0,0.0,6001849344,3037,2901,5938
3089,BPRN,0.0,0.0,187671824,3037,2901,5938
3090,BRKL,0.0,0.0,1179144448,3037,2901,5938
3091,BRLI,0.0,0.0,60804448,3037,2901,5938
3092,BRPAU,0.0,0.0,123100392,3037,2901,5938
3093,BSBK,0.0,0.0,140791904,3037,2901,5938
3094,BSRR,0.0,0.0,414579680,3037,2901,5938
3095,BSVN,0.0,0.0,153840144,3037,2901,5938
3096,BTNB,0.0,0.0,384962496,3037,2901,5938
3097,BTWN,0.0,0.0,795803904,3037,2901,5938
3098,BUSE,0.0,0.0,1390576384,3037,2901,5938
3099,BWB,0.0,0.0,450893472,3037,2901,5938
3100,BWFG,0.0,0.0,216344928,3037,2901,5938
3101,BYFC,0.0,0.0,64167468,3037,2901,5938
3102,CAC,0.0,0.0,706880960,3037,2901,5938
3103,CACC,0.0,0.0,6038489600,3037,2901,5938
3104,CALB,0.0,0.0,137082336,3037,2901,5938
3105,CAPA,0.0,0.0,174256192,3037,2901,5938
3106,CARE,0.0,0.0,376341824,3037,2901,5938
3107,CARV,0.0,0.0,31999394,3037,2901,5938
3108,CASH,0.0,0.0,1504719616,3037,2901,5938
3109,CATC,0.0,0.0,571431616,3037,2901,5938
3110,CATY,0.0,0.0,3267461120,3037,2901,5938
3111,CBAN,0.0,0.0,144624240,3037,2901,5938
3112,CBFV,0.0,0.0,117382392,3037,2901,5938
3113,CBMB,0.0,0.0,49907472,3037,2901,5938
3114,CBNK,0.0,0.0,266100992,3037,2901,5938
3115,CBSH,0.0,0.0,9080569856,3037,2901,5938
3116,CBTX,0.0,0.0,776199232,3037,2901,5938
3117,CCB,0.0,0.0,316183872,3037,2901,5938
3118,CCBG,0.0,0.0,433637728,3037,2901,5938
3119,CCNE,0.0,0.0,412987520,3037,2901,5938
3120,CENH,0.0,0.0,431249984,3037,2901,5938
3121,CFB,0.0,0.0,697728000,3037,2901,5938
3122,CFBK,0.0,0.0,132121680,3037,2901,5938
3123,CFFI,0.0,0.0,156063568,3037,2901,5938
3124,CFFN,0.0,0.0,1831571456,3037,2901,5938
3125,CGRO,0.0,0.0,185371872,3037,2901,5938
3126,CHCO,0.0,0.0,1290524928,3037,2901,5938
3127,CHMG,0.0,0.0,200029248,3037,2901,5938
3128,CIVB,0.0,0.0,364166336,3037,2901,5938
3129,CIZN,0.0,0.0,110344632,3037,2901,5938
3130,CLBK,0.0,0.0,1918180736,3037,2901,5938
3131,CLDB,0.0,0.0,99903576,3037,2901,5938
3132,CNBKA,0.0,0.0,509129696,3037,2901,5938
3133,CNNB,0.0,0.0,38943944,3037,2901,5938
3134,CNOB,0.0,0.0,981505792,3037,2901,5938
3135,COFS,0.0,0.0,181843168,3037,2901,5938
3136,COLB,0.0,0.0,3075929600,3037,2901,5938
3137,COVA,0.0,0.0,362660768,3037,2901,5938
3138,COWN,0.0,0.0,968500288,3037,2901,5938
3139,CPSS,0.0,0.0,93557576,3037,2901,5938
3140,CSTR,0.0,0.0,395422336,3037,2901,5938
3141,CTAQ,0.0,0.0,509660224,3037,2901,5938
3142,CTBI,0.0,0.0,787200576,3037,2901,5938
3143,CVBF,0.0,0.0,2979366400,3037,2901,5938
3144,CVCY,0.0,0.0,237967392,3037,2901,5938
3145,CVLY,0.0,0.0,175643824,3037,2901,5938
3146,CWBC,0.0,0.0,107138560,3037,2901,5938
3147,CZNC,0.0,0.0,377621248,3037,2901,5938
3148,CZWI,0.0,0.0,143229952,3037,2901,5938
3149,DCOM,0.0,0.0,1313934464,3037,2901,5938
3150,DGNS,0.0,0.0,375161696,3037,2901,5938
3151,EAC,0.0,0.0,402408000,3037,2901,5938
3152,EBC,0.0,0.0,3585753856,3037,2901,5938
3153,EBMT,0.0,0.0,158545520,3037,2901,5938
3154,EBSB,0.0,0.0,966058240,3037,2901,5938
3155,EBTC,0.0,0.0,394610688,3037,2901,5938
3156,EFSC,0.0,0.0,1551825664,3037,2901,5938
3157,EGBN,0.0,0.0,1715667968,3037,2901,5938
3158,EMCF,0.0,0.0,76466000,3037,2901,5938
3159,ENVI,0.0,0.0,251505008,3037,2901,5938
3160,EPHY,0.0,0.0,498346880,3037,2901,5938
3161,EQBK,0.0,0.0,404507584,3037,2901,5938
3162,ESBK,0.0,0.0,47449956,3037,2901,5938
3163,ESQ,0.0,0.0,178543696,3037,2901,5938
3164,ESSA,0.0,0.0,170644016,3037,2901,5938
3165,ESXB,0.0,0.0,190698224,3037,2901,5938
3166,EUCR,0.0,0.0,131899184,3037,2901,5938
3167,EWBC,0.0,0.0,10526773248,3037,2901,5938
3168,FBIZ,0.0,0.0,210041792,3037,2901,5938
3169,FBMS,0.0,0.0,782090944,3037,2901,5938
3170,FBNC,0.0,0.0,1224985856,3037,2901,5938
3171,FCAP,0.0,0.0,163758880,3037,2901,5938
3172,FCBC,0.0,0.0,515472928,3037,2901,5938
3173,FCBP,0.0,0.0,287156384,3037,2901,5938
3174,FCCO,0.0,0.0,142560816,3037,2901,5938
3175,FCCY,0.0,0.0,180038544,3037,2901,5938
3176,FCNCA,0.0,0.0,8148026880,3037,2901,5938
3177,FDBC,0.0,0.0,284377088,3037,2901,5938
3178,FFBC,0.0,0.0,2352080896,3037,2901,5938
3179,FFBW,0.0,0.0,81033104,3037,2901,5938
3180,FFIC,0.0,0.0,648490496,3037,2901,5938
3181,FFIN,0.0,0.0,6545796096,3037,2901,5938
3182,FFNW,0.0,0.0,133923312,3037,2901,5938
3183,FFWM,0.0,0.0,1027400832,3037,2901,5938
3184,FGBI,0.0,0.0,175537328,3037,2901,5938
3185,FHB,0.0,0.0,3578778624,3037,2901,5938
3186,FIBK,0.0,0.0,2859096320,3037,2901,5938
3187,FIII,0.0,0.0,321511552,3037,2901,5938
3188,FINM,0.0,0.0,502492512,3037,2901,5938
3189,FISI,0.0,0.0,472116576,3037,2901,5938
3190,FITB,0.0,0.0,27289958400,3037,2901,5938
3191,FITBI,0.0,0.0,19824934912,3037,2901,5938
3192,FLIC,0.0,0.0,509189824,3037,2901,5938
3193,FMAO,0.0,0.0,277586048,3037,2901,5938
3194,FMBH,0.0,0.0,789395392,3037,2901,5938
3195,FMBI,0.0,0.0,2473940736,3037,2901,5938
3196,FMNB,0.0,0.0,480325664,3037,2901,5938
3197,FNCB,0.0,0.0,147754192,3037,2901,5938
3198,FNLC,0.0,0.0,314703040,3037,2901,5938
3199,FNWB,0.0,0.0,172901872,3037,2901,5938
3200,FRAF,0.0,0.0,133577384,3037,2901,5938
3201,FRBA,0.0,0.0,226518928,3037,2901,5938
3202,FRBK,0.0,0.0,217810496,3037,2901,5938
3203,FRHC,0.0,0.0,3353470976,3037,2901,5938
3204,FRME,0.0,0.0,2497391616,3037,2901,5938
3205,FRST,0.0,0.0,376108512,3037,2901,5938
3206,FSBW,0.0,0.0,293095680,3037,2901,5938
3207,FSEA,0.0,0.0,57649360,3037,2901,5938
3208,FSFG,0.0,0.0,161614000,3037,2901,5938
3209,FSSI,0.0,0.0,319880192,3037,2901,5938
3210,FTIV,0.0,0.0,343761600,3037,2901,5938
3211,FTOC,0.0,0.0,1036552832,3037,2901,5938
3212,FULT,0.0,0.0,2766864128,3037,2901,5938
3213,FUNC,0.0,0.0,119559416,3037,2901,5938
3214,FUSB,0.0,0.0,59029580,3037,2901,5938
3215,FUTU,0.0,0.0,19527862272,3037,2901,5938
3216,FVCB,0.0,0.0,224921952,3037,2901,5938
3217,FXNC,0.0,0.0,88654656,3037,2901,5938
3218,GABC,0.0,0.0,1208235264,3037,2901,5938
3219,GBCI,0.0,0.0,5518059008,3037,2901,5938
3220,GBNY,0.0,0.0,25060050,3037,2901,5938
3221,GCBC,0.0,0.0,210792032,3037,2901,5938
3222,GFED,0.0,0.0,84647680,3037,2901,5938
3223,GGAL,0.0,0.0,1808669568,3037,2901,5938
3224,GHAC,0.0,0.0,257775008,3037,2901,5938
3225,GLAQ,0.0,0.0,150056480,3037,2901,5938
3226,GLBZ,0.0,0.0,34852476,3037,2901,5938
3227,GLG,0.0,0.0,169019664,3037,2901,5938
3228,GNAC,0.0,0.0,284912480,3037,2901,5938
3229,GNTY,0.0,0.0,454782336,3037,2901,5938
3230,GRCY,0.0,0.0,52968200,3037,2901,5938
3231,GSBC,0.0,0.0,767763264,3037,2901,5938
3232,GWAC,0.0,0.0,224874672,3037,2901,5938
3233,HAFC,0.0,0.0,615253504,3037,2901,5938
3234,HBAN,0.0,0.0,16501373952,3037,2901,5938
3235,HBANN,0.0,0.0,28373221376,3037,2901,5938
3236,HBANO,0.0,0.0,13190829056,3037,2901,5938
3237,HBCP,0.0,0.0,317461952,3037,2901,5938
3238,HBMD,0.0,0.0,294883680,3037,2901,5938
3239,HBNC,0.0,0.0,812503360,3037,2901,5938
3240,HBT,0.0,0.0,467636768,3037,2901,5938
3241,HCAQ,0.0,0.0,262528384,3037,2901,5938
3242,HFBL,0.0,0.0,54079520,3037,2901,5938
3243,HFWA,0.0,0.0,1009205888,3037,2901,5938
3244,HIFS,0.0,0.0,616527616,3037,2901,5938
3245,HLXA,0.0,0.0,164670144,3037,2901,5938
3246,HMCO,0.0,0.0,392446880,3037,2901,5938
3247,HMNF,0.0,0.0,97106968,3037,2901,5938
3248,HMST,0.0,0.0,920730688,3037,2901,5938
3249,HOMB,0.0,0.0,4366507008,3037,2901,5938
3250,HONE,0.0,0.0,764964608,3037,2901,5938
3251,HOPE,0.0,0.0,1865059968,3037,2901,5938
3252,HTBI,0.0,0.0,418333056,3037,2901,5938
3253,HTBK,0.0,0.0,737016000,3037,2901,5938
3254,HTLF,0.0,0.0,2096454528,3037,2901,5938
3255,HVBC,0.0,0.0,41792312,3037,2901,5938
3256,HWBK,0.0,0.0,135202704,3037,2901,5938
3257,HWC,0.0,0.0,3653021440,3037,2901,5938
3258,IBCP,0.0,0.0,521240832,3037,2901,5938
3259,IBKR,0.0,0.0,30846703616,3037,2901,5938
3260,IBOC,0.0,0.0,2881985280,3037,2901,5938
3261,IBTX,0.0,0.0,3092547072,3037,2901,5938
3262,ICBK,0.0,0.0,144581616,3037,2901,5938
3263,IIII,0.0,0.0,338953984,3037,2901,5938
3264,INBK,0.0,0.0,348254784,3037,2901,5938
3265,INDB,0.0,0.0,2732480256,3037,2901,5938
3266,INKA,0.0,0.0,211096880,3037,2901,5938
3267,IROQ,0.0,0.0,72908552,3037,2901,5938
3268,ISBC,0.0,0.0,3569779968,3037,2901,5938
3269,ISTR,0.0,0.0,212691920,3037,2901,5938
3270,ITAC,0.0,0.0,97745176,3037,2901,5938
3271,JCIC,0.0,0.0,420468736,3037,2901,5938
3272,JRJC,0.0,0.0,30719856,3037,2901,5938
3273,KFFB,0.0,0.0,57297328,3037,2901,5938
3274,KRNY,0.0,0.0,1024717696,3037,2901,5938
3275,KURI,0.0,0.0,423918752,3037,2901,5938
3276,LACQU,0.0,0.0,84593808,3037,2901,5938
3277,LARK,0.0,0.0,118621288,3037,2901,5938
3278,LATN,0.0,0.0,251500016,3037,2901,5938
3279,LBAI,0.0,0.0,866597184,3037,2901,5938
3280,LBC,0.0,0.0,599590016,3037,2901,5938
3281,LCNB,0.0,0.0,227594400,3037,2901,5938
3282,LEGO,0.0,0.0,260688112,3037,2901,5938
3283,LEVL,0.0,0.0,186400944,3037,2901,5938
3284,LGHL,0.0,0.0,117770984,3037,2901,5938
3285,LKFN,0.0,0.0,1753815680,3037,2901,5938
3286,LMFA,0.0,0.0,35347728,3037,2901,5938
3287,LMST,0.0,0.0,118853920,3037,2901,5938
3288,LOAN,0.0,0.0,64261196,3037,2901,5938
3289,LOB,0.0,0.0,2918902272,3037,2901,5938
3290,LSAQ,0.0,0.0,101714808,3037,2901,5938
3291,LSBK,0.0,0.0,85012152,3037,2901,5938
3292,LWAC,0.0,0.0,222629696,3037,2901,5938
3293,MBCN,0.0,0.0,130700000,3037,2901,5938
3294,MBIN,0.0,0.0,1170567936,3037,2901,5938
3295,MBINP,0.0,0.0,482939520,3037,2901,5938
3296,MBWM,0.0,0.0,515407136,3037,2901,5938
3297,MCAD,0.0,0.0,75499424,3037,2901,5938
3298,MCBC,0.0,0.0,335819424,3037,2901,5938
3299,MCBS,0.0,0.0,385375744,3037,2901,5938
3300,MFNC,0.0,0.0,146755568,3037,2901,5938
3301,MGYR,0.0,0.0,78154560,3037,2901,5938
3302,MLAC,0.0,0.0,177711440,3037,2901,5938
3303,MLVF,0.0,0.0,141388288,3037,2901,5938
3304,MNSB,0.0,0.0,155115536,3037,2901,5938
3305,MOFG,0.0,0.0,491099488,3037,2901,5938
3306,MOGO,0.0,0.0,457960960,3037,2901,5938
3307,MON,0.0,0.0,305312896,3037,2901,5938
3308,MPB,0.0,0.0,222197488,3037,2901,5938
3309,MRBK,0.0,0.0,159866656,3037,2901,5938
3310,MRLN,0.0,0.0,160635168,3037,2901,5938
3311,MSBI,0.0,0.0,624684800,3037,2901,5938
3312,MSVB,0.0,0.0,48194376,3037,2901,5938
3313,MUDS,0.0,0.0,454609472,3037,2901,5938
3314,MVBF,0.0,0.0,394987616,3037,2901,5938
3315,MYFW,0.0,0.0,203165200,3037,2901,5938
3316,NAVI,0.0,0.0,2666531840,3037,2901,5938
3317,NBN,0.0,0.0,222911136,3037,2901,5938
3318,NBTB,0.0,0.0,1716231936,3037,2901,5938
3319,NCBS,0.0,0.0,845806656,3037,2901,5938
3320,NFBK,0.0,0.0,825620800,3037,2901,5938
3321,NICK,0.0,0.0,80927000,3037,2901,5938
3322,NKSH,0.0,0.0,220752384,3037,2901,5938
3323,NMMC,0.0,0.0,165312608,3037,2901,5938
3324,NRIM,0.0,0.0,269789664,3037,2901,5938
3325,NTRS,0.0,0.0,22211772416,3037,2901,5938
3326,NWBI,0.0,0.0,1838232832,3037,2901,5938
3327,NWFL,0.0,0.0,222781136,3037,2901,5938
3328,NYMT,0.0,0.0,1717060864,3037,2901,5938
3329,NYMTN,0.0,0.0,1310378880,3037,2901,5938
3330,NYMTO,0.0,0.0,1287215616,3037,2901,5938
3331,NYMTP,0.0,0.0,1302168832,3037,2901,5938
3332,OBNK,0.0,0.0,1001333056,3037,2901,5938
3333,OCFC,0.0,0.0,1420604416,3037,2901,5938
3334,OFED,0.0,0.0,145879984,3037,2901,5938
3335,ONB,0.0,0.0,3207408896,3037,2901,5938
3336,OPBK,0.0,0.0,156587680,3037,2901,5938
3337,OPHC,0.0,0.0,12430046,3037,2901,5938
3338,OPOF,0.0,0.0,125998272,3037,2901,5938
3339,OPRT,0.0,0.0,582314944,3037,2901,5938
3340,ORRF,0.0,0.0,258240128,3037,2901,5938
3341,OSBC,0.0,0.0,375139968,3037,2901,5938
3342,OSTR,0.0,0.0,277437504,3037,2901,5938
3343,OVBC,0.0,0.0,114491648,3037,2901,5938
3344,OVLY,0.0,0.0,143305392,3037,2901,5938
3345,OZK,0.0,0.0,5184769536,3037,2901,5938
3346,PACW,0.0,0.0,4601814016,3037,2901,5938
3347,PBCT,0.0,0.0,7670468608,3037,2901,5938
3348,PBCTP,0.0,0.0,6760420352,3037,2901,5938
3349,PBFS,0.0,0.0,320824576,3037,2901,5938
3350,PBHC,0.0,0.0,63138996,3037,2901,5938
3351,PBIP,0.0,0.0,112355880,3037,2901,5938
3352,PCB,0.0,0.0,229820304,3037,2901,5938
3353,PCSB,0.0,0.0,271027872,3037,2901,5938
3354,PDLB,0.0,0.0,190841280,3037,2901,5938
3355,PEBK,0.0,0.0,137203280,3037,2901,5938
3356,PEBO,0.0,0.0,659766336,3037,2901,5938
3357,PFBC,0.0,0.0,985512000,3037,2901,5938
3358,PFBI,0.0,0.0,279131200,3037,2901,5938
3359,PFC,0.0,0.0,1244182272,3037,2901,5938
3360,PFHD,0.0,0.0,246000032,3037,2901,5938
3361,PFIS,0.0,0.0,306203616,3037,2901,5938
3362,PGC,0.0,0.0,600367104,3037,2901,5938
3363,PGRW,0.0,0.0,169823552,3037,2901,5938
3364,PKBK,0.0,0.0,240637680,3037,2901,5938
3365,PLBC,0.0,0.0,151741104,3037,2901,5938
3366,PMBC,0.0,0.0,211470000,3037,2901,5938
3367,PNBK,0.0,0.0,39435700,3037,2901,5938
3368,PNFP,0.0,0.0,6764767744,3037,2901,5938
3369,PPBI,0.0,0.0,4048967168,3037,2901,5938
3370,PROV,0.0,0.0,126518248,3037,2901,5938
3371,PRSR,0.0,0.0,397718752,3037,2901,5938
3372,PSAC,0.0,0.0,414116480,3037,2901,5938
3373,PTRS,0.0,0.0,133481304,3037,2901,5938
3374,PVBC,0.0,0.0,283319008,3037,2901,5938
3375,PWOD,0.0,0.0,171830896,3037,2901,5938
3376,QCRH,0.0,0.0,753840000,3037,2901,5938
3377,RAAC,0.0,0.0,392149632,3037,2901,5938
3378,RACA,0.0,0.0,184949328,3037,2901,5938
3379,RACB,0.0,0.0,204336224,3037,2901,5938
3380,RBB,0.0,0.0,393277632,3037,2901,5938
3381,RBCAA,0.0,0.0,938471680,3037,2901,5938
3382,RBKB,0.0,0.0,148448496,3037,2901,5938
3383,RBNC,0.0,0.0,463122048,3037,2901,5938
3384,RCHG,0.0,0.0,246742512,3037,2901,5938
3385,RCLF,0.0,0.0,308660000,3037,2901,5938
3386,RILY,0.0,0.0,1632825472,3037,2901,5938
3387,RILYH,0.0,0.0,586247744,3037,2901,5938
3388,RIVE,0.0,0.0,97018952,3037,2901,5938
3389,RMBI,0.0,0.0,175028656,3037,2901,5938
3390,RNDB,0.0,0.0,106074760,3037,2901,5938
3391,RNST,0.0,0.0,2331664640,3037,2901,5938
3392,ROCC,0.0,0.0,146939504,3037,2901,5938
3393,RRBI,0.0,0.0,406281728,3037,2901,5938
3394,RVSB,0.0,0.0,154628784,3037,2901,5938
3395,SAII,0.0,0.0,217996864,3037,2901,5938
3396,SAL,0.0,0.0,123394152,3037,2901,5938
3397,SASR,0.0,0.0,2036830720,3037,2901,5938
3398,SBCF,0.0,0.0,1985681280,3037,2901,5938
3399,SBFG,0.0,0.0,130796456,3037,2901,5938
3400,SBNY,0.0,0.0,12890689536,3037,2901,5938
3401,SBSI,0.0,0.0,1264878976,3037,2901,5938
3402,SBT,0.0,0.0,268024128,3037,2901,5938
3403,SDAC,0.0,0.0,386219840,3037,2901,5938
3404,SFBC,0.0,0.0,108069472,3037,2901,5938
3405,SFBS,0.0,0.0,3271366656,3037,2901,5938
3406,SFNC,0.0,0.0,3150736128,3037,2901,5938
3407,SFST,0.0,0.0,371531840,3037,2901,5938
3408,SGAM,0.0,0.0,178070800,3037,2901,5938
3409,SHBI,0.0,0.0,200487408,3037,2901,5938
3410,SIEB,0.0,0.0,121692432,3037,2901,5938
3411,SIVB,0.0,0.0,26156519424,3037,2901,5938
3412,SLCR,0.0,0.0,420468736,3037,2901,5938
3413,SLCT,0.0,0.0,194404304,3037,2901,5938
3414,SLM,0.0,0.0,6304528384,3037,2901,5938
3415,SLMBP,0.0,0.0,3721167872,3037,2901,5938
3416,SMBC,0.0,0.0,355635872,3037,2901,5938
3417,SMBK,0.0,0.0,321906880,3037,2901,5938
3418,SMMF,0.0,0.0,337268512,3037,2901,5938
3419,SNEX,0.0,0.0,1282798976,3037,2901,5938
3420,SPFI,0.0,0.0,394101344,3037,2901,5938
3421,SRCE,0.0,0.0,1219300480,3037,2901,5938
3422,SRSA,0.0,0.0,250500016,3037,2901,5938
3423,SSB,0.0,0.0,5527764992,3037,2901,5938
3424,SSBI,0.0,0.0,101665800,3037,2901,5938
3425,SSPK,0.0,0.0,593410880,3037,2901,5938
3426,STBA,0.0,0.0,1302819072,3037,2901,5938
3427,STND,0.0,0.0,156062048,3037,2901,5938
3428,STXB,0.0,0.0,392397888,3037,2901,5938
3429,SV,0.0,0.0,287787520,3037,2901,5938
3430,SVBI,0.0,0.0,156134784,3037,2901,5938
3431,SWET,0.0,0.0,336029984,3037,2901,5938
3432,SWKH,0.0,0.0,205575472,3037,2901,5938
3433,SYBT,0.0,0.0,1177327232,3037,2901,5938
3434,TBBK,0.0,0.0,1224320768,3037,2901,5938
3435,TBK,0.0,0.0,2242447104,3037,2901,5938
3436,TBNK,0.0,0.0,254305744,3037,2901,5938
3437,TCAC,0.0,0.0,243313280,3037,2901,5938
3438,TCBI,0.0,0.0,3356560896,3037,2901,5938
3439,TCBIL,0.0,0.0,2951296512,3037,2901,5938
3440,TCBIP,0.0,0.0,2952176640,3037,2901,5938
3441,TCBK,0.0,0.0,1392417408,3037,2901,5938
3442,TCF,0.0,0.0,7282310656,3037,2901,5938
3443,TCFC,0.0,0.0,201532384,3037,2901,5938
3444,TECTP,0.0,0.0,38895936,3037,2901,5938
3445,TFSL,0.0,0.0,5729423360,3037,2901,5938
3446,THFF,0.0,0.0,600334784,3037,2901,5938
3447,TIGR,0.0,0.0,2372844800,3037,2901,5938
3448,TMTS,0.0,0.0,250000000,3037,2901,5938
3449,TOWN,0.0,0.0,2181328384,3037,2901,5938
3450,TRMK,0.0,0.0,2118972160,3037,2901,5938
3451,TRMT,0.0,0.0,47758984,3037,2901,5938
3452,TRST,0.0,0.0,717524800,3037,2901,5938
3453,TSBK,0.0,0.0,224706720,3037,2901,5938
3454,TSC,0.0,0.0,763312640,3037,2901,5938
3455,TSCAP,0.0,0.0,568420288,3037,2901,5938
3456,TSCBP,0.0,0.0,632916992,3037,2901,5938
3457,TSIA,0.0,0.0,415875008,3037,2901,5938
3458,TW,0.0,0.0,17970851840,3037,2901,5938
3459,UBCP,0.0,0.0,85313944,3037,2901,5938
3460,UBFO,0.0,0.0,132850440,3037,2901,5938
3461,UBOH,0.0,0.0,88265024,3037,2901,5938
3462,UBSI,0.0,0.0,4968250880,3037,2901,5938
3463,UCBI,0.0,0.0,2918230016,3037,2901,5938
3464,UMBF,0.0,0.0,4397492736,3037,2901,5938
3465,UMPQ,0.0,0.0,3927724032,3037,2901,5938
3466,UNB,0.0,0.0,136119104,3037,2901,5938
3467,UNTY,0.0,0.0,215733328,3037,2901,5938
3468,UVSP,0.0,0.0,818254208,3037,2901,5938
3469,VABK,0.0,0.0,91326544,3037,2901,5938
3470,VACQ,0.0,0.0,431200000,3037,2901,5938
3471,VBFC,0.0,0.0,58525324,3037,2901,5938
3472,VBTX,0.0,0.0,1629897984,3037,2901,5938
3473,VCKA,0.0,0.0,170947504,3037,2901,5938
3474,VIH,0.0,0.0,361604928,3037,2901,5938
3475,VIRT,0.0,0.0,6134126080,3037,2901,5938
3476,VLY,0.0,0.0,5560940544,3037,2901,5938
3477,VLYPO,0.0,0.0,3460318208,3037,2901,5938
3478,VLYPP,0.0,0.0,3487772160,3037,2901,5938
3479,VSPR,0.0,0.0,606625024,3037,2901,5938
3480,WABC,0.0,0.0,1700087168,3037,2901,5938
3481,WAFD,0.0,0.0,2347700480,3037,2901,5938
3482,WASH,0.0,0.0,889656768,3037,2901,5938
3483,WMPN,0.0,0.0,70660352,3037,2901,5938
3484,WNEB,0.0,0.0,204846192,3037,2901,5938
3485,WSBC,0.0,0.0,2434200576,3037,2901,5938
3486,WSBF,0.0,0.0,522948416,3037,2901,5938
3487,WSFS,0.0,0.0,2375154944,3037,2901,5938
3488,WTBA,0.0,0.0,403991936,3037,2901,5938
3489,WTFC,0.0,0.0,4345918976,3037,2901,5938
3490,WTFCM,0.0,0.0,3913376256,3037,2901,5938
3491,WVFC,0.0,0.0,30062502,3037,2901,5938
3492,ZION,0.0,0.0,9089868800,3037,2901,5938
3493,AAC,0.0,0.0,1232618240,3037,2901,5938
3494,AAIC,0.0,0.0,135287376,3037,2901,5938
3495,ABR,0.0,0.0,2122997248,3037,2901,5938
3496,ACR,0.0,0.0,150048608,3037,2901,5938
3497,ACRE,0.0,0.0,558593664,3037,2901,5938
3498,ADRA,0.0,0.0,140156256,3037,2901,5938
3499,AGAC,0.0,0.0,499387488,3037,2901,5938
3500,AGCB,0.0,0.0,613644992,3037,2901,5938
3501,AGM,0.0,0.0,1053267456,3037,2901,5938
3502,AIW,0.0,0.0,264734720,3037,2901,5938
3503,AJAX,0.0,0.0,911428224,3037,2901,5938
3504,AJX,0.0,0.0,261493056,3037,2901,5938
3505,ALLY,0.0,0.0,17461630976,3037,2901,5938
3506,APGB,0.0,0.0,853874944,3037,2901,5938
3507,APO,0.0,0.0,10926092288,3037,2901,5938
3508,ARI,0.0,0.0,1974667776,3037,2901,5938
3509,ARR,0.0,0.0,821688320,3037,2901,5938
3510,ASAQ,0.0,0.0,309062496,3037,2901,5938
3511,ASB,0.0,0.0,3309265152,3037,2901,5938
3512,ASPL,0.0,0.0,306276032,3037,2901,5938
3513,ATA,0.0,0.0,145000000,3037,2901,5938
3514,ATMR,0.0,0.0,426506272,3037,2901,5938
3515,AVAL,0.0,0.0,6962812928,3037,2901,5938
3516,AVAN,0.0,0.0,749249984,3037,2901,5938
3517,AX,0.0,0.0,2814433024,3037,2901,5938
3518,AXP,0.0,0.0,118207332352,3037,2901,5938
3519,BAC,0.0,0.0,342415474688,3037,2901,5938
3520,BANC,0.0,0.0,914641472,3037,2901,5938
3521,BAP,0.0,0.0,11596524544,3037,2901,5938
3522,BBAR,0.0,0.0,553436224,3037,2901,5938
3523,BBD,0.0,0.0,37981708288,3037,2901,5938
3524,BBDO,0.0,0.0,37981736960,3037,2901,5938
3525,BBVA,0.0,0.0,35921207296,3037,2901,5938
3526,BCH,0.0,0.0,11718749184,3037,2901,5938
3527,BCS,0.0,0.0,44855275520,3037,2901,5938
3528,BHB,0.0,0.0,455377184,3037,2901,5938
3529,BHLB,0.0,0.0,1136562816,3037,2901,5938
3530,BITE,0.0,0.0,226587760,3037,2901,5938
3531,BK,0.0,0.0,41953333248,3037,2901,5938
3532,BKU,0.0,0.0,4042286848,3037,2901,5938
3533,BLX,0.0,0.0,600326656,3037,2901,5938
3534,BMA,0.0,0.0,1408673792,3037,2901,5938
3535,BMO,0.0,0.0,58645716992,3037,2901,5938
3536,BNS,0.0,0.0,75294318592,3037,2901,5938
3537,BOH,0.0,0.0,3628053760,3037,2901,5938
3538,BRBS,0.0,0.0,275482112,3037,2901,5938
3539,BRMK,0.0,0.0,1391879936,3037,2901,5938
3540,BSAC,0.0,0.0,11556831232,3037,2901,5938
3541,BSBR,0.0,0.0,25239517184,3037,2901,5938
3542,BSMX,0.0,0.0,7570774528,3037,2901,5938
3543,BX,0.0,0.0,52956200960,3037,2901,5938
3544,BXMT,0.0,0.0,4609703936,3037,2901,5938
3545,BXS,0.0,0.0,3278513408,3037,2901,5938
3546,BY,0.0,0.0,825334528,3037,2901,5938
3547,C,0.0,0.0,151681499136,3037,2901,5938
3548,CADE,0.0,0.0,2581259008,3037,2901,5938
3549,CAP,0.0,0.0,429524992,3037,2901,5938
3550,CBU,0.0,0.0,4169888256,3037,2901,5938
3551,CCIV,0.0,0.0,5904674816,3037,2901,5938
3552,CCV,0.0,0.0,637499968,3037,2901,5938
3553,CCVI,0.0,0.0,689310016,3037,2901,5938
3554,CFG,0.0,0.0,19125518336,3037,2901,5938
3555,CFR,0.0,0.0,6896791040,3037,2901,5938
3556,CHFW,0.0,0.0,117451840,3037,2901,5938
3557,CHMI,0.0,0.0,162385408,3037,2901,5938
3558,CIB,0.0,0.0,7886989312,3037,2901,5938
3559,CIM,0.0,0.0,2955766528,3037,2901,5938
3560,CIT,0.0,0.0,5093327872,3037,2901,5938
3561,CLII,0.0,0.0,402500000,3037,2901,5938
3562,CM,0.0,0.0,44330082304,3037,2901,5938
3563,CMA,0.0,0.0,10025219072,3037,2901,5938
3564,CMO,0.0,0.0,615952704,3037,2901,5938
3565,CNF,0.0,0.0,259926528,3037,2901,5938
3566,COF,0.0,0.0,60718092288,3037,2901,5938
3567,COHN,0.0,0.0,45824264,3037,2901,5938
3568,CPF,0.0,0.0,765540736,3037,2901,5938
3569,CPSR,0.0,0.0,338789984,3037,2901,5938
3570,CRHC,0.0,0.0,1038104960,3037,2901,5938
3571,CS,0.0,0.0,26064629760,3037,2901,5938
3572,CUBI,0.0,0.0,997405696,3037,2901,5938
3573,CVII,0.0,0.0,1702574976,3037,2901,5938
3574,DB,0.0,0.0,25225064448,3037,2901,5938
3575,DFS,0.0,0.0,30266886144,3037,2901,5938
3576,DGNR,0.0,0.0,885787520,3037,2901,5938
3577,DX,0.0,0.0,583111808,3037,2901,5938
3578,DXF,0.0,0.0,33817340,3037,2901,5938
3579,EARN,0.0,0.0,150220400,3037,2901,5938
3580,EFC,0.0,0.0,768806656,3037,2901,5938
3581,EMPW,0.0,0.0,311250016,3037,2901,5938
3582,ENVA,0.0,0.0,1270602752,3037,2901,5938
3583,EPWR,0.0,0.0,334995008,3037,2901,5938
3584,EQD,0.0,0.0,514394976,3037,2901,5938
3585,EQHA,0.0,0.0,267849024,3037,2901,5938
3586,EVBN,0.0,0.0,179699568,3037,2901,5938
3587,EVR,0.0,0.0,5757598208,3037,2901,5938
3588,FBC,0.0,0.0,2377934592,3037,2901,5938
3589,FBK,0.0,0.0,2057884928,3037,2901,5938
3590,FBP,0.0,0.0,2457258496,3037,2901,5938
3591,FCF,0.0,0.0,1386473984,3037,2901,5938
3592,FHN,0.0,0.0,9512067072,3037,2901,5938
3593,FNB,0.0,0.0,4096411648,3037,2901,5938
3594,FRC,0.0,0.0,29446948864,3037,2901,5938
3595,FRX,0.0,0.0,375375008,3037,2901,5938
3596,FUSE,0.0,0.0,435750016,3037,2901,5938
3597,GDOT,0.0,0.0,2546466816,3037,2901,5938
3598,GFX,0.0,0.0,422625024,3037,2901,5938
3599,GHL,0.0,0.0,331505472,3037,2901,5938
3600,GNPK,0.0,0.0,213932400,3037,2901,5938
3601,GPMT,0.0,0.0,671762816,3037,2901,5938
3602,GS,0.0,0.0,111097528320,3037,2901,5938
3603,GWB,0.0,0.0,1729755392,3037,2901,5938
3604,HASI,0.0,0.0,4168142848,3037,2901,5938
3605,HDB,0.0,0.0,107141816320,3037,2901,5938
3606,HKIB,0.0,0.0,2521580288,3037,2901,5938
3607,HLI,0.0,0.0,4716952064,3037,2901,5938
3608,HSBC,0.0,0.0,122890731520,3037,2901,5938
3609,HTH,0.0,0.0,2696604672,3037,2901,5938
3610,HTPA,0.0,0.0,372000000,3037,2901,5938
3611,IBN,0.0,0.0,53790957568,3037,2901,5938
3612,IFS,0.0,0.0,3596774912,3037,2901,5938
3613,IMH,0.0,0.0,43188596,3037,2901,5938
3614,IMPX,0.0,0.0,494999968,3037,2901,5938
3615,ING,0.0,0.0,48876871680,3037,2901,5938
3616,IPOD,0.0,0.0,633650048,3037,2901,5938
3617,IPOE,0.0,0.0,1730750080,3037,2901,5938
3618,IPOF,0.0,0.0,1539562496,3037,2901,5938
3619,ITCB,0.0,0.0,1907385216,3037,2901,5938
3620,ITUB,0.0,0.0,43929157632,3037,2901,5938
3621,IVR,0.0,0.0,937242880,3037,2901,5938
3622,JMP,0.0,0.0,129446808,3037,2901,5938
3623,JPM,0.0,0.0,465476321280,3037,2901,5938
3624,JWSM,0.0,0.0,1284693760,3037,2901,5938
3625,KB,0.0,0.0,18637494272,3037,2901,5938
3626,KEY,0.0,0.0,19719591936,3037,2901,5938
3627,KKR,0.0,0.0,29435992064,3037,2901,5938
3628,KREF,0.0,0.0,1047313280,3037,2901,5938
3629,KWAC,0.0,0.0,145513952,3037,2901,5938
3630,LADR,0.0,0.0,1459767296,3037,2901,5938
3631,LAZ,0.0,0.0,4964660224,3037,2901,5938
3632,LDI,0.0,0.0,6339564544,3037,2901,5938
3633,LEAP,0.0,0.0,676902848,3037,2901,5938
3634,LFT,0.0,0.0,90045672,3037,2901,5938
3635,LNFA,0.0,0.0,171637504,3037,2901,5938
3636,LYG,0.0,0.0,42813575168,3037,2901,5938
3637,MC,0.0,0.0,3273494784,3037,2901,5938
3638,MCB,0.0,0.0,440196128,3037,2901,5938
3639,MDH,0.0,0.0,267858000,3037,2901,5938
3640,MFA,0.0,0.0,1871524224,3037,2901,5938
3641,MFG,0.0,0.0,36610670592,3037,2901,5938
3642,MITT,0.0,0.0,169556272,3037,2901,5938
3643,MS,0.0,0.0,147847479296,3037,2901,5938
3644,MTB,0.0,0.0,19834077184,3037,2901,5938
3645,MUFG,0.0,0.0,69838315520,3037,2901,5938
3646,NBA,0.0,0.0,149050576,3037,2901,5938
3647,NBHC,0.0,0.0,1224969600,3037,2901,5938
3648,NGA,0.0,0.0,682432640,3037,2901,5938
3649,NLY,0.0,0.0,12152964096,3037,2901,5938
3650,NMR,0.0,0.0,16422802432,3037,2901,5938
3651,NNI,0.0,0.0,2836470528,3037,2901,5938
3652,NREF,0.0,0.0,99647856,3037,2901,5938
3653,NRZ,0.0,0.0,4571063296,3037,2901,5938
3654,NSH,0.0,0.0,285487520,3037,2901,5938
3655,NSTB,0.0,0.0,495500032,3037,2901,5938
3656,NTB,0.0,0.0,1854499968,3037,2901,5938
3657,NWG,0.0,0.0,31081240576,3037,2901,5938
3658,NYCB,0.0,0.0,5863164416,3037,2901,5938
3659,OFG,0.0,0.0,1190775168,3037,2901,5938
3660,OMF,0.0,0.0,7320622592,3037,2901,5938
3661,OPY,0.0,0.0,536255968,3037,2901,5938
3662,ORC,0.0,0.0,566871616,3037,2901,5938
3663,PB,0.0,0.0,6989178368,3037,2901,5938
3664,PDAC,0.0,0.0,394875200,3037,2901,5938
3665,PFS,0.0,0.0,1768366592,3037,2901,5938
3666,PFSI,0.0,0.0,4157415680,3037,2901,5938
3667,PIPR,0.0,0.0,2053663104,3037,2901,5938
3668,PJT,0.0,0.0,2904695552,3037,2901,5938
3669,PMT,0.0,0.0,1958055936,3037,2901,5938
3670,PNC,0.0,0.0,75581562880,3037,2901,5938
3671,PRK,0.0,0.0,2087149184,3037,2901,5938
3672,PV,0.0,0.0,524600000,3037,2901,5938
3673,QFTA,0.0,0.0,245776080,3037,2901,5938
3674,RC,0.0,0.0,964008768,3037,2901,5938
3675,RF,0.0,0.0,20289435648,3037,2901,5938
3676,RJF,0.0,0.0,17531987968,3037,2901,5938
3677,ROT,0.0,0.0,342240000,3037,2901,5938
3678,RWT,0.0,0.0,1173893376,3037,2901,5938
3679,RY,0.0,0.0,132080795648,3037,2901,5938
3680,SACH,0.0,0.0,123141816,3037,2901,5938
3681,SAN,0.0,0.0,108845088768,3037,2901,5938
3682,SC,0.0,0.0,8816284672,3037,2901,5938
3683,SCHW,0.0,0.0,126401994752,3037,2901,5938
3684,SEAH,0.0,0.0,560249984,3037,2901,5938
3685,SF,0.0,0.0,6976571904,3037,2901,5938
3686,SHG,0.0,0.0,17227866112,3037,2901,5938
3687,SI,0.0,0.0,3302495488,3037,2901,5938
3688,SMFG,0.0,0.0,49611313152,3037,2901,5938
3689,SNV,0.0,0.0,6818299904,3037,2901,5938
3690,SPFR,0.0,0.0,451087488,3037,2901,5938
3691,SRL,0.0,0.0,114248688,3037,2901,5938
3692,STL,0.0,0.0,4478621696,3037,2901,5938
3693,STT,0.0,0.0,29810343936,3037,2901,5938
3694,STWD,0.0,0.0,7064555520,3037,2901,5938
3695,SUPV,0.0,0.0,256025424,3037,2901,5938
3696,SYF,0.0,0.0,24809146368,3037,2901,5938
3697,TD,0.0,0.0,121139806208,3037,2901,5938
3698,TFC,0.0,0.0,79900663808,3037,2901,5938
3699,TINV,0.0,0.0,347414976,3037,2901,5938
3700,TMP,0.0,0.0,1188362112,3037,2901,5938
3701,TREB,0.0,0.0,656578112,3037,2901,5938
3702,TRTX,0.0,0.0,869688192,3037,2901,5938
3703,TWO,0.0,0.0,2011775872,3037,2901,5938
3704,UBS,0.0,0.0,54669185024,3037,2901,5938
3705,USB,0.0,0.0,85361000448,3037,2901,5938
3706,VEL,0.0,0.0,184079120,3037,2901,5938
3707,VGAC,0.0,0.0,636322688,3037,2901,5938
3708,WAL,0.0,0.0,9308000256,3037,2901,5938
3709,WBK,0.0,0.0,68545265664,3037,2901,5938
3710,WBS,0.0,0.0,5068517376,3037,2901,5938
3711,WD,0.0,0.0,3225835776,3037,2901,5938
3712,WF,0.0,0.0,6830478336,3037,2901,5938
3713,WFC,0.0,0.0,165324259328,3037,2901,5938
3714,WMC,0.0,0.0,194600640,3037,2901,5938
3715,WPF,0.0,0.0,1300218752,3037,2901,5938
3716,XPOA,0.0,0.0,377624992,3037,2901,5938
3717,ESGC,0.188639309666794,-0.08124210165711665,670707904,1030,4916,5946
3718,GRVY,0.5002691049923556,-3.3151548513027116,922813952,315,5714,6029
3719,GRCL,0.40003209272558665,-0.8052500397599625,875268736,426,5682,6108
3720,QK,0.13673497589803202,-0.07415082785010502,127804896,1307,4857,6164
3721,LSXMB,-0.6227353463587921,0.05334360350519734,17337421824,5305,882,6187
3722,SNMP,0.10372589969430067,-0.05089693634750723,54421176,1554,4640,6194
3723,LSXMK,-0.6227353463587921,0.05285964736248411,17638293504,5305,900,6205
3724,LSXMA,-0.6227353463587921,0.05283055192353531,17656557568,5305,902,6207
3725,IO,0.0828210006979835,-0.036840693847641555,46517436,1764,4484,6248
3726,SNCR,0.20040947944925014,-0.1577364944381066,156775104,975,5280,6255
3727,RMNI,-0.2175990675990676,0.03495867444862059,753553472,4752,1600,6352
3728,MDCA,-0.8812224782012773,0.05201663204697982,269101728,5450,925,6375
3729,LOV,-0.8194690265486726,0.049457390227436615,196990160,5427,997,6424
3730,MDIA,0.04307921757586187,-0.01177512207399192,27051064,2350,4075,6425
3731,VIEW,0.1359118068751672,-0.1173703802563352,1758323712,1317,5111,6428
3732,GNOG,-0.055168759093142686,0.021156627200071963,1209275008,4233,2217,6450
3733,GWGH,-0.041440731770404686,0.01905679765461,223389232,4172,2287,6459
3734,STRM,0.012576312576312577,-0.0010310626544141454,85954936,2859,3691,6550
3735,ZH,0.1166576011817445,-0.11862556972054865,5025469952,1448,5116,6564
3736,BRP,0.004811971046959017,-0.00044079998429536913,2735612928,2968,3643,6611
3737,MSGM,-0.00019509430521934246,2.727124290613035e-06,409665600,3722,2900,6622
3738,MCFE,-0.030313351498637602,0.010824501237632119,10271175680,4108,2572,6680
3739,GBLIL,-0.009984406882624575,0.004924070360432933,460957888,3944,2747,6691
3740,STAF,-0.013405646554552016,0.005342197744595574,31587782,3978,2735,6713
3741,LTRPA,0.15845724907063197,-0.3628950554324858,588665600,1172,5576,6748
3742,LTRPB,0.15845724907063197,-0.3766080301437686,554450688,1172,5583,6755
3743,DRD,0.17988151274143807,-6.205271095738053,826321472,1072,5719,6791
3744,EVOP,-0.03896479975975461,0.008747013813303475,1316756736,4157,2636,6793
3745,KDP,-1.3979690522243713,0.04236616599734029,49634414592,5570,1256,6826
3746,MEG,-0.012962110753183003,0.0007062368351603444,1431401472,3973,2873,6846
3747,NOAH,0.16566918793168112,-2.3019704965201226,2655248896,1139,5708,6847
3748,CO,0.08535000903832249,-0.1282045354683582,542117440,1731,5159,6890
3749,NXTD,-0.6589202749183056,0.035351953181661525,59092844,5338,1575,6913
3750,SGFY,-0.051494565217391305,0.005872954434784361,5939210752,4217,2719,6936
3751,ZIXI,-0.07703231657835696,0.009276609022445743,428748160,4314,2622,6936
3752,UTZ,-0.07925898443689541,0.009421868281747584,3459087872,4324,2617,6941
3753,QH,0.009209620347141977,-0.011734294917938053,318186240,2907,4074,6981
3754,AAMC,0.1255570791909496,-2.105012084062544,38262412,1368,5706,7074
3755,BQ,0.07506980454726765,-0.1441423098414753,499141504,1849,5232,7081
3756,SGRY,-1.1401082381238725,0.03484422520098561,2611360768,5529,1603,7132
3757,RAAS,0.06017196906748773,-0.11695291006275516,1942116608,2040,5109,7149
3758,AINC,0.08028583199556762,-0.18853637709880247,27116586,1795,5360,7155
3759,PLX,-0.14617044228694714,0.008908620017546892,235990752,4549,2630,7179
3760,XYF,0.10927369190476556,-11.846759844868817,199566192,1507,5723,7230
3761,TMDI,-0.2828622901391882,0.0175153196970911,222175760,4887,2348,7235
3762,ONTF,-0.1917617003344834,0.009645785830314738,2183199232,4694,2609,7303
3763,IBA,0.09031343966112351,-0.5527095343113103,2049853184,1675,5646,7321
3764,CFIV,-0.00010524549821858401,-8.472103581350429e-05,621665024,3720,3605,7325
3765,VTAQ,-0.00011942622546258559,-8.549686424238512e-05,213900000,3721,3606,7327
3766,MNTK,-0.0003556845504858651,-4.4687815425965995e-05,1613496832,3727,3600,7327
3767,ETAC,-0.00024207343430551021,-0.00019443466708417455,749046016,3723,3618,7341
3768,DWIN,-0.0002824511142056166,-0.00022966547033838165,251182912,3724,3623,7347
3769,FTCV,-0.0004205205754463038,-0.00023850193255797684,444427104,3728,3624,7352
3770,ID,-0.5299537868519866,0.023211512455657574,257070768,5217,2136,7353
3771,MOTV,-0.00033663335852657933,-0.00027522218246131113,509996192,3726,3628,7354
3772,PRTY,-0.0006916024487849668,-0.000272669579488322,663290624,3736,3627,7363
3773,LCY,-0.00046480920125521155,-0.00035979730261026315,648209984,3729,3636,7365
3774,JYAC,-0.0006378226929263404,-0.0004917409234314653,139052592,3731,3647,7378
3775,DAKT,-0.0007746220818316334,-0.0004265064252912038,285986304,3739,3641,7380
3776,CONX,-0.0006485729555685907,-0.0005190675049332782,939575424,3732,3649,7381
3777,PCPC,-0.0005540470552031846,-0.0005344553019639719,431767552,3730,3652,7382
3778,GHVI,-0.0007729560125838637,-0.00044983847952932276,594693760,3738,3645,7383
3779,AGFS,-0.6412259615384616,0.02532815295282006,112223320,5322,2062,7384
3780,CFAC,-0.0006673425248981844,-0.000526185892456473,291622496,3735,3651,7386
3781,CMLF,-0.0009287256849682979,-0.0004898400953183522,842884544,3745,3646,7391
3782,APSG,-0.000714709521674756,-0.0005741755491643712,1013862976,3737,3656,7393
3783,PRPB,-0.0008002921862493701,-0.0006085425933594337,1090424960,3740,3657,7397
3784,SNRH,-0.0008320949768075763,-0.000674177958308167,513360000,3741,3664,7405
3785,SHEN,-0.001599973217536376,-0.00032857852459073196,2478130176,3776,3631,7407
3786,AYX,-0.0016671693527588725,-0.00029394329903247577,5733856768,3779,3629,7408
3787,ARL,-0.0006565066359316377,-0.0008030204296901807,145206480,3733,3680,7413
3788,BHSE,-0.0008921167968227657,-0.0007407522552945546,93281248,3742,3671,7413
3789,ACND,-0.0009191414120133666,-0.00074453624452883,513360000,3743,3672,7415
3790,TCI,-0.0006629668189349141,-0.0008288067755823621,188509952,3734,3682,7416
3791,SVAC,-0.0009200266739905731,-0.00074572470722646,504282400,3744,3673,7417
3792,TWCT,-0.0009424256147220954,-0.0007558844384922868,751500032,3746,3674,7420
3793,GOAC,-0.0009452611657013354,-0.0007603024240116519,717312448,3747,3676,7423
3794,HCAR,-0.0009734658792786371,-0.0008039831570876553,403236000,3748,3681,7429
3795,GE,-0.0010774989567567904,-0.0007744842089170098,117626470400,3753,3677,7430
3796,BVS,-0.5520105337789932,0.022009621750475213,781347904,5238,2193,7431
3797,SHIP,-0.0010132976410582154,-0.0009029386988987571,159305632,3749,3686,7435
3798,PSTH,-0.0010549840467022056,-0.0008584520723895043,4974000128,3751,3684,7435
3799,BOWX,-0.0012106066526707884,-0.0007782430218831903,754083712,3757,3678,7435
3800,HZON,-0.0011399269345192973,-0.0009047783530491053,663468736,3755,3687,7442
3801,IIIV,-0.20825046706442477,0.006149604875206711,1009727040,4733,2709,7442
3802,TIPT,-0.001712626160968456,-0.0006351886867538658,323107328,3781,3662,7443
3803,ALTG,-0.0019135093761959434,-0.0005210823412147885,391441248,3793,3650,7443
3804,BSN,-0.0011947972569231696,-0.000976412882748034,377049472,3756,3688,7444
3805,HPX,-0.0012385343057450754,-0.0010147269976258316,310993216,3758,3689,7447
3806,NOAC,-0.0012832808022809432,-0.001048104751709138,284912704,3760,3694,7454
3807,LOKB,-0.0012923903529713288,-0.0010340867275844424,320361248,3762,3692,7454
3808,MTAC,-0.0012920535998260955,-0.0010681753351728751,305937376,3761,3695,7456
3809,BAND,-0.0033852631578947367,-0.00017795044349641734,3086361856,3842,3616,7458
3810,VNTR,-0.0010314595152140279,-0.0012234755157394645,501687392,3750,3709,7459
3811,FRPH,-0.0010739271352027907,-0.0011807963705275809,451178656,3752,3707,7459
3812,MRAC,-0.001359210291912101,-0.0011049477424881432,463450048,3766,3698,7464
3813,ACIC,-0.0013756115855426438,-0.0010982922989253858,628750016,3767,3697,7464
3814,GF,-0.001257247568694949,-0.0011729842617682377,314496512,3759,3706,7465
3815,SQ,-0.003557293794654058,-0.00016362264322190284,111435227136,3853,3614,7467
3816,RMGB,-0.0014052745286757212,-0.0011415218306718542,430387488,3768,3702,7470
3817,PACE,-0.0014286605342378421,-0.0011390931036301506,564750336,3770,3701,7471
3818,FMAC,-0.001452567545149339,-0.0011593883049237329,521122496,3771,3704,7475
3819,PTIC,-0.001422876572554257,-0.0011810148015739684,281175008,3769,3708,7477
3820,YAC,-0.0014529322370124443,-0.00116740821715284,431681248,3772,3705,7477
3821,CND,-0.0013162746237343362,-0.001305688757979215,280684800,3763,3715,7478
3822,UAA,-0.002405988955598333,-0.0007091915989449412,9623778304,3813,3668,7481
3823,UA,-0.002405988955598333,-0.0007191190649268917,9478504448,3813,3669,7482
3824,FCAC,-0.0015193642258876075,-0.0012272574089565306,429524992,3773,3710,7483
3825,DEH,-0.001526044914843906,-0.001236862305145686,428231264,3774,3711,7485
3826,FGNA,-0.0015573276684009757,-0.0012463887192339011,306637024,3775,3712,7487
3827,NEBC,-0.0016579514119354744,-0.0013495083331091962,340656256,3778,3716,7494
3828,HZAC,-0.0016937693028290918,-0.001364953567961769,676580096,3780,3718,7498
3829,ZNGA,-0.004307413284969395,-0.0002992629982728606,11446961152,3868,3630,7498
3830,BTAQ,-0.001715746335565748,-0.0013557331942176836,440991232,3782,3717,7499
3831,LPL,-0.0013228659864108765,-0.0016290022531392388,8333201408,3764,3736,7500
3832,BCTG,-0.0018491191673322197,-0.0012939573466237183,241562368,3787,3714,7501
3833,CEVA,-0.0035183016240443407,-0.0005676468348807044,1337108608,3848,3655,7503
3834,MTLS,-0.004223297647696933,-0.00042580360321252744,1820088448,3864,3640,7504
3835,GSAH,-0.0018321584443675258,-0.0013684866009467534,1003124992,3786,3719,7505
3836,VII,-0.0017571256179827323,-0.0014588690068416935,281175008,3785,3724,7509
3837,TREE,-0.0036404506287535054,-0.0005399731951917401,3009816832,3857,3653,7510
3838,VCVC,-0.001895391992698017,-0.0014298592629298263,252316672,3791,3723,7514
3839,HSAQ,-0.001904178697988015,-0.001417140068620284,219632992,3792,3722,7514
3840,PRU,-0.0002947739323870862,-0.002460579901633984,37149331456,3725,3791,7516
3841,NFH,-0.0035494555186690864,-0.0006957873216453403,1493528320,3851,3666,7517
3842,ENPC,-0.001720957269753895,-0.0016832307136854206,424948704,3783,3739,7522
3843,ESSC,-0.0019796676956081,-0.0015585744053565609,177389072,3795,3729,7524
3844,TWND,-0.001973213439524544,-0.0015935030524648981,418605568,3794,3731,7525
3845,IFN,-0.0016094629333146193,-0.0017871112884674098,578987008,3777,3749,7526
3846,IGAC,-0.002010894581481947,-0.0016283262783692728,373124992,3796,3735,7531
3847,CCAC,-0.002016863051450947,-0.0016241019479141705,347070016,3797,3734,7531
3848,DUNE,-0.0017357007518647622,-0.0017871444454470484,168704992,3784,3750,7534
3849,COOL,-0.0020690697761357995,-0.0016971217438440135,492500032,3798,3741,7539
3850,RMT,-0.0018518230214297781,-0.0018096983507310666,505045792,3788,3754,7542
3851,LUXA,-0.0021534689617266306,-0.001693464857311675,440306240,3802,3740,7542
3852,CHPM,-0.002152799391029492,-0.0017332013590047836,376124992,3801,3745,7546
3853,SPNV,-0.002159595564365678,-0.001716722633879136,508659360,3803,3743,7546
3854,HQH,-0.001869407916682531,-0.0018590672305178987,1059501568,3789,3759,7548
3855,KINZ,-0.002166469563011177,-0.0017840705725702044,340860000,3804,3748,7552
3856,PIAI,-0.0018875830528784414,-0.002014358044158338,305882912,3790,3766,7556
3857,MAAC,-0.0022069089706923434,-0.0018030801139086027,505697056,3807,3751,7558
3858,VYGG,-0.0020749125862758624,-0.0019200163224257195,622992768,3799,3762,7561
3859,PMVC,-0.002175045466896609,-0.0018103887090979759,214556560,3806,3755,7561
3860,KW,-0.0021669316870888285,-0.0018339266065675213,2897865472,3805,3757,7562
3861,RSVA,-0.0030403179287269407,-0.001614005730995734,412275008,3830,3733,7563
3862,NGAC,-0.0022996374037057344,-0.0018518150775470041,467812192,3810,3758,7568
3863,RELX,-1.9113636363636364,0.02783379132463471,50048143360,5622,1952,7574
3864,MFIN,-0.002245219190515179,-0.002015254694724519,190304000,3808,3767,7575
3865,DBDR,-0.0023907753502651285,-0.0019741282980648535,287713280,3812,3764,7576
3866,ASYS,-0.003067098501928381,-0.0017290455549825905,187793808,3832,3744,7576
3867,DDOG,-0.008757199908695716,-0.0005065281192487994,26542206976,3928,3648,7576
3868,EXPC,-0.0024454510164145134,-0.0019002857521577207,357500000,3816,3761,7577
3869,ERES,-0.0024496048103266528,-0.0018727249925419545,424781280,3817,3760,7577
3870,MFINL,-0.002245219190515179,-0.002073044768197291,151156768,3808,3772,7580
3871,RNET,-0.005071982594199009,-0.0010851465860744318,187672880,3884,3696,7580
3872,TACA,-0.0021490065024137943,-0.002210736337136817,227699984,3800,3783,7583
3873,SVOK,-0.002440173779413423,-0.002021759898639323,316645792,3815,3768,7583
3874,SNPR,-0.0025204617168238866,-0.0019269424140508672,453675008,3821,3763,7584
3875,QELL,-0.002345340638695451,-0.0020890437191808608,430569632,3811,3775,7586
3876,LBRDK,-0.0031821980835224713,-0.0018062157910692204,28845531136,3834,3752,7586
3877,ANGI,-0.006393195583795739,-0.0008679855311348165,7203277824,3901,3685,7586
3878,LBRDA,-0.0031821980835224713,-0.0018064821690156848,28840660992,3834,3753,7587
3879,LORL,-0.005179707404618072,-0.001156815579483333,1144513536,3887,3703,7590
3880,PTON,-0.00951496867022511,-0.0006089712198057942,33926631424,3938,3658,7596
3881,OACB,-0.002589320815703944,-0.002093285957998991,311562624,3822,3776,7598
3882,API,-0.007946902164259438,-0.000852738145020593,6163178496,3917,3683,7600
3883,APWC,-0.0011198864868985007,-0.0035728825769709275,53482236,3754,3849,7603
3884,HIGA,-0.0026572806932637365,-0.002137346697233893,453566208,3824,3779,7603
3885,TAC,-0.0024958402662229617,-0.0022280451214334264,2640359168,3820,3784,7604
3886,TVAC,-0.0026066051045226793,-0.0021636457684078196,214331248,3823,3781,7604
3887,FSRV,-0.00315501296345592,-0.0020806838406071206,383299168,3833,3773,7606
3888,ROKU,-0.012602343875421416,-0.00044032218362827235,46478491648,3967,3642,7609
3889,THCB,-0.003271009731724641,-0.0020680130359370837,444966848,3839,3771,7610
3890,FRGI,-0.00247806277610066,-0.002495703114866129,358754752,3819,3792,7611
3891,IIAC,-0.0027848008525515116,-0.0022528661860970393,498093728,3825,3786,7611
3892,TDF,-0.0024656747857437554,-0.002561459069568654,801495168,3818,3798,7616
3893,DFPH,-0.002959753576686108,-0.002358062779510905,290662496,3829,3788,7617
3894,FST,-0.0033039630057476116,-0.0021477288456252653,310249984,3841,3780,7621
3895,OLN,-0.0047463373289744525,-0.0017613262284414352,6284278272,3878,3746,7624
3896,RTP,-0.0031927101850244403,-0.00253722934799137,871987456,3836,3794,7630
3897,FIVN,-0.011445650989063045,-0.000738592112649079,10988646400,3960,3670,7630
3898,GRSV,-0.003212182338645,-0.002560835823832279,659531264,3837,3796,7633
3899,CFV,-0.022494386609512144,-1.785206818575088e-06,308540512,4053,3584,7637
3900,EOS,-0.0029535900658743093,-0.0027765121172992928,1111708032,3828,3810,7638
3901,GIL,-0.005866579206903162,-0.001707256214454025,6584494592,3897,3742,7639
3902,CBAH,-0.0029349328760860135,-0.002811918646810381,422624992,3827,3813,7640
3903,BLSA,-0.0034681481868641174,-0.002561193665315047,197204960,3843,3797,7640
3904,ICLK,-0.007801189216471932,-0.001507641600385825,1100331776,3916,3727,7643
3905,MRVL,-0.013467383273065995,-0.0007001970069229379,34028251136,3980,3667,7647
3906,AONE,-0.0035233719920089632,-0.0026708522343132386,285950016,3849,3803,7652
3907,DMYD,-0.00525147135529788,-0.0019815716699400415,734160000,3888,3765,7653
3908,FEN,-0.0030460813795877523,-0.0029244860370573494,264849072,3831,3824,7655
3909,MESA,-0.0032150534994721948,-0.0028889043692076444,479816352,3838,3821,7659
3910,MOTN,-0.00349581431814081,-0.002852971405501374,142743360,3845,3817,7662
3911,THCA,-0.003542484377587951,-0.0027942042483119437,221853872,3850,3812,7662
3912,OCA,-0.0035041200922631493,-0.0028483422403935096,256060352,3847,3816,7663
3913,CVR,-0.0027934689480725505,-0.0034707723913088287,24964852,3826,3842,7668
3914,EGLE,-0.0032922907812775676,-0.0033121331019542078,453291200,3840,3834,7674
3915,ETWO,-0.009454004519991246,-0.0016820207844813557,2309201920,3937,3738,7675
3916,DFNS,-0.003622232321771122,-0.0029422276836975642,214546864,3855,3825,7680
3917,FLAC,-0.0036569550801444244,-0.0029244759939191893,175734896,3858,3823,7681
3918,JWS,-0.004608546807351988,-0.002737902695936839,1159200000,3873,3808,7681
3919,NPA,-0.004852612696892901,-0.002578160261846252,435735456,3881,3800,7681
3920,L,-0.0034965741657739958,-0.003347268607703169,14076931072,3846,3836,7682
3921,HOL,-0.003998969823330256,-0.002907171262854651,414750016,3860,3822,7682
3922,EOG,-0.004253242831384887,-0.002880009865412465,42781323264,3865,3820,7685
3923,RBAC,-0.003957105646508652,-0.003173750157998765,718750016,3859,3830,7689
3924,CLI,-0.0035568986617452738,-0.0033857812479708075,1445313024,3852,3839,7691
3925,SRDX,-0.011434786980247342,-0.0016390756386947128,775128064,3959,3737,7696
3926,TNDM,-0.01317912143607207,-0.0014070383315974426,5442917888,3977,3720,7697
3927,SBG,-0.004154241786260673,-0.003377220625930217,285487520,3862,3838,7700
3928,CCX,-0.004160477416044056,-0.003366635967604761,865087488,3863,3837,7700
3929,KRNT,-0.013048916468706064,-0.0014599283652789873,4645280256,3976,3725,7701
3930,CIA,-0.0013535523007468196,-0.006251909976036486,286679744,3765,3937,7702
3931,PHIC,-0.00430197292714995,-0.0034880983652744216,214331248,3866,3843,7709
3932,RTPZ,-0.004324761807934263,-0.0034408270186047,291525024,3869,3840,7709
3933,ZGYH,-0.004453947485439023,-0.0034592221646712624,89623896,3871,3841,7712
3934,ARYA,-0.005104339069017404,-0.003037662316495102,253453664,3885,3827,7712
3935,EZGO,-0.013977961684710978,-0.0014653794891053822,78253968,3986,3726,7712
3936,IIF,-0.003493689155339065,-0.003948516303631635,260579504,3844,3869,7713
3937,ZNTE,-0.0036224660761337776,-0.0036892609008103996,231610000,3856,3857,7713
3938,RICE,-0.00448001265449776,-0.0035843010223214162,299553888,3872,3850,7722
3939,THBR,-0.004646236882997059,-0.0035563246219667477,454968768,3876,3847,7723
3940,FVRR,-0.016344676164300374,-0.0014123407025723427,7848183296,4007,3721,7728
3941,OTRA,-0.004626232879830661,-0.0038043445731391614,132489360,3874,3860,7734
3942,HEC,-0.004681962329791838,-0.003759953205231813,514912480,3877,3859,7736
3943,PINS,-0.02216751858794362,-0.001015301939871561,52669558784,4048,3690,7738
3944,BSET,-0.004843461327208269,-0.0038993893475881896,250811968,3879,3865,7744
3945,OLO,-0.326371286626787,0.00399014900312646,4037437952,4977,2767,7744
3946,MXC,-0.006439706683678484,-0.0035058994262307853,17257006,3903,3846,7749
3947,STPK,-0.009151342988261748,-0.0028572186384542004,1223156096,3932,3818,7750
3948,AXAS,-0.00410933316729967,-0.004671978072372696,26218794,3861,3890,7751
3949,HQL,-0.0043729540369980445,-0.004493583161494439,470021376,3870,3881,7751
3950,BREZ,-0.005028042920840002,-0.004047761190835583,146250000,3882,3870,7752
3951,ROP,-65.94930875576037,0.026151511695803053,43522813952,5723,2030,7753
3952,MCMJ,-0.005055886517308691,-0.004063141865381893,162736672,3883,3871,7754
3953,VTOL,-0.004306410810226157,-0.004618353554122501,779900608,3867,3889,7756
3954,BFI,-0.008910862457992186,-0.003136907587753898,266163392,3930,3829,7759
3955,VIAO,-0.00966183574879227,-0.002861150757123436,296307776,3940,3819,7759
3956,PVH,-0.008816595945308817,-0.0031767084729565223,7326992384,3929,3831,7760
3957,ADTN,-0.00801400331132433,-0.0034940574844511615,885815488,3919,3844,7763
3958,VERU,-0.026738941451429007,-0.0007968637036444499,804793216,4084,3679,7763
3959,ROCR,-0.04276315789473684,-6.764045895112833e-06,144134256,4179,3585,7764
3960,IDN,-0.019041789177661153,-0.001763547324459067,158233248,4021,3747,7768
3961,PTK,-0.005431686030206227,-0.004372563263833441,142168752,3891,3878,7769
3962,KSMT,-0.005527106480525612,-0.004409596837711373,314007520,3893,3879,7772
3963,GDDY,-0.741153659718856,0.01630603818826452,14114689024,5385,2392,7777
3964,AMS,-0.003568646176271016,-0.006060722463726363,14690550,3854,3927,7781
3965,GLEO,-0.005718120566700761,-0.004565695013962616,174174000,3896,3888,7784
3966,GDP,-0.007270453514461214,-0.004238527578119065,129064152,3910,3874,7784
3967,VCRA,-0.014272352086905866,-0.0025584819555672916,1189283712,3989,3795,7784
3968,ASG,-0.005482051732887446,-0.0049224574194936584,365273344,3892,3896,7788
3969,GWRE,-0.0135787737718077,-0.0027106525097519646,8623463424,3983,3807,7790
3970,IPHI,-0.028462059654103138,-0.0011203633356480292,9780775936,4094,3699,7793
3971,SPRQ,-0.006143219323373981,-0.004880980841250398,435993728,3899,3895,7794
3972,TLYS,-0.005606134751582355,-0.005031129492383599,357044864,3895,3904,7799
3973,DMYI,-0.006578237523334419,-0.004939421174320285,400874976,3905,3897,7802
3974,NEO,-0.02042981632191316,-0.0020832298593172907,5707847168,4030,3774,7804
3975,LCAP,-0.0064011715868296645,-0.0050706738375218075,290177984,3902,3908,7810
3976,NHIC,-0.0064826026504202945,-0.005172971707605678,217780864,3904,3909,7813
3977,CMCTP,-0.011752593510334778,-0.0035981573587740598,805843840,3963,3851,7814
3978,REV,-0.01741654571843251,-0.002671003768985753,640593024,4010,3804,7814
3979,CLNC,-0.005165011766258951,-0.006123174824192575,1075149696,3886,3929,7815
3980,STWO,-0.006786074327185716,-0.005499124405077194,309687488,3908,3916,7824
3981,BOMN,-0.010414848819821871,-0.004191034129741871,753212224,3951,3873,7824
3982,CVEO,-0.0067440132594158994,-0.005542213297259666,228959456,3907,3918,7825
3983,IACA,-0.006999245060151096,-0.0055094892042732305,329906752,3909,3917,7826
3984,PEN,-0.025891648859760027,-0.0018148721947807574,9904933888,4075,3756,7831
3985,LTHM,-0.012665650287322623,-0.0038839931905946465,2473243392,3969,3864,7833
3986,MANU,-0.018303808743875983,-0.002825766700872861,2730857728,4018,3815,7833
3987,FVAM,-0.007512539121619235,-0.005773479668140669,110123640,3912,3922,7834
3988,ASA,-0.00554203125237754,-0.006461646031540705,399108032,3894,3943,7837
3989,TPGY,-0.010481138364202572,-0.004532109394410839,800624960,3952,3885,7837
3990,FEDU,0.019524269893600264,-0.10795679169623297,58441824,2772,5068,7840
3991,NOVA,-0.009818091497932403,-0.00494458245893392,4112619776,3942,3899,7841
3992,ALHC,-0.03499218775971544,-0.0012629389038564174,4076955136,4128,3713,7841
3993,CTAC,-0.007738933719489351,-0.00614562900073141,329487840,3915,3932,7847
3994,KBSF,0.006325373642291881,-0.08000382275473623,9717375,2946,4904,7850
3995,CNQ,-0.006054303541411436,-0.006922542295223169,36389629952,3898,3954,7852
3996,NFE,-0.018790987254557613,-0.003260665343710111,8752189440,4020,3833,7853
3997,JBGS,-0.007640285962665061,-0.006484646565946686,4259693056,3913,3944,7857
3998,FAII,-0.007988210993080658,-0.006315531138737945,435993728,3918,3940,7858
3999,BLFS,-0.022511136114921622,-0.0026793301440553915,1164372864,4054,3806,7860
4000,CLNE,-0.01761703098487117,-0.003598846614372595,2693481472,4011,3852,7863
4001,ARMK,-0.013999336116402958,-0.0043484116543344815,9978756096,3987,3877,7864
4002,SPWR,-0.018438856640044535,-0.003501368733732548,5088678912,4019,3845,7864
4003,OSS,-0.018028600853760252,-0.0036115298576534713,113953568,4013,3853,7866
4004,KOSS,-0.024244144194862732,-0.0026710731134265207,182600624,4063,3805,7868
4005,MARA,-0.028834157147672197,-0.002022576396775374,4570700800,4099,3769,7868
4006,CTHR,-0.010692410993501857,-0.005209505529834471,93448960,3957,3912,7869
4007,FROG,-0.02278580390488,-0.002818501818900704,4449067008,4056,3814,7870
4008,LIVK,-0.008330875346359738,-0.0066442197822783,101122344,3921,3950,7871
4009,ACTC,-0.011522622227147443,-0.005266838485501128,607031232,3962,3913,7875
4010,ENG,-0.022163069266824837,-0.0032110360643449374,117812144,4047,3832,7879
4011,BL,-0.030001685822235002,-0.002249445093554497,6442820608,4104,3785,7889
4012,TBIO,-0.009794902872057351,-0.006628304792128259,1257541248,3941,3949,7890
4013,PYR,-0.03334475826790328,-0.002104106518870371,993475584,4119,3777,7896
4014,IRL,-0.008730478857947742,-0.007421867486733024,62272132,3927,3970,7897
4015,GNRS,-0.009207803335710115,-0.007265777189099103,218924992,3933,3965,7898
4016,MNTX,-0.016744778632206397,-0.004679441791423241,162334576,4008,3891,7899
4017,CHAQ,-0.009313678255741491,-0.007355144144953132,108861904,3935,3968,7903
4018,MXE,-0.009086464252868298,-0.007566723445267061,18722144,3931,3974,7905
4019,SYPR,-0.013518844848899293,-0.005778063198611682,69027144,3982,3923,7905
4020,HUBS,-0.03478220405906433,-0.0022088518411388152,22472572928,4127,3782,7909
4021,AMHC,-0.009262159207941812,-0.007589493651523247,123749992,3934,3976,7910
4022,AKR,-0.008650991906502776,-0.008162294033050339,1710517504,3925,3990,7915
4023,ALAC,-0.004641369573086082,-0.010493980237559675,50513800,3875,4042,7917
4024,SCPE,-0.009997360118621788,-0.007501812959341603,230406256,3945,3972,7917
4025,LC,-0.006691245490033285,-0.009070972572120433,1468738176,3906,4012,7918
4026,SFTW,-0.00990507286619347,-0.007774589637836733,401636992,3943,3979,7922
4027,YSAC,-0.010174253362364317,-0.007907667641566736,170325984,3947,3981,7928
4028,SOAC,-0.010022295235319802,-0.008013340707843309,374249984,3946,3983,7929
4029,GCO,-0.0076745123421491325,-0.009259253482830994,702464576,3914,4016,7930
4030,HGV,-0.01266268026732325,-0.007249832541756877,3258631936,3968,3964,7932
4031,RIOT,-0.03570398569533368,-0.0025738492068112973,4068918272,4133,3799,7932
4032,CONN,-0.008424003193099588,-0.009133084294873852,617955968,3923,4013,7936
4033,TMPM,-0.010192475252736326,-0.008152703630161703,124952240,3948,3989,7937
4034,AZEK,-0.03563678526093339,-0.0027607065945368285,6909096960,4132,3809,7941
4035,GBLI,-0.008161249075271155,-0.009554399483773554,421149568,3920,4022,7942
4036,JIH,-0.012748333876037677,-0.007527914341942257,582187520,3970,3973,7943
4037,HGSH,-0.007285632220776042,-0.010257354744625118,51131748,3911,4034,7945
4038,CMCT,-0.011752593510334778,-0.008064407334112487,183859760,3963,3986,7949
4039,BMRN,-0.019350476866100013,-0.006072651948913635,14191832064,4022,3928,7950
4040,BBBY,-0.010556129819107937,-0.008649611817297278,3431596544,3955,3998,7953
4041,KYN,-0.010328176736968633,-0.008920773960385054,907896640,3949,4007,7956
4042,CSTL,-0.020131341229101547,-0.006135468344246271,1761976320,4027,3930,7957
4043,FTHM,-0.040612586435417736,-0.0024262379397810042,500596608,4168,3790,7958
4044,POSH,-0.5918357023622843,0.007474854703774268,3145605632,5277,2681,7958
4045,DCBO,-0.027337778419587594,-0.004164485634260143,1492221056,4088,3872,7960
4046,ESTE,-0.013045075431844176,-0.008091403476485357,603251712,3975,3988,7963
4047,REX,-0.009590921939991115,-0.00969484703572398,505724800,3939,4025,7964
4048,LFTR,-0.011114405678841439,-0.008956234993338901,258356240,3958,4008,7966
4049,OPRX,-0.05649634498358084,-0.0015623299057924817,848061056,4237,3730,7967
4050,BVN,-0.00943080407720886,-0.01039298644981398,2588127488,3936,4039,7975
4051,HBM,-0.008461111339270813,-0.011066873727888605,2075275392,3924,4055,7979
4052,CRWD,-0.050757117037377564,-0.0020596879619313893,43416272896,4212,3770,7982
4053,EXFO,-0.01796887304382687,-0.00747708532513751,253304304,4012,3971,7983
4054,LIVN,-0.028511002296775757,-0.004693582313860496,3810830848,4095,3892,7987
4055,BILL,-0.0470290221791938,-0.0025207700662160286,12463285248,4195,3793,7988
4056,TCOM,-0.02588684737129343,-0.005700830089243133,186621771776,4074,3921,7995
4057,DXR,-0.02132668596716811,-0.007089050953041446,46793008,4038,3960,7998
4058,HES,-0.016321129245699163,-0.00846872349819249,22413121536,4006,3993,7999
4059,MAG,-0.02616541633429656,-0.005820219235603916,1541506048,4081,3924,8005
4060,CRSA,-0.012987931113551964,-0.010299331690390112,314687488,3974,4036,8010
4061,OSPN,-0.03001981147695417,-0.005197527803511702,1024724800,4105,3911,8016
4062,MEC,-0.02093709708032541,-0.008034353257015802,300289216,4035,3984,8019
4063,MASS,-0.03461433146421896,-0.004761402556074829,1355340800,4126,3893,8019
4064,ELLO,-0.015194644766587407,-0.009677696026677602,400589280,3997,4024,8021
4065,GNMK,-0.03948746380829175,-0.0038404488337072692,1761128320,4162,3861,8023
4066,OSUR,-0.016821644249245128,-0.009227981571669038,751830528,4009,4015,8024
4067,DNMR,-0.031861822098583965,-0.005294347001410912,3268124672,4114,3914,8028
4068,ZDGE,-0.05781093099985655,-0.0022531106232812903,180918832,4241,3787,8028
4069,GPRO,-0.03163976700190841,-0.005670779651094437,1859150464,4113,3920,8033
4070,ANIP,-0.025034901907271142,-0.0072874484129624014,397297088,4069,3966,8035
4071,STNE,-0.018225924676261503,-0.009397544526347045,19990695936,4017,4019,8036
4072,PFSW,-0.023622716673144188,-0.00762961408070423,142280704,4060,3977,8037
4073,KLXE,-0.0086687306501548,-0.0133832962798719,129524032,3926,4112,8038
4074,TWIN,-0.012961207788271405,-0.01153858251863117,138483552,3971,4068,8039
4075,RCG,-0.014091937614436275,-0.010889836011858233,15296537,3988,4052,8040
4076,MODN,-0.03691307044551606,-0.005013934670158725,1325915136,4143,3903,8046
4077,WIFI,-0.02233079209272139,-0.0088062088436332,626953408,4051,4001,8052
4078,GIK,-0.014940567979451551,-0.011159927001760135,269033472,3995,4058,8053
4079,APXT,-0.01583027456216656,-0.010804485854147243,505756032,4003,4050,8053
4080,DSX,-0.010530405342904187,-0.01283203175230799,285589184,3953,4102,8055
4081,GXGX,-0.014614754147669311,-0.01152793130590321,362968768,3991,4065,8056
4082,UFI,-0.015590440352741791,-0.01116803082056881,524115488,4001,4059,8060
4083,GRNV,-0.014625135601097804,-0.01155724121710989,73168752,3992,4070,8062
4084,MEOH,-0.013429267865697404,-0.012206490201716333,2847789056,3979,4085,8064
4085,TDAC,-0.023384149305884262,-0.00890690912883401,151152048,4059,4005,8064
4086,ALC,-0.032973844056030745,-0.006620054791197061,35530936320,4117,3948,8065
4087,PANW,-0.04206686930091185,-0.004840348678869479,32923426816,4174,3894,8068
4088,ELSE,-0.016244624940277116,-0.01151281427020101,18276386,4005,4064,8069
4089,STKS,-0.020825376152878047,-0.010681488196062744,241696832,4034,4045,8079
4090,SHAK,-0.03348943531201529,-0.006996064741898852,4857735168,4121,3958,8079
4091,WHG,-0.015155182364878703,-0.012140350324573907,135320272,3996,4084,8080
4092,FSII,-0.12917222963951935,-1.2040520177228369e-05,257072816,4502,3586,8088
4093,AMRN,-0.030484163899491438,-0.007855806582644568,2381491968,4109,3980,8089
4094,BLMN,-0.0250449450052552,-0.009576267514666266,2462169088,4070,4023,8093
4095,HAYN,-0.010357661158185478,-0.014418789197519164,377292480,3950,4144,8094
4096,GLSI,-0.06749237358709795,-0.0029528999580684637,658788992,4269,3826,8095
4097,WDAY,-0.07217758855638014,-0.0026179079047100188,61193793536,4294,3802,8096
4098,CAR,-0.011491696322657176,-0.014128336049794887,5263860224,3961,4136,8097
4099,BCAC,-0.13008365774869543,-4.263395477288006e-05,73601544,4503,3597,8100
4100,LQDT,-0.050941728899901235,-0.004557636202260528,646783232,4214,3887,8101
4101,JAMF,-0.07679458306611582,-0.0023757934580310065,4329722880,4312,3789,8101
4102,CVX,-0.01564333755956393,-0.012776189554466204,200873115648,4002,4100,8102
4103,FMO,-0.018164179913180013,-0.01221265730639797,70101808,4016,4086,8102
4104,HZN,-0.028028260667472344,-0.009273447445887727,278903616,4090,4017,8107
4105,HHC,-0.015582854590675026,-0.01330722816667167,5495680512,4000,4110,8110
4106,JOB,-0.03608668983847884,-0.007576852411092881,21730534,4138,3975,8113
4107,PRA,-0.008343212978900227,-0.016863332168324467,1452424448,3922,4192,8114
4108,DESP,-0.03380965015350794,-0.008377941488682058,933079680,4123,3991,8114
4109,BATL,-0.020309811978535704,-0.012363134003611848,195206400,4028,4091,8119
4110,TTI,-0.04104021225749393,-0.006910064506101666,331786304,4169,3953,8122
4111,BLDP,-0.04544684450923116,-0.006419473184620107,6937550848,4187,3942,8129
4112,ZS,-0.06916694824098434,-0.0036600376354212873,24471918592,4276,3856,8132
4113,TRC,-0.014704970045021092,-0.014830341341947067,431393472,3993,4147,8140
4114,PATI,-0.010535714285714285,-0.016496488764306743,38475668,3954,4187,8141
4115,DOYU,0.03835708308713184,-3.9931211185840603,3331429888,2430,5716,8146
4116,SGOC,-0.024591320157359372,-0.012105103591912131,251497504,4065,4083,8148
4117,SITM,-0.06667421622516267,-0.0045075560821011326,1752417664,4266,3883,8149
4118,SRAC,-0.021728695218648203,-0.013419153017833979,275017280,4041,4113,8154
4119,ALUS,-0.018083304198874234,-0.014223534055392497,361890624,4015,4140,8155
4120,DCT,-0.06287187381641804,-0.004960358717843055,5479289856,4256,3900,8156
4121,F,-0.014739802763198155,-0.015718043924170703,50807975936,3994,4170,8164
4122,TURN,-0.012072458505626174,-0.017279796696974027,77284808,3965,4202,8167
4123,IMAB,0.02841642844748066,-0.30560883700139635,3673603584,2643,5531,8174
4124,UTI,-0.015912622396882424,-0.01585034691254241,199384784,4004,4172,8176
4125,RNG,-0.07526671598527886,-0.003923159190840936,27690702848,4308,3868,8176
4126,AC,-0.01349022340173472,-0.017053636458956394,733224704,3981,4196,8177
4127,RELL,-0.013895189609691348,-0.016928725521206188,99057752,3985,4193,8178
4128,SAVA,-0.07347866068047818,-0.0043467619795006605,1654183424,4302,3876,8178
4129,SA,-0.02609692561278373,-0.01330208758230043,1258265472,4078,4109,8187
4130,HWCC,-0.01954856912535268,-0.015538606116129092,88465872,4023,4166,8189
4131,QS,-0.07696385061483878,-0.004522305155048191,18016729088,4313,3884,8197
4132,TWI,-0.025600231201258632,-0.013971761288758223,596785344,4072,4126,8198
4133,VREX,-0.028798411122144985,-0.012891562694484783,836920000,4098,4103,8201
4134,ZKIN,-0.042391107326523784,-0.009873196571476364,152964080,4177,4026,8203
4135,SSY,-0.021501862623357952,-0.015461172953192121,19180110,4040,4165,8205
4136,BYND,-0.08314447853650944,-0.0038762257015566323,8200491520,4342,3863,8205
4137,FARO,-0.04289466930793563,-0.010097800688692272,1550878080,4180,4030,8210
4138,MAYS,-0.012961317325297664,-0.019274255693707942,53418168,3972,4240,8212
4139,OII,-0.02044253313848313,-0.016348001149452805,1152027136,4031,4183,8214
4140,AOSL,-0.02990948886775866,-0.01346572663718338,857143424,4103,4114,8217
4141,CUBA,-0.021106673530202267,-0.016392904476463445,37538000,4036,4184,8220
4142,GDEN,-0.02438430924173908,-0.015056973691901574,787044096,4064,4157,8221
4143,NET,-0.08241484712217678,-0.00455752711578015,21633261568,4336,3886,8222
4144,RUTH,-0.035881201389746216,-0.0122817300039048,865996352,4135,4089,8224
4145,WK,-0.07129351390013432,-0.006234071052630175,4596214272,4291,3935,8226
4146,CERT,-0.07814549598950606,-0.005175735770149112,4113605376,4318,3910,8228
4147,NTUS,-0.04608693174803658,-0.010411014048815004,862771904,4189,4040,8229
4148,NTIP,-0.020595158036314728,-0.01716945367779509,80551112,4033,4201,8234
4149,FSR,-0.04213453149713388,-0.01139973340497983,4646793728,4176,4060,8236
4150,HAAC,-0.01962812951379892,-0.01793446056060643,578812480,4024,4214,8238
4151,BOX,-0.054139105946787135,-0.008972692353342571,3879802368,4229,4009,8238
4152,ATRO,-0.03081815666734667,-0.013983108769779784,562341824,4111,4128,8239
4153,CSU,-0.038755164771017085,-0.012233308500366476,82025216,4155,4088,8243
4154,INGN,-0.039662906524177054,-0.011948765347640092,1161632128,4163,4080,8243
4155,BSPE,-0.00638722971811805,-0.02627110120663206,90360000,3900,4345,8245
4156,TXG,-0.0928224363988079,-0.0037338602041654444,20156280832,4390,3858,8248
4157,CVET,-0.05258033106134372,-0.009914935901746117,3972328704,4223,4027,8250
4158,GWPH,-0.06747429876391621,-0.008066154799281607,6735657984,4268,3987,8255
4159,RRC,-0.02132227889198992,-0.018264216721989808,2592645888,4037,4221,8258
4160,GT,-0.021824653428250282,-0.018018930180114467,4163845376,4042,4216,8258
4161,LMPX,-0.05445503064139385,-0.010062333621856313,162639744,4232,4029,8261
4162,VTIQ,-0.18643848607638588,-1.2558848149024402e-05,343965024,4674,3587,8261
4163,AMBC,-0.026043613707165108,-0.016434259419441887,786336064,4077,4186,8263
4164,WRN,-0.027035636890377232,-0.01629460971345089,164556368,4086,4181,8267
4165,DZSI,-0.03996466928660121,-0.01295572165917628,408776224,4166,4105,8271
4166,NG,-0.08479984791700614,-0.005965709290234165,3088044032,4346,3925,8271
4167,MUR,-0.013654376305500178,-0.022022496334677774,2635734272,3984,4288,8272
4168,YELP,-0.03928874692819426,-0.013498930310339607,3040679680,4158,4116,8274
4169,PUMP,-0.022108103311303053,-0.018714458313129612,1082835328,4046,4232,8278
4170,EQC,-0.004847223526387965,-0.03075603569865366,3447419392,3880,4403,8283
4171,HYLN,-0.03434858009971819,-0.015143764274242003,1848969344,4125,4159,8284
4172,DRQ,-0.018044964787135607,-0.021503084509509055,1130178688,4014,4274,8288
4173,DCRB,-0.02471477570905095,-0.018321926794719272,294006560,4066,4223,8289
4174,HURC,-0.019780751660071667,-0.020953762372839132,229768704,4026,4269,8295
4175,UPWK,-0.10590092346663894,-0.0038544283393710296,5705764864,4433,3862,8295
4176,ZVO,-0.03776801082905797,-0.014873647965656142,113644584,4150,4149,8299
4177,PXS,-0.022876663918011544,-0.01949676656868755,37595260,4057,4243,8300
4178,AVLR,-0.09472482433719562,-0.005047165894293592,11999035392,4395,3906,8301
4179,RMBS,-0.037707382675220655,-0.014947469082380854,2280273664,4149,4153,8302
4180,OOMA,-0.08495591476855253,-0.006968282247462521,368875008,4348,3955,8303
4181,APPN,-0.10828307530561929,-0.003902953896378415,9667680256,4441,3866,8307
4182,BRT,-0.025121700298287863,-0.018997806633465578,294664384,4071,4237,8308
4183,SHAC,-0.2032714335300243,-1.6789869907787455e-05,278875008,4719,3589,8308
4184,CRNT,-0.03656904471961321,-0.015540608105993486,317009216,4141,4168,8309
4185,NOTV,-0.0874771094520355,-0.006587245023055287,233757296,4362,3947,8309
4186,TALO,-0.02132791959152279,-0.021243853023736454,997644928,4039,4272,8311
4187,GIX,-0.023739494510332054,-0.01965053452777431,198915488,4062,4249,8311
4188,IAC,-0.04727540836083778,-0.013519503725006144,20595200000,4196,4118,8314
4189,GFL,-0.049930202917315744,-0.013180556028707373,11301951488,4207,4108,8315
4190,CAAS,-0.02476233408155515,-0.019711589848552858,149631232,4067,4250,8317
4191,GRIN,-0.020485803089029198,-0.02191797123266856,129246920,4032,4286,8318
4192,HFC,-0.02568753580484691,-0.019541851987844135,5984992768,4073,4245,8318
4193,COP,-0.028435687836232796,-0.018663814129057946,70825615360,4093,4231,8324
4194,HCC,-0.0221793075943636,-0.021607595555110826,917683520,4049,4277,8326
4195,CREE,-0.06892675689042758,-0.011116790428514276,13163751424,4275,4056,8331
4196,SPOT,-0.10472201066260473,-0.0049818642980199845,53451218944,4430,3901,8331
4197,FOUR,-0.08273381294964029,-0.008571082077220652,7604981248,4338,3995,8333
4198,APLE,-0.022572858125847816,-0.021772048644165903,3377205760,4055,4279,8334
4199,GATO,-0.032825017407206204,-0.018257246492642508,616072384,4116,4220,8336
4200,SCHL,-0.021892047085845537,-0.02237304848627211,1044947392,4043,4294,8337
4201,CDNA,-0.09748920296691217,-0.006177796075988541,3712059904,4405,3934,8339
4202,LXU,-0.0233684574712125,-0.021913958815130093,150488880,4058,4285,8343
4203,NGS,-0.010597410351132505,-0.029541722027450274,123812744,3956,4390,8346
4204,DNN,-0.04586045005666181,-0.015135370134985103,948949184,4188,4158,8346
4205,VFF,-0.05934787220325024,-0.013014229058268422,991785472,4244,4106,8350
4206,APPS,-1.0971599402092675,0.001788197072947366,7308667392,5520,2833,8353
4207,APTS,-0.01977325142551548,-0.025311805695096803,516438016,4025,4329,8354
4208,PAGS,-0.04305128896952959,-0.01605865283311898,15839856640,4181,4176,8357
4209,NXE,-0.07270428976968803,-0.011425725585188156,1906941568,4299,4061,8360
4210,ICCC,-0.03637539089921769,-0.01849890208949828,70619816,4140,4226,8366
4211,OFIX,-0.04745752936808602,-0.015579829617487564,837459008,4198,4169,8367
4212,PEI,-0.026109770922239015,-0.022064374370529508,162504192,4079,4290,8369
4213,LMAO,-0.21491753148580145,-0.0002439312549918323,128579328,4747,3625,8372
4214,BOAS,-0.23519142037660556,-2.0248075861101763e-05,279450016,4782,3591,8373
4215,LNDC,-0.03933059673240942,-0.017959250732941478,321089024,4159,4215,8374
4216,DOCN,-0.14405743687052985,-0.0033433356948929576,4496438272,4544,3835,8379
4217,SEER,-0.07749208359721342,-0.011548303863350472,3239252224,4316,4069,8385
4218,BURL,-0.06531211762515295,-0.013891906837917592,20404142080,4263,4125,8388
4219,RFL,-0.07241727406494884,-0.012664845418507356,668864576,4296,4096,8392
4220,CCNC,-0.1051026072862888,-0.007185702525165849,130470288,4431,3962,8393
4221,XL,-0.045403267942811,-0.01743417274045552,1197702656,4186,4209,8395
4222,VCYT,-0.08682058491050557,-0.010368238163236768,3494798336,4357,4038,8395
4223,ONEM,-0.0765438508232119,-0.012225284884789685,5591316992,4311,4087,8398
4224,CLR,-0.027680563937988126,-0.023510601393340144,9440264192,4089,4310,8399
4225,JVA,-0.028701412017467384,-0.02312373528632783,30769354,4097,4304,8401
4226,SOI,-0.03861510337389761,-0.019608647974225665,555084864,4154,4247,8401
4227,CPHC,-0.02943823292182727,-0.0229787581536194,65118296,4102,4302,8404
4228,DASH,-0.0874808156106117,-0.010487949659375871,40986660864,4363,4041,8404
4229,SLAC,-0.24839750132690974,-1.4462488699635565e-05,420468736,4817,3588,8405
4230,SFIX,-0.0927084342711126,-0.00939381291770939,5431090176,4388,4018,8406
4231,FCEL,-0.09678258128906865,-0.008907436197215844,4110969600,4400,4006,8406
4232,AIRI,-0.04751213391884307,-0.017614450596594954,46080288,4199,4211,8410
4233,NAV,-0.05087390761548065,-0.017293581972247375,4397462016,4213,4203,8416
4234,SNOW,-0.10648862994536931,-0.008056389158514244,67547140096,4437,3985,8422
4235,HTHT,-0.028372822062197586,-0.025534978046320413,34554298368,4092,4331,8423
4236,NCNO,-0.11717340608087297,-0.006649648900847808,6663289344,4473,3951,8424
4237,FPH,-0.026115754834400123,-0.026377048059264073,1110119936,4080,4348,8428
4238,OKTA,-0.12165710952113368,-0.00654965882713955,29202542592,4482,3946,8428
4239,INVE,-0.10342501297353399,-0.008895004915148526,193894336,4425,4004,8429
4240,MDRR,-0.02814774009184307,-0.026156298410634597,13532804,4091,4342,8433
4241,ZEN,-0.11316875589909246,-0.007990850358695775,16287738880,4451,3982,8433
4242,ALLT,-0.08336180074046035,-0.012473415420352027,688596480,4343,4092,8435
4243,E,-0.02618665830751239,-0.026982291094811872,44324241408,4082,4358,8440
4244,IPI,-0.02927238341493669,-0.026112694973035817,420868544,4101,4339,8440
4245,IOR,-0.01521214674121161,-0.03314815979941379,47936296,3998,4443,8441
4246,GBR,-0.08254610886189834,-0.012930741679155814,28122976,4337,4104,8441
4247,LPSN,-0.07897369326444645,-0.013829149054202041,3857592832,4321,4121,8442
4248,NTIC,-0.047784750973510495,-0.019842920682708372,135474592,4200,4251,8451
4249,SDGR,-0.09050685383342198,-0.011844826970660279,5271926784,4378,4078,8456
4250,CYRX,-0.12131881996253645,-0.0076875111768099705,2337235712,4480,3978,8458
4251,TWLO,-0.1262815055965213,-0.007316646258434448,60197482496,4494,3967,8461
4252,SSSS,-0.036006406823701806,-0.02498207913002911,358262368,4137,4326,8463
4253,CLWT,-0.03204939723610703,-0.026516494110783967,15773596,4115,4350,8465
4254,DSPG,-0.04687734732262504,-0.021276182113514893,354184128,4193,4273,8466
4255,SWTX,-0.08293157124929061,-0.013988481004677951,3441060864,4340,4129,8469
4256,PING,-0.08655203142933428,-0.013550075125859411,1758363008,4356,4119,8475
4257,IRTC,-0.09809484021095569,-0.011625650363472672,3758231040,4407,4071,8478
4258,ARCO,-0.033790710264368924,-0.02693218596880197,1079855872,4122,4357,8479
4259,AE,-0.03068161975520044,-0.028036340285302577,119028560,4110,4371,8481
4260,KOPN,-0.15463898649873062,-0.004994687997320004,953927168,4579,3902,8481
4261,OPEN,-0.08955940786105991,-0.01331271649753702,12606660608,4372,4111,8483
4262,PHR,-0.10120399091810303,-0.011529935326198238,2359051264,4418,4066,8484
4263,NDLS,-0.0450396570129107,-0.022734010455938838,478525088,4185,4300,8485
4264,RFIL,-0.046093064091308165,-0.02242845163724493,64222644,4190,4295,8485
4265,ALGT,-0.05018135259458744,-0.021584371307272206,4112700416,4209,4276,8485
4266,THM,-0.06205293737478311,-0.018954564292585387,235504608,4252,4235,8487
4267,WKHS,-0.05891772449407956,-0.01964537727907434,1675780480,4243,4248,8491
4268,SD,-0.03095517178505379,-0.028762306171970748,139842832,4112,4381,8493
4269,AIRG,-0.07727592651020557,-0.01627839757253918,226913648,4315,4180,8495
4270,AEI,-0.07830551660965755,-0.016155448084868355,96755296,4319,4178,8497
4271,PSX,-0.03747895831270423,-0.026706084472922574,35029200896,4147,4351,8498
4272,PRTG,-0.07647239420764468,-0.01658036040833151,357770048,4310,4188,8498
4273,DFHT,-0.04262053115414135,-0.024882857196341646,238985040,4178,4325,8503
4274,ACEL,-0.07893963713491359,-0.016838267975267187,1068677504,4320,4190,8510
4275,MLP,-0.09084255271232722,-0.014071591373056611,227249296,4381,4134,8515
4276,BE,-0.084552843826601,-0.015960677461709576,4248562944,4344,4173,8517
4277,GAIA,-0.06533585566253494,-0.02000317422885775,216395280,4264,4254,8518
4278,CAL,-0.05668749630104379,-0.021784293954851826,786655808,4239,4281,8520
4279,TRT,-0.027315783676616367,-0.03283576846157981,17662218,4087,4439,8526
4280,CSII,-0.08105399648715729,-0.01707441979160328,1462583168,4329,4197,8526
4281,INCY,-0.09271941884182688,-0.01418306240423336,17890904064,4389,4139,8528
4282,IMGN,-0.0897662288559779,-0.015026921701551631,1561904256,4374,4156,8530
4283,EVER,-0.13649464826267688,-0.009047472495241994,1037639872,4521,4010,8531
4284,CRU,-0.3064409469646872,-2.143136785275213e-05,324084896,4940,3592,8532
4285,ASPU,-0.07273778532447812,-0.01879940537831537,145460832,4300,4233,8533
4286,NVRO,-0.11422174487472354,-0.011996592811891093,4902815232,4454,4081,8535
4287,ALIM,-0.13986339646072649,-0.009068376038439768,55808268,4529,4011,8540
4288,CVNA,-0.1554345462579992,-0.007018425618153936,46045360128,4581,3959,8540
4289,RLAY,-0.07096948983524486,-0.01998812090312661,3225472000,4289,4253,8542
4290,PFPT,-0.11685709936707929,-0.011656912859079277,7427974656,4471,4072,8543
4291,IMO,-0.02601130926489778,-0.03512583596012245,18480758784,4076,4468,8544
4292,TENB,-0.14549338922928087,-0.008803179189898232,3903430656,4546,4000,8546
4293,LI,-0.020361384330418363,-0.03995284452342612,20110235648,4029,4519,8548
4294,RUN,-0.05162489889228089,-0.0254979818595623,10982078464,4218,4330,8548
4295,PDS,-0.02248602521133531,-0.03797134368367431,308456960,4052,4497,8549
4296,XOM,-0.038009405843203774,-0.030378913855238707,239574908928,4152,4399,8551
4297,DDS,-0.03937252278157195,-0.02956479633120307,2110759936,4160,4391,8551
4298,ANGO,-0.09672817982607257,-0.0149799484473777,900042624,4399,4154,8553
4299,OXM,-0.0701125111131549,-0.021209480371255,1487198080,4284,4271,8555
4300,VLO,-0.03687229595061008,-0.031088767136669478,30415759360,4142,4415,8557
4301,MTA,-0.08580647600125815,-0.017416101634658652,384556704,4353,4208,8561
4302,NYC,-0.02371198060489002,-0.03849304754770974,109238672,4061,4501,8562
4303,PDFS,-0.07262910431745907,-0.020846850910624496,702414528,4297,4267,8564
4304,OLMA,-0.06366650203911432,-0.023380796843274425,1254719616,4259,4307,8566
4305,EQT,-0.026316589724068227,-0.037233517077862155,5036103168,4083,4486,8569
4306,KNDI,-0.03617887271916868,-0.03268108586189483,468910848,4139,4435,8574
4307,NNDM,-0.05229793281275181,-0.026793495667825684,1910952960,4222,4355,8577
4308,HP,-0.02693716608996154,-0.03796679403277438,2969248256,4085,4496,8581
4309,LASR,-0.09459386232682478,-0.01684770523767071,1304078080,4394,4191,8585
4310,SYNL,-0.03717982507217152,-0.03332214318708403,90732112,4145,4445,8590
4311,IONS,-0.080027302863877,-0.020754403685104405,6148626432,4328,4266,8594
4312,ATRC,-0.1271468345556871,-0.012737631898555946,2958143488,4496,4098,8594
4313,GCMG,-0.103299892801521,-0.015834192870585562,2311837184,4424,4171,8595
4314,U,-0.1483928294413233,-0.010240795068661119,27204022272,4562,4033,8595
4315,TISI,-0.054428295870956864,-0.02818673241710014,363080608,4231,4374,8605
4316,NNBR,-0.04446880312927431,-0.0315831408535905,302108160,4183,4423,8606
4317,STRS,-0.04635744918461968,-0.03152051320829162,251151856,4191,4421,8612
4318,GPS,-0.04981986618630983,-0.030982408268473684,11509768192,4205,4410,8615
4319,CDMO,-0.1676486426557699,-0.00887140733397744,1184941056,4620,4002,8622
4320,SRG,-0.040307130634615274,-0.034246652985538716,1062774976,4167,4458,8625
4321,CHNG,-0.15138528529206055,-0.011022589962997353,6795769856,4572,4053,8625
4322,GH,-0.11522508647413857,-0.015413809912469677,15870478336,4462,4164,8626
4323,EDRY,-0.03790749380716381,-0.03612784197343834,19839924,4151,4479,8630
4324,PAR,-0.10191976640299841,-0.01753170768188663,1368808960,4420,4210,8630
4325,AGYS,-0.17269814591102473,-0.00840768772781305,1150441984,4638,3992,8630
4326,SNCY,-0.09743675533002472,-0.01855403115724361,2094675840,4404,4227,8631
4327,CAMP,-0.06959477712742008,-0.02676111695614703,386432736,4280,4354,8634
4328,LLNW,-0.0683388169607885,-0.02712992326872112,450610080,4274,4362,8636
4329,LAC,-0.10084316395623473,-0.01826585964466282,1768480768,4415,4222,8637
4330,KEQU,-0.03766281967444902,-0.03765379836180709,33899556,4148,4490,8638
4331,GSAT,-0.08152923931946868,-0.023276247982601493,2186781952,4332,4306,8638
4332,DOCU,-0.22538908803339577,-0.004246180053969083,39720132608,4766,3875,8641
4333,BIGC,-0.16770896987505363,-0.009495186133738485,4248993536,4622,4020,8642
4334,HUIZ,-0.03335096708923324,-0.039999272353169836,441978784,4120,4523,8643
4335,MPC,-0.048855650343868615,-0.03307811974167308,35199807488,4203,4441,8644
4336,PEGA,-0.13680338712936593,-0.013835603047013548,9567304704,4523,4122,8645
4337,XNET,-0.048481138951196906,-0.033315393963346894,425359360,4202,4444,8646
4338,BNED,-0.051442437598475624,-0.0326544990279275,399727840,4215,4432,8647
4339,ALXO,-0.10157729440502501,-0.01859594706123014,2775999744,4419,4228,8647
4340,TLGT,-0.050674181441370855,-0.03273284320267737,57546852,4211,4437,8648
4341,GILT,-0.07935533080405345,-0.02477782294346111,588026624,4325,4323,8648
4342,WIX,-0.16004651958713056,-0.010842487890320855,16918241280,4598,4051,8649
4343,LACQ,-0.10868794678197873,-0.01741104055351001,77616648,4443,4207,8650
4344,STRT,-0.04702192743040178,-0.03431484023377174,194728784,4194,4459,8653
4345,DDD,-0.12845701907874507,-0.014980158748796314,3031230208,4499,4155,8654
4346,CCXI,-0.11806582345653388,-0.016330362632890328,3341438208,4474,4182,8656
4347,ISUN,-0.1480880915850514,-0.012726166342690975,123193768,4559,4097,8656
4348,NEWR,-0.10392385007674407,-0.01865719313074602,3988930816,4428,4230,8658
4349,SKYW,-0.0398070939639079,-0.037897592966699645,2717952000,4165,4494,8659
4350,CDOR,-0.035862052934977996,-0.04023373378437535,43392560,4134,4526,8660
4351,KIQ,-0.09732748862012905,-0.02022920551146695,50370644,4403,4258,8661
4352,CSPI,-0.03503937007874016,-0.0409472902555571,38578416,4129,4533,8662
4353,CAKE,-0.0629014683539509,-0.030873342290023705,2730372864,4257,4406,8663
4354,QTWO,-0.13656425803576153,-0.01429995509524344,5661140992,4522,4141,8663
4355,BLI,-0.14922605194133512,-0.012742060379088087,3366269952,4564,4099,8663
4356,PD,-0.11592778488139087,-0.017077928717822544,3505874176,4467,4198,8665
4357,BHFAP,-0.005300664516045894,-0.0651423491542816,4614130176,3889,4778,8667
4358,XPL,-0.06297879544588818,-0.030973437696055824,48472164,4258,4409,8667
4359,BB,-0.12483745123537061,-0.01601254102212853,5060300800,4492,4175,8667
4360,CCO,-0.070310155112951,-0.0290890174054627,973146688,4285,4384,8669
4361,COTY,-0.09798835362625728,-0.020730254541184566,6663457280,4406,4265,8671
4362,AFRM,-0.2210850169213414,-0.005646116604959091,18404601856,4757,3919,8676
4363,CHWY,-0.27786258604114,-0.002599038886038584,33989195776,4877,3801,8678
4364,CSBR,-0.17620933861481214,-0.009967006763388093,143542944,4651,4028,8679
4365,CDXS,-0.12366614277442303,-0.016965878180409906,1534024704,4490,4194,8684
4366,FORD,-0.10323247656532186,-0.02059559494460061,29856776,4423,4264,8687
4367,CLDT,-0.03939882419874834,-0.04030592335073516,642782656,4161,4528,8689
4368,IHT,-0.062313415303635794,-0.03270037754001967,23882348,4253,4436,8689
4369,NTZ,-0.050542617916881236,-0.03645019350651219,164558784,4210,4480,8690
4370,QUOT,-0.1063366316287003,-0.02003333497383808,1473852928,4436,4256,8692
4371,EDN,-0.022226807217616384,-0.05117025205732421,248972752,4050,4643,8693
4372,RDCM,-0.058195211786372006,-0.033958552127103823,133573192,4242,4451,8693
4373,MDRX,-0.10583031110640005,-0.020518158381173195,2153692160,4432,4261,8693
4374,BHF,-0.005300664516045894,-0.06700798418224774,4086715904,3889,4806,8695
4375,ITI,-0.10852920045160629,-0.02000956523071335,251925632,4442,4255,8697
4376,QTRX,-0.1490442660794143,-0.014123525837884418,2326929408,4563,4135,8698
4377,IMBI,-0.0908313742252618,-0.024612813363185843,118299288,4379,4321,8700
4378,GDYN,-0.10743470350612107,-0.020570228217471523,776910976,4438,4263,8701
4379,SND,-0.02203521552434707,-0.05333302190209433,110262672,4045,4661,8706
4380,GROW,-0.14297614089367525,-0.015538708597909538,154573056,4542,4167,8709
4381,WORK,-0.17383391620803226,-0.01153772358523338,24138348544,4643,4067,8710
4382,TKAT,-0.26552989185742004,-0.0036451562895192745,415689248,4855,3855,8710
4383,LSPD,-0.2407392458199211,-0.005462938941814418,8844782592,4796,3915,8711
4384,MITC,-0.26658243840808593,-0.003630243930369788,117115632,4858,3854,8712
4385,ATHA,-0.07266734021907413,-0.031198258791708334,697121152,4298,4417,8715
4386,LVS,-0.08979227161045343,-0.026118339722146045,47458934784,4375,4340,8715
4387,TRCH,-0.14719896096996657,-0.01538007763109665,263018336,4554,4163,8717
4388,MTSL,-0.1945080091533181,-0.009534605795649393,15617788,4699,4021,8720
4389,JCS,-0.046524209305701836,-0.04075703527763299,55032664,4192,4531,8723
4390,XELA,-0.2360407504314424,-0.0063113010668952784,130910296,4785,3939,8724
4391,AGMH,-0.25990669419350465,-0.004494469390423278,272236320,4844,3882,8726
4392,SPT,-0.18857429068088744,-0.010571131693709164,3078239232,4683,4044,8727
4393,TMQ,-0.06281111068890831,-0.035828189072961536,333036992,4255,4473,8728
4394,KIDS,-0.12305149109063387,-0.019327982594166765,951658304,4489,4241,8730
4395,EVBG,-0.1666175524417137,-0.01382077936049669,4698631168,4612,4120,8732
4396,GSV,-0.03554361017878271,-0.047019515744355304,213238832,4131,4602,8733
4397,CEIX,-0.02861715832225778,-0.05080895750245757,329225312,4096,4639,8735
4398,PCT,-0.157432340816154,-0.014924773537464145,3037355264,4589,4152,8741
4399,UIS,-0.060102391472052735,-0.03808127507107628,1689849856,4247,4498,8745
4400,BGI,-0.07010028782155064,-0.03514617313134533,45106960,4283,4469,8752
4401,GLPG,-0.035525856539832645,-0.0501690831112166,5060512256,4130,4628,8758
4402,MGNI,-0.24039110575190212,-0.0072465309349897524,4657486336,4795,3963,8758
4403,KRYS,-0.1117125717690391,-0.023838531468673322,1637088512,4447,4315,8762
4404,PLL,-0.2501471330390236,-0.00631909310435452,1042496640,4821,3941,8762
4405,AIH,-0.028927798558136975,-0.053745702421731545,179458032,4100,4664,8764
4406,CDLX,-0.15227925636066328,-0.01681459647353007,3067464704,4575,4189,8764
4407,RSSS,-0.17532260660290339,-0.013482967346463965,62540928,4649,4115,8764
4408,ERJ,-0.033331233280708,-0.05176661890074034,1909677440,4118,4648,8766
4409,FRD,-0.037138614522585794,-0.04982768855089056,57871024,4144,4626,8770
4410,LMNR,-0.057697104232659065,-0.04074647148239318,300643296,4240,4530,8770
4411,GPRK,-0.07904558609761528,-0.03389334787188004,1019234432,4322,4449,8771
4412,VINC,-0.09905177943037426,-0.027267117154691118,265843440,4408,4363,8771
4413,CNNE,-0.038110961261219364,-0.04962373161257569,3743955200,4153,4620,8773
4414,CVU,-0.11467087070080931,-0.024222501917053864,55095496,4460,4316,8776
4415,ANDA,-0.09947429026775668,-0.027807994673208877,45319448,4412,4368,8780
4416,INSP,-0.2157994962835555,-0.010124496244168541,5696730624,4750,4031,8781
4417,ALKS,-0.08599228396950302,-0.03236162701149818,3036668672,4354,4430,8784
4418,AMTX,-0.2650307819936253,-0.006237673196549333,669350272,4852,3936,8788
4419,FARM,-0.04730770480616125,-0.04570647019762325,189618704,4197,4594,8791
4420,SHI,-0.024765144335180494,-0.059701965487362,4704642560,4068,4725,8793
4421,RPAY,-0.17890118477629258,-0.014025621710743548,1937469952,4660,4133,8793
4422,LUNG,-0.13013535977202564,-0.022258635853657678,1654226816,4504,4291,8795
4423,SBTX,-0.08545623995659432,-0.03385227735760925,1349369344,4352,4447,8799
4424,PMVP,-0.09729868205980714,-0.03027478910336884,1509173632,4402,4398,8800
4425,BCAB,-0.1415251368278508,-0.020909661691719136,1645140096,4534,4268,8802
4426,BEEM,-0.16925014996493695,-0.016242437133397236,345481696,4624,4179,8803
4427,MSGS,-0.1561440465442873,-0.01836874499154915,4522104320,4582,4224,8806
4428,HPK,-0.056607726554088786,-0.044466413099972006,653365120,4238,4572,8810
4429,MDB,-0.21558862397757014,-0.01144497708934355,17425274880,4749,4062,8811
4430,STXS,-0.18509785561230563,-0.014308587100191152,498608864,4670,4142,8812
4431,VOXX,-0.07532982512509256,-0.038685547322600336,456783616,4309,4504,8813
4432,SE,-0.2358435938016288,-0.0102042925766863,127413616640,4784,4032,8816
4433,ASM,-0.0732143417296653,-0.039746053033018924,124136624,4301,4516,8817
4434,BNTX,-0.2095096744903281,-0.012103508664602879,27369158656,4736,4082,8818
4435,EVH,-0.15054014058453571,-0.02015484931449876,1694286592,4567,4257,8824
4436,EAR,-0.15925691911504256,-0.018625353331422585,1959958528,4595,4229,8824
4437,INN,-0.05145969401000269,-0.048178171764181474,1093031040,4216,4609,8825
4438,LOVE,-0.16678700216239928,-0.017910236559577457,870707840,4614,4213,8827
4439,ITP,-0.030053830017891924,-0.05925174456554503,73282960,4106,4723,8829
4440,WPRT,-0.14022601325654677,-0.02268975052435565,1010742016,4531,4299,8830
4441,NSYS,-0.05622358554873892,-0.04571003354744043,16733446,4236,4595,8831
4442,PLT,-0.1459694568695028,-0.02190506284833695,1569625600,4547,4284,8831
4443,GEVO,-0.17722043664680262,-0.016126108575517918,1690407168,4654,4177,8831
4444,UAVS,-0.21444590037666375,-0.012346348356778052,421154272,4744,4090,8834
4445,ORLA,-0.11223533172908683,-0.02924556962773149,882623488,4448,4387,8835
4446,ARWR,-0.199714811473988,-0.01398956501573966,6762064896,4711,4130,8841
4447,CENX,-0.06943845423962736,-0.04427090922632058,1371549824,4279,4566,8845
4448,MXL,-0.1793230398260414,-0.01642578555899547,2594120448,4661,4185,8846
4449,RMO,-0.10095680128946107,-0.03266073881171775,1326230400,4417,4433,8850
4450,USAP,-0.03421102495606588,-0.06026860213182246,86368704,4124,4727,8851
4451,SNAP,-0.2572896344289664,-0.009197490513680443,90844913664,4838,4014,8852
4452,FSLY,-0.24218101769536873,-0.011040577388323787,7741230592,4799,4054,8853
4453,TSRI,-0.06938727591934503,-0.04488537397836844,18443364,4278,4580,8858
4454,KYMR,-0.12296644872768604,-0.02792974414728182,1578261120,4488,4370,8858
4455,PHAT,-0.10779307895671389,-0.031345850511627436,1088742912,4439,4420,8859
4456,RADI,-0.12254896641527861,-0.028550963336831617,887536320,4487,4376,8863
4457,ALYA,-0.1285329846593587,-0.027586574528508438,200546416,4500,4364,8864
4458,VET,-0.049879611350455696,-0.05263707067776911,1123366528,4206,4659,8865
4459,EMKR,-0.0896849881857672,-0.03785574865761913,224457456,4373,4493,8866
4460,CRIS,-0.13436806856020336,-0.0264742814721788,1059656896,4517,4349,8866
4461,BORR,-0.04207423722225821,-0.057475363873298733,276998784,4175,4704,8879
4462,EH,-0.1328603167777539,-0.02781565917046746,1859677824,4511,4369,8880
4463,OLB,-0.1893948377304327,-0.01698778180548579,38633240,4686,4195,8881
4464,RLJ,-0.04892393823674085,-0.05528521591229013,2623845376,4204,4679,8883
4465,DNOW,-0.06521739130434782,-0.049641768451597124,1081927680,4262,4621,8883
4466,TPHS,-0.0562178390549669,-0.05198033965256876,67156176,4235,4651,8886
4467,RHP,-0.09083187888168853,-0.039161326202312115,4267269376,4380,4510,8890
4468,CBAT,-0.21255987411169872,-0.014908562149206135,453745920,4740,4151,8891
4469,SSYS,-0.08493853913476776,-0.0426411267275263,1515089280,4347,4546,8893
4470,AXGN,-0.1313457528782522,-0.02918703606688707,785668736,4507,4386,8893
4471,TLGA,-0.6144617230400073,-2.7298263811151284e-05,487500000,5300,3593,8893
4472,AAU,-0.05300826562839947,-0.05392747880209799,73669296,4226,4668,8894
4473,VRNS,-0.2270949355124831,-0.013852352075952756,5470305792,4770,4124,8894
4474,LODE,-0.14293903849279146,-0.026883001884932076,201239056,4541,4356,8897
4475,INDO,-0.08696935302150506,-0.04168026710121438,45929352,4359,4539,8898
4476,KOD,-0.13129039264425513,-0.029663873510038075,5497911296,4506,4392,8898
4477,KNTE,-0.0915434043537851,-0.0399205142541995,1259975040,4383,4518,8901
4478,OTRK,-0.15073280607658354,-0.025593859169651855,587847552,4569,4332,8901
4479,TRVG,-0.12131830497831218,-0.031592238015426544,1494538240,4479,4424,8903
4480,ARVL,-0.35182083623590094,-0.00494438396031595,9674265600,5007,3898,8905
4481,BJRI,-0.08275969034683162,-0.04428300087878153,1395697664,4339,4568,8907
4482,PEB,-0.05277445457487624,-0.055973059850572604,3150616576,4224,4689,8913
4483,GPRE,-0.08137846718117216,-0.045067711092567644,1219075968,4330,4584,8914
4484,CLPT,-0.23955324475255152,-0.013845000139518426,444878656,4792,4123,8915
4485,STTK,-0.11118637740325271,-0.035285900196465964,1187686016,4446,4470,8916
4486,MBI,-0.053776196124950576,-0.05619774221537635,538052096,4228,4692,8920
4487,UUUU,-0.1473003606696613,-0.02765548688004028,898346368,4555,4365,8920
4488,GRUB,-0.20159457899289562,-0.017395552789070925,6114796032,4716,4204,8920
4489,WTT,-0.1038623988601089,-0.037910919258620675,38338732,4427,4495,8922
4490,YRD,-0.012390070002817558,-0.089760909066115,360089216,3966,4967,8933
4491,VOLT,-0.07105522254075812,-0.05156042490959301,83251176,4290,4645,8935
4492,PLM,-0.04995660442226181,-0.060457103300849024,308122240,4208,4732,8940
4493,ZNH,-0.038785794349546376,-0.06610205461444055,14500410368,4156,4788,8944
4494,XNCR,-0.1346894946362278,-0.03173874629090495,2445287424,4518,4426,8944
4495,RPD,-0.23547634921108757,-0.015318231797028452,4075905024,4783,4161,8944
4496,MRO,-0.051842561070298034,-0.05976524511371805,8632491008,4219,4726,8945
4497,AMYT,-0.16086047098705328,-0.026186103383358448,510365760,4601,4344,8945
4498,BBQ,-0.07002045303962896,-0.0537703770704471,104708704,4282,4665,8947
4499,REPH,-0.09208216970406102,-0.04372981545577539,98622296,4384,4563,8947
4500,PHX,-0.05281720194728799,-0.0594355193904908,64162380,4225,4724,8949
4501,MDLA,-0.17256886297747434,-0.024358144186899838,4487870976,4635,4318,8953
4502,CTSO,-0.1372194282214859,-0.03255094381152615,379856160,4524,4431,8955
4503,WLDN,-0.17643029551829864,-0.0229909765765488,512008640,4652,4303,8955
4504,TPTX,-0.11618588518961702,-0.03775552867368043,3952677888,4468,4492,8960
4505,PK,-0.05574308033561578,-0.060363862838064365,5183265280,4234,4728,8962
4506,ENTA,-0.09013258293197683,-0.0452861426878729,980959488,4377,4586,8963
4507,PSTG,-0.14261893072761353,-0.0319658165349236,6063667200,4536,4429,8965
4508,DRH,-0.06104005561201591,-0.05902326087459099,2220523264,4250,4721,8971
4509,AXNX,-0.1814205879970843,-0.02341787699193481,2491181056,4663,4308,8971
4510,MRNA,-0.2588734785148419,-0.014022716833021372,52657020928,4840,4132,8972
4511,KVHI,-0.09291787663205357,-0.045218846136821776,245116336,4391,4585,8976
4512,ESTA,-0.22177557100297915,-0.018131201028578178,1548457344,4760,4218,8978
4513,WYNN,-0.09700446039711026,-0.044745166702862604,15343114240,4401,4578,8979
4514,GME,-0.22063899460129216,-0.018447912873732368,12463523840,4754,4225,8979
4515,PLYA,-0.07360540349232876,-0.05524232196518839,1199059328,4303,4678,8981
4516,CLDR,-0.16878068195035953,-0.027080378648922786,3595863808,4623,4360,8983
4517,PDD,-0.12719121652773338,-0.03772325768526092,172767903744,4497,4491,8988
4518,DM,-0.1534904892754242,-0.031002675904592714,3422285824,4576,4412,8988
4519,TZPS,-0.75,-4.181542830517341e-05,358416896,5393,3596,8989
4520,CDZI,-0.17435547512386151,-0.026332526662792195,371927104,4645,4347,8992
4521,XLRN,-0.19182640161252226,-0.02248027132538659,8053136896,4695,4297,8992
4522,PACB,-0.2620260041866634,-0.01444278716836018,6855159808,4847,4145,8992
4523,PLRX,-0.1466750256227833,-0.03310377461408129,1297296640,4553,4442,8995
4524,NNOX,-0.18902399544177254,-0.023613936809939843,2063443712,4684,4312,8996
4525,BA,-0.16127470153284534,-0.03007319880521218,147415793664,4602,4397,8999
4526,ADPT,-0.1732579760096143,-0.02710352678240913,5656508928,4639,4361,9000
4527,SWAV,-0.2664234909377143,-0.014314969954508101,4598539264,4857,4143,9000
4528,KRTX,-0.20487598746375876,-0.021855557026811894,3240622848,4723,4282,9005
4529,ARKR,-0.07067702681754767,-0.05882272117149638,74699704,4287,4720,9007
4530,GDRX,-0.2447013346413746,-0.017135367113705415,15853936640,4807,4200,9007
4531,FATE,-0.23856842183687535,-0.01825191378009849,7099403264,4789,4219,9008
4532,GKOS,-0.1858007831224517,-0.025989392926275865,3660606464,4672,4337,9009
4533,SEAS,-0.12153685659770731,-0.040560118632442015,4003168768,4481,4529,9010
4534,HST,-0.07224933102471273,-0.05871444343871421,12357994496,4295,4716,9011
4535,EXTR,-0.207001111636968,-0.021881493623366853,1120498560,4728,4283,9011
4536,INTZ,-0.3061443066516347,-0.011667460624006816,479832608,4938,4073,9011
4537,XONE,-0.18992113486434203,-0.02507818577972422,631969984,4687,4327,9014
4538,EMX,-0.11522894913305873,-0.043235209640491164,269808224,4463,4555,9018
4539,KOS,-0.06655085968925226,-0.06211258730512841,1235767296,4265,4754,9019
4540,LMND,-0.20523275569147129,-0.02285372648232736,5617090048,4724,4301,9025
4541,LTRX,-0.17381300983057937,-0.029119647255175744,130927168,4642,4385,9027
4542,KRON,-0.11629547112047893,-0.04350529087117008,1569335552,4469,4560,9029
4543,FOSL,-0.07217155987630966,-0.06094670646910325,639432704,4293,4737,9030
4544,H,-0.08461641451332173,-0.05574095797838479,8584161792,4345,4686,9031
4545,TATT,-0.0417043917597219,-0.07441988196061264,45590452,4173,4860,9033
4546,XHR,-0.06927299545743187,-0.06286013502893119,2235875328,4277,4761,9038
4547,ANAB,-0.0601893978539615,-0.06639373731139747,590292416,4248,4791,9039
4548,FEYE,-0.21439140461495396,-0.022431490781465536,4697679872,4743,4296,9039
4549,PFIE,-0.0741207296811097,-0.06053900473146737,57612788,4307,4733,9040
4550,AOUT,-0.14820396079814466,-0.03671941389597986,356500640,4561,4483,9044
4551,NSTG,-0.17362984523640493,-0.03081112044027962,3059683072,4641,4404,9045
4552,XBIT,-0.052252973467520586,-0.06941305993733408,496675392,4221,4825,9046
4553,EMAN,-0.20806762122488268,-0.02451408664404514,275231296,4731,4319,9050
4554,TMDX,-0.18825947041320898,-0.028102466500995044,916894976,4681,4372,9053
4555,X,-0.0775514649820281,-0.061117812767028185,6348631552,4317,4739,9056
4556,SMAR,-0.2816139629809437,-0.016002501703586466,7601746944,4884,4174,9058
4557,VEI,-0.0957720201989882,-0.05370595037380626,939235968,4397,4663,9060
4558,AQB,-0.13161633353107313,-0.04313505813761647,461813568,4508,4553,9061
4559,SCWX,-0.19621728217999282,-0.027046235030973545,1139992192,4703,4359,9062
4560,FWONA,-0.1672316384180791,-0.033958546187132475,10516764672,4617,4450,9067
4561,FWONK,-0.1672316384180791,-0.033978528821927693,10509075456,4617,4452,9069
4562,MORF,-0.23247792494481237,-0.022266995338467297,2181440000,4779,4292,9071
4563,FLXS,-0.0878577996376437,-0.05793142979389469,273478336,4364,4709,9073
4564,BHR,-0.06375029010621101,-0.0684092907718095,253324448,4260,4815,9075
4565,VRM,-0.15354452558258697,-0.038499787944739905,5212463616,4577,4502,9079
4566,OEPW,-0.9912724176467458,-3.8310362739840156e-05,485905312,5486,3594,9080
4567,IMCC,-0.2604995882514411,-0.018957649905726,361729632,4845,4236,9081
4568,IZEA,-0.22566251178141633,-0.02372135136660972,270221376,4768,4314,9082
4569,DGNU,-1.0,-3.87938032082227e-05,515500032,5488,3595,9083
4570,NAAC,-1.0,-4.318645888581635e-05,462752672,5488,3598,9086
4571,GNUS,-0.15061246015825336,-0.039976994130403516,531569920,4568,4521,9089
4572,EQH,-0.014485131462203362,-0.11585241697158852,14521070592,3990,5102,9092
4573,YPF,-0.044995860070378806,-0.08023178977025501,1687312768,4184,4908,9092
4574,CPUH,-1.0426100549644497,-1.9465054290875778e-05,1061948224,5504,3590,9094
4575,SXTC,-0.14285724937823638,-0.04336978610729848,25909048,4537,4558,9095
4576,HLAH,-1.0240369138319563,-5.989430509783697e-05,318211872,5496,3602,9098
4577,ACTG,-0.060037281066017016,-0.07343433836917768,306518464,4246,4853,9099
4578,GTE,-0.07048983260514334,-0.06837982074660469,249796320,4286,4814,9100
4579,USIO,-0.2854007560157141,-0.017400940438777095,157443104,4894,4206,9100
4580,ITMR,-0.22539558337680404,-0.02590315017476458,391861408,4767,4335,9102
4581,JAX,-0.06805862711937904,-0.07087310792057444,151353696,4271,4832,9103
4582,SOGO,-0.1428590357761696,-0.04400119559535446,3066251264,4538,4565,9103
4583,GSM,-0.08696276903149192,-0.061750633073402006,622508800,4358,4749,9107
4584,CPS,-0.07154144108712321,-0.06900896624504398,587174208,4292,4820,9112
4585,SOHON,-0.08835168711808745,-0.06168013083950343,79931624,4365,4747,9112
4586,PRCH,-0.21148539864469604,-0.028149720084067582,1572875008,4739,4373,9112
4587,INFN,-0.15892120981917826,-0.03996404988580925,2002959872,4593,4520,9113
4588,PHVS,-0.42896406189118425,-0.008871854172744624,921289152,5110,4003,9113
4589,PRFX,-0.09922802850356295,-0.05751074497581176,43771440,4410,4705,9115
4590,SOHOO,-0.08835168711808745,-0.06197302102527843,77656000,4365,4751,9116
4591,PLG,-0.31170895390592807,-0.015321668933752818,306045984,4955,4162,9117
4592,NETI,-0.04381838221457566,-0.0841758740760794,246123584,4182,4937,9119
4593,ZOM,-0.32379027910971137,-0.014762867430101611,1195580928,4973,4146,9119
4594,FURY,-0.06447834616848701,-0.07428099237786613,152286960,4261,4859,9120
4595,SOHOB,-0.08835168711808745,-0.062135523867772526,76402680,4365,4755,9120
4596,FORA,-0.36569680881041866,-0.012493080759493205,329188640,5028,4093,9121
4597,MGM,-0.08150738852114973,-0.06662582304346822,20339714048,4331,4796,9127
4598,GMBL,-0.3554837281412541,-0.013516343937493796,310229984,5010,4117,9127
4599,DAIO,-0.10465173275819813,-0.05717300256006513,46318800,4429,4700,9129
4600,BMRA,-0.15414371311110173,-0.043106709615122966,62905736,4578,4551,9129
4601,BWAY,-0.17746499577376795,-0.035630300532915375,145691712,4657,4472,9129
4602,STPC,-1.163955589981926,-4.405735874054624e-05,511175008,5532,3599,9131
4603,VUZI,-0.4114249589831687,-0.010761154621817348,1813244416,5086,4047,9133
4604,TMST,-0.06121687196715192,-0.07758094783482297,516676320,4251,4889,9140
4605,GAU,-0.07379533134638849,-0.07132522962982955,265430336,4305,4835,9140
4606,AEHR,-0.1521219366407651,-0.0442747263995876,58024004,4573,4567,9140
4607,IPHA,-0.0864903935832867,-0.06604753086147176,353965920,4355,4786,9141
4608,DRRX,-0.21465398424339363,-0.02999553341184277,411235616,4746,4395,9141
4609,ALLK,-0.22527855552750556,-0.028567387537468937,5682499584,4765,4379,9144
4610,WAFU,-0.16668293341186635,-0.04078577376062889,42452180,4613,4532,9145
4611,NTLA,-0.22315004215217918,-0.02894384216410778,4814662656,4764,4382,9146
4612,ZLAB,-0.25358125622292893,-0.02424021461231162,12794499072,4829,4317,9146
4613,SOHO,-0.08835168711808745,-0.06597880189189775,48560640,4365,4785,9150
4614,MCF,-0.25504453060162763,-0.024530670958813693,738835392,4831,4320,9151
4615,SMHI,-0.05969690810127154,-0.08020966963011131,119424656,4245,4907,9152
4616,AXR,-0.05376114234411406,-0.0820220459605235,71832976,4227,4926,9153
4617,SY,-0.021894579764950135,-0.1187791619037537,1033490944,4044,5118,9162
4618,SIBN,-0.18680128963333206,-0.03755116092807487,1043686336,4676,4489,9165
4619,CNET,-0.2901839436135465,-0.020313670021663423,77561752,4906,4259,9165
4620,M,-0.08515057113187954,-0.06914656363766948,4959755264,4349,4821,9170
4621,CCCC,-0.16966425848896674,-0.04221871807195914,1559628672,4626,4545,9171
4622,SHSP,-0.19447478928874465,-0.035932509940117346,202799744,4698,4476,9174
4623,PRO,-0.20100319086481866,-0.034317975604389823,1888709504,4714,4460,9174
4624,PI,-0.22942852925480578,-0.03045979750225319,1268219392,4776,4400,9176
4625,LSF,-0.15968148510319569,-0.0448975187596277,337044800,4597,4581,9178
4626,EXAS,-0.2571716412964231,-0.02613334215131837,21843431424,4837,4341,9178
4627,PRPH,-0.17344185236768803,-0.04177416832190912,85924880,4640,4541,9181
4628,OSH,-0.4116820467418077,-0.012659919917396146,14418397184,5087,4095,9182
4629,KROS,-0.17790428545826836,-0.04018505925611994,1419745408,4658,4525,9183
4630,SILK,-0.267020950306399,-0.025158861707056304,1696963456,4859,4328,9187
4631,GPAC,-1.5,-8.134269854597648e-05,368624992,5584,3604,9188
4632,GLDG,-0.16713860957339116,-0.044713011859947416,249683920,4616,4577,9193
4633,HT,-0.07381581435866283,-0.07758929275253945,416758976,4306,4890,9196
4634,IDYA,-0.13613271244737685,-0.05518065199974596,673911360,4519,4677,9196
4635,GRNQ,-0.3142348781004546,-0.019030419177734594,147194064,4958,4238,9196
4636,GP,-0.5538928979394578,-0.006991560606699925,448495168,5239,3957,9196
4637,KRKR,-0.03590624524026738,-0.10612326259414466,125980848,4136,5063,9199
4638,FOXW,-1.3639435713136299,-0.00035850231133748896,70796880,5567,3635,9202
4639,ONCT,-0.155306283255571,-0.04974377898776043,463526112,4580,4624,9204
4640,VVNT,-0.19836434336837702,-0.03828088020283889,2810101248,4707,4499,9206
4641,IGMS,-0.21277900416973264,-0.03460268433331922,2630589696,4741,4465,9206
4642,FENG,-0.047792351546617755,-0.09545963401022776,131233680,4201,5006,9207
4643,ICAD,-0.3173766058147397,-0.019449540061884176,486159936,4965,4242,9207
4644,BSQR,-0.17052980132450332,-0.044957081264070914,41889332,4628,4582,9210
4645,OPNT,-0.04136260186178654,-0.10218224231096998,45062116,4171,5041,9212
4646,BATRK,-0.12178877259752617,-0.06041549366209753,1485661824,4483,4730,9213
4647,EPIX,-0.29632798610267413,-0.022024173434805425,1123031296,4926,4289,9215
4648,TWST,-0.325335908446963,-0.019109202470148225,6209239040,4976,4239,9215
4649,SKLZ,-0.4036075128156042,-0.014132830764464942,6928393728,5078,4137,9215
4650,CSTA,-1.725579905751018,-9.697539936265956e-05,388717312,5607,3608,9215
4651,BATRA,-0.12178877259752617,-0.06060925820359189,1478888576,4483,4734,9217
4652,SUNW,-0.28514876370605424,-0.02479882838487231,387864032,4893,4324,9217
4653,UFCS,-0.08164413342723065,-0.077321243473484,863615296,4333,4885,9218
4654,HOFV,-0.10999932510901352,-0.06481172299435115,376446400,4444,4774,9218
4655,SHO,-0.0890420285546344,-0.07335767854992897,2738405120,4369,4851,9220
4656,NOV,-0.08940231039678553,-0.07322539746657984,5283551744,4371,4850,9221
4657,IBIO,-0.1594511500797085,-0.05022629270920687,328335200,4596,4629,9225
4658,NBR,-0.07080449310650068,-0.08462010010776157,702914432,4288,4941,9229
4659,NTRA,-0.29570276182663385,-0.023680089378016706,8780406784,4923,4313,9236
4660,ITOS,-0.13640611724723875,-0.05879143905832755,1085963136,4520,4718,9238
4661,BBW,-0.08534943856044773,-0.07748251801022364,129438024,4351,4888,9239
4662,CDMOP,-0.1676486426557699,-0.04960806209697726,205154576,4620,4619,9239
4663,CLRO,-0.11256879203957974,-0.06640561335667751,54449820,4450,4792,9242
4664,VIST,-0.06695380310903873,-0.0912945010592191,243559056,4267,4978,9245
4665,LBRT,-0.11840213876203243,-0.06470886054958558,2023427072,4475,4771,9246
4666,RBCN,-0.05191247703357274,-0.09971442149016466,25409506,4220,5030,9250
4667,SFE,-0.12454815831617479,-0.06257649643346155,142627280,4491,4759,9250
4668,PRLD,-0.2769031406827981,-0.02840039297486936,2276025088,4876,4375,9251
4669,CHRA,-0.24916994997565187,-0.03267599271680366,147988688,4820,4434,9254
4670,PLUG,-0.2659701270340578,-0.03056007269237316,18846298112,4856,4401,9257
4671,NKTX,-0.15664544932014268,-0.05469083183994985,1029664192,4585,4673,9258
4672,ENFA,-2.476851175697386,-9.408440098634117e-05,360174176,5654,3607,9261
4673,SPR,-0.10234440080923479,-0.07197038690870655,5117051392,4422,4843,9265
4674,RVMD,-0.24894079231433505,-0.03388925960927068,3323525120,4819,4448,9267
4675,KURA,-0.14794072003966593,-0.05831489407739978,1871128576,4557,4712,9269
4676,AGS,-0.18216772455383629,-0.04764192623148407,295142144,4665,4604,9269
4677,NRIX,-0.18471364737183205,-0.04672652528485513,1465526016,4669,4600,9269
4678,AVDL,-0.13107867008477334,-0.06376021869638487,503385344,4505,4767,9272
4679,GSQD,-2.736167734420501,-0.00010987424086266237,427368736,5663,3610,9273
4680,HHLA,-3.0881565062099194,-7.5331639657562e-05,504562496,5670,3603,9273
4681,MEIP,-0.13163541174956014,-0.06344093059934462,375843520,4509,4765,9274
4682,INSG,-0.3500405754334194,-0.02095772928830053,931148864,5005,4270,9275
4683,MLCO,-0.1444770339728689,-0.0604464487417929,9864112128,4545,4731,9276
4684,FBRX,-0.2411834520176331,-0.03606551438484894,450927104,4798,4478,9276
4685,OCGN,-0.5548469222967444,-0.010322087733079358,1295933184,5240,4037,9277
4686,ARVN,-0.18683319162519021,-0.04787034260213654,3145530624,4677,4606,9283
4687,AMR,-0.06768109276514268,-0.09697046583696778,258734624,4270,5014,9284
4688,PSNL,-0.206389626161817,-0.0433293833472701,1000577664,4727,4557,9284
4689,SPLK,-0.27440069333217254,-0.031016150754999836,22739214336,4871,4413,9284
4690,CVI,-0.09137544084642514,-0.07998284144099135,1943264256,4382,4903,9285
4691,UBER,-0.24463021014745154,-0.03671845872782,105867165696,4806,4482,9288
4692,PWFL,-0.5563063063063063,-0.010729514124409343,281338592,5243,4046,9289
4693,IKNX,-0.12254648529812139,-0.06698076005925145,21313138,4486,4805,9291
4694,AXU,-0.14290284807494194,-0.062091601685630875,368034272,4539,4753,9292
4695,GCAC,-4.739598629466471,-4.619631546718146e-05,209587504,5693,3601,9294
4696,SUMO,-0.19729866862576176,-0.04540979503541892,1917483648,4705,4590,9295
4697,RCL,-0.11378898910733601,-0.0723198418214533,23175053312,4453,4845,9298
4698,FWAA,-4.2328878307450895,-0.00017477097273623093,447467424,5687,3615,9302
4699,CRSP,-0.20445888642057494,-0.04505782056599155,8940587008,4722,4583,9305
4700,REPL,-0.2390121634574279,-0.0399908441943278,1365979008,4791,4522,9313
4701,URG,-0.17055522174352156,-0.05563265517178109,227769200,4629,4685,9314
4702,AHT,-0.09656432436825826,-0.08151742057336861,287030336,4398,4918,9316
4703,STOK,-0.18514485165794067,-0.05167781993346285,1302319488,4671,4646,9317
4704,CMPS,-0.2398644695539807,-0.0401848973025805,1356708608,4793,4524,9317
4705,HSON,-0.08297532064348208,-0.09127820534491501,44785300,4341,4977,9318
4706,ARGX,-0.28915523402124127,-0.031231753649396145,14181751808,4900,4418,9318
4707,NRP,-0.08180941787170931,-0.09297900999186558,199226176,4334,4987,9321
4708,CRON,-0.11518656275588979,-0.07450101198624216,3148299008,4461,4862,9323
4709,BLUA,-7.240356606937947,-0.00022775091569884236,360027520,5706,3622,9328
4710,FVT,-11.282993715482766,-0.00020747700015005287,285200000,5710,3620,9330
4711,XENE,-0.18779886364318155,-0.0521049265009082,630958144,4679,4654,9333
4712,MDNA,-0.22835753446731794,-0.04347580772281735,210523504,4775,4559,9334
4713,PNTM,-13.1103105163836,-0.00027244770544491374,840937472,5712,3626,9338
4714,HCAT,-0.2755468068037645,-0.034679376164098,2083205504,4875,4466,9341
4715,GMBT,-10.243642025654333,-0.00032904212131652213,419606240,5709,3632,9341
4716,MEDS,-0.19894935055880902,-0.05031806799127178,40466000,4710,4632,9342
4717,CYTK,-0.18691255939069326,-0.053877258810226515,1659721472,4678,4667,9345
4718,ASPN,-0.2583206582272417,-0.03903909604472654,553007424,4839,4507,9346
4719,TDOC,-0.5096628572612499,-0.014845341828417433,27180599296,5198,4148,9346
4720,METC,-0.09569946368603077,-0.08740124570189851,182061264,4396,4952,9348
4721,AGX,-0.1649874830381403,-0.06155059788495304,851022016,4608,4743,9351
4722,MSGE,-0.06827491829697586,-0.11178783059706929,2132256640,4273,5082,9355
4723,ASAN,-0.3092912270564422,-0.030920422196719373,5393760256,4947,4408,9355
4724,UAMY,-0.3757450537346005,-0.023607636312865107,135696000,5044,4311,9355
4725,KBNT,-0.18929002288564584,-0.05455713787728406,103773784,4685,4671,9356
4726,UIHC,-0.2054422515121175,-0.050257085846484,318412192,4726,4630,9356
4727,SCVX,-33.61965134706814,-0.00044254778700951464,287212480,5720,3644,9364
4728,RGS,-0.08747413430020692,-0.0953902756025378,500387712,4361,5004,9365
4729,RPTX,-0.1569095448346009,-0.06543701980275429,1145006080,4586,4780,9366
4730,ALVR,-0.19889436499900984,-0.05243763457821205,1470249088,4709,4657,9366
4731,DS,-0.12243050416364303,-0.07702636708376204,336864896,4485,4882,9367
4732,SU,-0.07971557415287182,-0.10331771495174999,32103217152,4326,5047,9373
4733,HALL,-0.21653136327925793,-0.04970919613990088,67670408,4751,4623,9374
4734,SVFC,-36.74878128046799,-0.0005406140409939065,418197568,5721,3654,9375
4735,FRSX,-0.26811488250652743,-0.03969098079171744,360145408,4863,4515,9378
4736,CLNN,-0.3572956252761821,-0.02778223268412355,773245312,5012,4366,9378
4737,CEA,-0.08228556538012805,-0.10339744120191434,11484698624,4335,5049,9384
4738,SVFB,-28.37685060565276,-0.0006867064618120498,306904000,5719,3665,9384
4739,FPRX,-0.24696089392695805,-0.044465464308161874,1766010112,4815,4571,9386
4740,LTRN,-0.29828353644452715,-0.03417504055971965,191448656,4931,4455,9386
4741,MPLN,-0.6286055387508428,-0.011791965303584746,4053678080,5310,4076,9386
4742,IEP,-0.14812132914956955,-0.0697004945051168,13556012032,4560,4827,9387
4743,BLNK,-0.6774734358447256,-0.010546995547499109,1704409088,5348,4043,9391
4744,GLBS,-0.09399146894888183,-0.09487207689598483,47785892,4392,5000,9392
4745,TARS,-0.16206741303238587,-0.06609471990782169,571216384,4605,4787,9392
4746,PS,-0.31097787703613716,-0.03332932388043972,3334610944,4953,4446,9399
4747,ATEC,-0.32758314320034687,-0.03129101599191437,1484333824,4980,4419,9399
4748,RNA,-0.13866418632618357,-0.07637313610185828,886620736,4526,4875,9401
4749,CGEN,-0.24646107376773377,-0.045748954188435866,685072896,4809,4596,9405
4750,CUTR,-0.2858793291448154,-0.03914021326399073,551803392,4896,4509,9405
4751,XTLB,-0.16152666553075481,-0.06696657520219243,17533316,4604,4803,9407
4752,RCUS,-0.19094775315351595,-0.058565000040314556,2173064192,4692,4715,9407
4753,JWN,-0.15902495647127105,-0.0684834967556405,5794891776,4594,4816,9410
4754,RIDE,-0.14193375935205269,-0.07637410641378836,1936501120,4535,4876,9411
4755,CVE,-0.09012477718360071,-0.10104654184787275,15596174336,4376,5036,9412
4756,NCLH,-0.11652757819245643,-0.08482988279032863,11532098560,4470,4943,9413
4757,CCL,-0.11457799319569371,-0.08963740522185222,33546332160,4457,4965,9422
4758,RARE,-0.23673953530733413,-0.05060160295974784,7047741952,4787,4637,9424
4759,TLRY,-0.3140306389144848,-0.03498667277095707,3393938176,4957,4467,9424
4760,VERY,-0.0372404198293676,-0.15845507652620508,149642512,4146,5283,9429
4761,MDWT,-0.015371337586546227,-0.22064292878941705,180711024,3999,5432,9431
4762,GSIT,-0.127895603215879,-0.08354528475462028,171583584,4498,4935,9433
4763,CJJD,-0.16139592622713483,-0.07014803578568121,45509464,4603,4830,9433
4764,DRNA,-0.21363708417310173,-0.05612196551980816,1965263104,4742,4691,9433
4765,PLAY,-0.13926430872049955,-0.08042336433356738,2122228480,4528,4910,9438
4766,ORIC,-0.17015120950361212,-0.06775043266470093,797749312,4627,4811,9438
4767,BEAM,-0.380030915440545,-0.02934610957962164,4583772672,5051,4389,9440
4768,ATOM,-0.3931799615252853,-0.02856369810355117,558835328,5063,4378,9441
4769,LIND,-0.18286719073231278,-0.06493036780330484,921791680,4666,4777,9443
4770,PLAN,-0.5194394152299627,-0.018921792356630353,8042889216,5209,4234,9443
4771,DTEA,-0.09917077543702375,-0.10059527852820718,90234296,4409,5035,9444
4772,CETX,-0.09259852323732208,-0.10542721427587524,30545940,4386,5059,9445
4773,DVAX,-0.24680147972686464,-0.05040056941684848,1114439040,4812,4633,9445
4774,CRDF,-0.14607115185503597,-0.07946772258852804,361257984,4548,4900,9448
4775,ACHL,-0.16683237617542454,-0.07132248840712976,634106304,4615,4834,9449
4776,ORMP,-0.2932139561563209,-0.04132159020859175,299284384,4913,4537,9450
4777,PROF,-0.19810746093093598,-0.06166172352973973,385015008,4706,4746,9452
4778,CVAC,-1.079954282419325,-0.006255384617997833,16704414720,5515,3938,9453
4779,ABGI,-1673.3932584269662,-0.0015511874275077892,191779392,5725,3728,9453
4780,MRTX,-0.2629561971044868,-0.047702482670578895,8557146112,4850,4605,9455
4781,IMNM,-0.29553836141441897,-0.041186994882372284,334285056,4921,4535,9456
4782,AEZS,-0.25332421223652146,-0.05047194032708884,136648960,4827,4634,9461
4783,KRUS,-0.1758707762293028,-0.06795220764240396,263875680,4650,4813,9463
4784,LIQT,-0.26148738304094954,-0.048967118605662316,172060384,4846,4617,9463
4785,IDEX,-0.2842506389193136,-0.04457599334453975,1270524416,4890,4573,9463
4786,ESTC,-0.6539727957976554,-0.013980471328716725,10928864256,5336,4127,9463
4787,DOGZ,-0.12024542340501204,-0.09327739664316949,54919656,4478,4989,9467
4788,HMG,-0.06240307935618928,-0.14144175244274107,12034623,4254,5214,9468
4789,ALLO,-0.22782615753381755,-0.05693846378750744,4624506368,4773,4697,9470
4790,ZUO,-0.3331446095777306,-0.03688779986542311,1818630016,4985,4485,9470
4791,AMPG,-0.6520488068796628,-0.01417335771892912,62771004,5333,4138,9471
4792,USAS,-0.1332357309931536,-0.08855966325368912,299630240,4514,4958,9472
4793,LOOP,-0.31514525429610124,-0.03955210954927558,352033728,4960,4513,9473
4794,HMHC,-0.19461330183295064,-0.06484919787896563,913529728,4700,4775,9475
4795,CPHI,-0.2704833495923121,-0.04830557836236956,42024392,4866,4612,9478
4796,SOLO,-0.1940439527858508,-0.06595716130199762,537442112,4697,4784,9481
4797,XGN,-0.2337826453243471,-0.057310064083245495,283490400,4781,4701,9482
4798,DTSS,-0.45325867264332864,-0.026309902892090512,72784656,5139,4346,9485
4799,MVIS,-1.3006288144997227,-0.006138459906435923,2296974336,5554,3931,9485
4800,ATEX,-0.2523053696752081,-0.05336025217898987,823922816,4825,4662,9487
4801,ISR,-0.4975665616948182,-0.02249794502372122,155320000,5189,4298,9487
4802,VXRT,-0.24724609032504902,-0.054844388052898936,680689024,4816,4674,9490
4803,EDIT,-0.2621336951830698,-0.05107608353403613,2721457152,4848,4642,9490
4804,MSC,-0.10813243765603611,-0.10426793081740954,1476955648,4440,5055,9495
4805,RAMP,-0.2216659846200582,-0.06082173981318316,3459732992,4759,4736,9495
4806,CUK,-0.11457799319569371,-0.10194012840486547,26926194688,4457,5040,9497
4807,AR,-0.07925632480598722,-0.13264007129992744,3093221632,4323,5175,9498
4808,DRTT,-0.15120913789946622,-0.08280443185115045,268737792,4571,4927,9498
4809,MSON,-0.2902064523110981,-0.04543389910450154,340701792,4907,4591,9498
4810,ASUR,-0.46924507251766456,-0.02615758703610583,148712944,5158,4343,9501
4811,FI,-0.11356400529764182,-0.10345341763920061,819763200,4452,5051,9503
4812,PTGX,-0.22698758386782394,-0.06108291398303977,1133320704,4769,4738,9507
4813,REFR,-0.43149043129807285,-0.029759759522935646,91153152,5114,4393,9507
4814,PRTC,-0.16532395920839277,-0.0796776648627212,1692493440,4610,4902,9512
4815,RES,-0.14980038008809793,-0.08665694087674997,1178328064,4565,4951,9516
4816,AUVI,-0.31789281529220803,-0.0431306650225879,85554216,4967,4552,9519
4817,AMSC,-0.29698253723677454,-0.045575346213021936,491228288,4928,4592,9520
4818,WWR,-0.16950680419519806,-0.0788383436936388,170088944,4625,4897,9522
4819,RCKT,-0.2546549814938414,-0.056840556443937575,2592217344,4830,4695,9525
4820,FEIM,-0.14061876375996188,-0.09431485722378234,106623600,4532,4994,9526
4821,CNTB,-0.16436031456336656,-0.08164022390024105,1007473600,4607,4920,9527
4822,CVV,-0.11435558027112708,-0.1096998638046161,29399832,4455,5075,9530
4823,ALNY,-0.29358588215782105,-0.04890239830879566,16660673536,4915,4615,9530
4824,WMG,-2.764705882352941,-0.0039098733191195055,18732699648,5666,3867,9533
4825,OCUL,-0.26720776874051333,-0.05517151654908471,1299270400,4861,4676,9537
4826,FUV,-0.34599469314955705,-0.04204424083783726,448764160,4997,4543,9540
4827,DMTK,-0.5328101934581617,-0.024695333663551287,1407303936,5219,4322,9541
4828,IFMK,-0.1572927692951916,-0.08850273808046076,50782760,4588,4956,9544
4829,AYRO,-0.25120782985598655,-0.059202013348619256,205643920,4822,4722,9544
4830,YEXT,-0.2907308954740881,-0.050596088126641334,1834662912,4908,4636,9544
4831,FTCH,-0.4250388494693016,-0.03278666498454799,17845133312,5107,4438,9545
4832,GBIO,-0.2866877551381059,-0.052018387038295935,1611002240,4897,4653,9550
4833,SILV,-0.3040603124526353,-0.04876369831839325,1203383808,4936,4614,9550
4834,IMAX,-0.15620364973836612,-0.09091619798096429,1289799680,4583,4972,9555
4835,CPA,-0.16064483637738716,-0.08846537492275798,3404848384,4600,4955,9555
4836,FUSN,-0.12694975888414056,-0.10580835339475705,437185568,4495,5061,9556
4837,MCRB,-0.2972093415394992,-0.05001162893798762,1807185152,4929,4627,9556
4838,BILI,-0.24850745424335235,-0.061188935911832464,40277843968,4818,4740,9558
4839,REKR,-0.8204417976594419,-0.014002933108640939,859336448,5428,4131,9559
4840,FDMT,-0.20864032519965978,-0.06962262531851393,1073855360,4735,4826,9561
4841,RDVT,-0.46919431279620855,-0.030814427622661,227897872,5157,4405,9562
4842,AIKI,-0.22101424809237627,-0.0675906129297683,98685768,4756,4808,9564
4843,RBLX,-1.7448631708692288,-0.006971824453838505,37838618624,5609,3956,9565
4844,MTC,-0.4101355050465978,-0.036648782150196534,63302360,5085,4481,9566
4845,RNWK,-0.2647150048910839,-0.05873092750845058,187235392,4851,4717,9568
4846,NIO,-0.12882140912850523,-0.10827092666153296,61067644928,4501,5069,9570
4847,VLRS,-0.06087273038711888,-0.17002528144723209,1710042752,4249,5322,9571
4848,SGMO,-0.18642050809776314,-0.07959874838169119,1615345280,4673,4901,9574
4849,EGHT,-0.3718837885224104,-0.04150303410163421,3529840384,5039,4538,9577
4850,YJ,-0.07371338155788913,-0.1571492951455838,458602592,4304,5278,9582
4851,TLND,-0.4861948979801931,-0.03105123094211744,2081688448,5173,4414,9587
4852,TSHA,-0.17081095681464298,-0.0887932678968673,728417472,4630,4959,9589
4853,CLDX,-0.2596181039268469,-0.06175866553362547,832302784,4843,4750,9593
4854,BDSX,-0.36462558116529825,-0.044331611357455745,512951520,5025,4569,9594
4855,NVAX,-0.480466007429474,-0.03176197647632344,12686742528,5169,4427,9596
4856,CREG,-0.07977380639235587,-0.15411564424203095,23472280,4327,5270,9597
4857,RDIB,-0.11591155483072475,-0.12315475561536746,168383248,4465,5133,9598
4858,EXN,-0.15750485421051774,-0.09608374098666227,89569448,4590,5009,9599
4859,EOSE,-0.3155255124291321,-0.050666644865748345,878550016,4961,4638,9599
4860,IKT,-0.2801454394807102,-0.05880143823489619,56887528,4881,4719,9600
4861,DKNG,-0.4585980093032561,-0.0344356526393753,24693504000,5143,4463,9606
4862,RDI,-0.11591155483072475,-0.124253764865993,163937280,4465,5142,9607
4863,VIR,-0.34781387364423755,-0.04798867651546582,5910659072,5001,4607,9608
4864,AMWL,-0.23108350589416315,-0.07104339254734968,4021931008,4778,4833,9611
4865,NBEV,-0.28708437900261374,-0.05831657525911733,377730240,4898,4713,9611
4866,SREV,-0.15630504610921148,-0.09925297545747956,136222368,4584,5028,9612
4867,MTBC,-0.2704622739975085,-0.061681914147129785,122092664,4864,4748,9612
4868,AFMD,-0.42376137381394324,-0.03907219526792211,895330816,5104,4508,9612
4869,MLSS,-0.4528366794697988,-0.03589590406573941,218977456,5137,4475,9612
4870,LEAF,-0.29576319022479,-0.056579627223244285,327569984,4924,4693,9617
4871,SAVE,-0.11453614334989938,-0.12853042158644898,3670647552,4456,5162,9618
4872,CPIX,-0.1522593687029019,-0.10240532017686467,46403376,4574,5044,9618
4873,AMTI,-0.5031806279759434,-0.03168552522299526,2102675072,5193,4425,9618
4874,IBRX,-1.2178834420366085,-0.01183179272978586,7180774400,5541,4077,9618
4875,OM,-0.31995413156396657,-0.05201318473460127,2487014144,4970,4652,9622
4876,TRIL,-0.2337376342122979,-0.07262012042657613,1072435072,4780,4848,9628
4877,SPCE,-0.399559341566892,-0.04316386340848516,6928242688,5074,4554,9628
4878,BP,-0.12551516779751118,-0.1233897349406894,85963456512,4493,5137,9630
4879,GVP,-0.22242927325088938,-0.0754284543015015,30519672,4762,4868,9630
4880,PRAX,-0.21557311180454816,-0.07704184766759933,1085230080,4748,4883,9631
4881,APLS,-0.2568075151218035,-0.06660762244758915,3287353856,4836,4795,9631
4882,ADES,-0.13315845111781058,-0.11881051703290768,101112648,4513,5119,9632
4883,SDC,-0.3062573826871413,-0.05676547474747627,3877159168,4939,4694,9633
4884,FNHC,-0.1716714407946133,-0.09536748341919735,81957208,4633,5003,9636
4885,DUO,-0.15818525773866887,-0.10258740672180358,488662400,4591,5046,9637
4886,TWOU,-0.296916931092055,-0.05827872205126673,2904272384,4927,4711,9638
4887,TRIP,-0.4426229508196721,-0.03988662378945037,7131105280,5124,4517,9641
4888,TESS,-0.18826588935286506,-0.08949838126448094,66122244,4682,4963,9645
4889,VERX,-0.49280599265052294,-0.03453536964232618,3039948800,5182,4464,9646
4890,MNKD,-0.7101108787210269,-0.021760027206662542,1014141120,5368,4278,9646
4891,STRO,-0.19514476810218537,-0.08612213947807201,977964864,4701,4948,9649
4892,PCSA,-0.4249786631213369,-0.042151835678657094,166856880,5106,4544,9650
4893,BRN,-0.22725189090075637,-0.07723098826610862,23838222,4771,4884,9655
4894,ALT,-0.1749378946617193,-0.09592196663917552,505616928,4648,5008,9656
4895,ASND,-0.3588733837563716,-0.050945329151198156,7021414912,5015,4641,9656
4896,POWW,-0.753127847643423,-0.02054889956334458,665512832,5395,4262,9657
4897,AKUS,-0.1465405822570597,-0.11669119913199123,463394944,4551,5107,9658
4898,ANNX,-0.18379550798670236,-0.09360340336069563,936005952,4667,4991,9658
4899,BNGO,-0.8645088362716952,-0.01808334499447841,2062098944,5443,4217,9660
4900,PAYS,-0.5839424440044485,-0.030005194037105554,220959552,5266,4396,9662
4901,KMPH,-1.30166076776477,-0.013065769404763665,294545984,5555,4107,9662
4902,KC,-0.14292088498837632,-0.12009906070165,9980995584,4540,5123,9663
4903,FUN,-0.22149669418342935,-0.08008270539488443,2825850880,4758,4905,9663
4904,HCM,-0.3729335512767515,-0.04980064558580263,3998898432,5041,4625,9666
4905,OXY,-0.13426440503229756,-0.12613009538952025,23616563200,4516,5151,9667
4906,SNDX,-0.2535058795134538,-0.07155995831798496,1076623104,4828,4839,9667
4907,IVA,-0.26293773927060243,-0.0689461140132368,555952128,4849,4818,9667
4908,FREQ,-0.11571351769093781,-0.13991375502841402,375614016,4464,5205,9669
4909,BDTX,-0.22054068447814565,-0.08124383045539044,876698176,4753,4917,9670
4910,MDVL,-0.3384397716739035,-0.05543156930019581,425758880,4989,4683,9672
4911,AAOI,-0.13279355308805776,-0.12933915904177695,226146320,4510,5165,9675
4912,WNW,-82.87923479244216,-0.006826181165168342,255000000,5724,3952,9676
4913,XXII,-0.5174598782512452,-0.0358655728029434,515105248,5204,4474,9678
4914,NSEC,-0.0940890853325179,-0.15910128612879337,27909980,4393,5286,9679
4915,AUPH,-0.24693842758777454,-0.07549298693966838,1621805824,4814,4869,9683
4916,VKTX,-0.17457738784562943,-0.10130156097959801,438126624,4646,5038,9684
4917,CGC,-0.23615764032140532,-0.07925399463473327,11502798848,4786,4898,9684
4918,BGNE,-0.366707377961791,-0.05218246506539782,31890145280,5030,4656,9686
4919,RETO,-0.17736348981838201,-0.09975607060301031,35237100,4656,5031,9687
4920,SOLY,-0.4666148313733113,-0.04125749758986091,377837184,5152,4536,9688
4921,DYN,-0.17129863567458312,-0.10546543093965978,845962944,4632,5060,9692
4922,NGM,-0.36246945472317255,-0.054051190361161836,2025446272,5022,4670,9692
4923,SIX,-0.41552199360983694,-0.04683736315042839,4098055680,5092,4601,9693
4924,TRX,-0.28499508424259046,-0.06697487642946406,146104112,4892,4804,9696
4925,DT,-2.11300476161029,-0.011487038306133578,14087309312,5633,4063,9696
4926,INO,-0.25615278801335845,-0.07458839405216504,1853923328,4833,4864,9697
4927,SVMK,-0.6393545403960846,-0.028604039962923336,2633968640,5320,4380,9700
4928,GEOS,-0.09929744675916036,-0.1599187532518517,124066656,4411,5291,9702
4929,SCX,-0.10069361913610925,-0.1625677574970947,45277912,4413,5297,9710
4930,MNOV,-0.24102579315024994,-0.08067251762568721,233594400,4797,4913,9710
4931,RVPH,-0.327698974431105,-0.06041261102842785,47728096,4981,4729,9710
4932,SCOR,-0.7268111184066536,-0.0258223796511636,284264128,5377,4333,9710
4933,SPNE,-0.24692121490538368,-0.0794637907358969,568625792,4813,4899,9712
4934,PZG,-0.11465041824293205,-0.15120194171393558,39124660,4459,5255,9714
4935,RIGL,-0.41665588104174756,-0.04970326261870679,552636480,5095,4622,9717
4936,RGNX,-0.1902501448021994,-0.10000923923554744,1449198848,4690,5032,9722
4937,ARCT,-0.16752901495543818,-0.11656899474395807,1013105536,4619,5106,9725
4938,RNGR,-0.14802065404475043,-0.13134450466199682,86253328,4558,5171,9729
4939,SSKN,-0.31863664790494056,-0.06298128300104887,55433640,4968,4763,9731
4940,BTN,-0.174043235008274,-0.11316081063171946,46851840,4644,5089,9733
4941,IH,-0.06989876307918746,-0.2369890045546929,650025664,4281,5457,9738
4942,IOVA,-0.36707292634493816,-0.05762732749176123,4557818880,5033,4706,9739
4943,WRAP,-0.2899804017926331,-0.07147687777023662,197257696,4904,4838,9742
4944,IRIX,-0.3522769839995719,-0.06075815246484463,110044600,5008,4735,9743
4945,DK,-0.17722137404580152,-0.11335437394671444,1689525888,4655,5091,9746
4946,CNTG,-0.256802517827975,-0.0804971458437781,250749120,4835,4911,9746
4947,CNK,-0.174931383144088,-0.11566617568399172,2755396864,4647,5101,9748
4948,PARR,-0.2084955950236941,-0.09740146379738907,911329344,4734,5015,9749
4949,TACT,-0.2526742101032585,-0.08177553916224867,101433312,4826,4923,9749
4950,NR,-0.13336901378413737,-0.14494669971169427,300148768,4515,5235,9750
4951,SRRK,-0.2512805828640514,-0.08288488601134841,1141290624,4823,4928,9751
4952,TDW,-0.1108778159069627,-0.1657545609359554,515459488,4445,5308,9753
4953,GRPN,-0.4736938210520115,-0.045406642806362994,1453193472,5164,4589,9753
4954,IPA,-1.2643213234992183,-0.017396575328670744,229566224,5551,4205,9756
4955,VAPO,-0.2821146407838641,-0.07614687899529232,589420480,4885,4873,9758
4956,LUB,-0.16636019634363175,-0.12570605301688095,104830224,4611,5148,9759
4957,FMTX,-0.19121291417605282,-0.10857655219158345,1394412672,4693,5070,9763
4958,RCON,-0.17195583493919364,-0.1226308435658846,122310800,4634,5132,9766
4959,USEG,-0.20129998030332874,-0.10501929549727201,20108090,4715,5057,9772
4960,VBIV,-0.34180726762638414,-0.06546088763216684,726454272,4993,4781,9774
4961,UUU,-0.2887098369216124,-0.07658566407146772,16930356,4899,4877,9776
4962,OCC,-0.18676421724049053,-0.11587834317875981,28415482,4675,5103,9778
4963,STIM,-0.32158369266954134,-0.06786419848745,302861472,4972,4812,9784
4964,TGTX,-0.509211988334025,-0.04539424827474613,6485232128,5197,4588,9785
4965,CETXP,-0.09259852323732208,-0.20372338303130522,12086200,4386,5401,9787
4966,SRPT,-0.22076276758625224,-0.10053429033911651,5704781824,4755,5034,9789
4967,NEPH,-0.3692105910320518,-0.06243678691200738,78207960,5035,4756,9791
4968,UEPS,-0.10601967594534584,-0.18681027234958836,349311872,4434,5358,9792
4969,MACK,-0.3131325752842684,-0.07145358140404862,83411440,4956,4837,9793
4970,AEYE,-1.05828125,-0.021926265229997424,307895936,5509,4287,9796
4971,APYX,-0.3098272138228942,-0.0725579948035426,309547488,4950,4847,9797
4972,ABNB,-0.7443219561418717,-0.030992231491749008,109481795584,5388,4411,9799
4973,LUV,-0.19525893790912965,-0.1155639546442345,37519867904,4702,5100,9802
4974,ONE,-0.369721299927519,-0.06462360134966956,390624672,5036,4770,9806
4975,HUSA,-0.251670949329147,-0.09171070928169792,19152046,4824,4984,9808
4976,TUSK,-0.1200252880270918,-0.177189446055585,264546560,4477,5334,9811
4977,CATO,-0.1600588985099556,-0.14135860711158768,299269024,4599,5213,9812
4978,MRAM,-0.3392696931634667,-0.06918486525316703,109929816,4990,4822,9812
4979,SNDL,-0.38819340760307797,-0.062438461477491436,1660230016,5057,4757,9814
4980,CTMX,-0.19014329696467064,-0.12108071406557076,492361440,4688,5127,9815
4981,VRS,-0.1009433962264151,-0.20278612827048162,491649504,4416,5400,9816
4982,ROOT,-0.19681291390728478,-0.11837802694565046,3040475648,4704,5115,9819
4983,AVXL,-0.9807845841375983,-0.026020322804612205,1048571968,5482,4338,9820
4984,OGI,-0.24647639966953105,-0.09615501007475688,928133056,4811,5010,9821
4985,AMBO,-0.20054735580850716,-0.11720149999777596,51305812,4712,5110,9822
4986,LEGN,-0.4059800211135608,-0.061209464412102885,3988819968,5083,4741,9824
4987,JNCE,-0.20059845628512485,-0.11740356004170602,512458880,4713,5112,9825
4988,NNVC,-0.20714129333309345,-0.11506499985320491,50075304,4729,5096,9825
4989,BHTG,-0.27545465731390406,-0.08795270277763348,38067184,4874,4953,9827
4990,AXSM,-0.546341003782719,-0.04637427997066828,2028863488,5233,4598,9831
4991,NEON,-0.3972409367982034,-0.06334180864671858,104002552,5070,4764,9834
4992,IGC,-0.2562532666318226,-0.094984560580721,77576376,4834,5001,9835
4993,NXTC,-0.1391237146453653,-0.1661079315628714,268823008,4527,5309,9836
4994,SMTI,-1.4388493464664032,-0.02039059979171477,243824000,5576,4260,9836
4995,XM,-4.192192636423406,-0.014888037391762993,16367749120,5686,4150,9836
4996,MDWD,-0.3830934450336438,-0.06623358821515789,138908192,5052,4790,9842
4997,AEHL,-0.08708907886974016,-0.2552275139684603,11938920,4360,5484,9844
4998,ACET,-0.2815392861360684,-0.0892032348982789,409271136,4883,4962,9845
4999,RETA,-0.3065089735047319,-0.08028398289160864,3518003456,4941,4909,9850
5000,ACAD,-0.34607225912268835,-0.07356996763414857,3397797888,4999,4854,9853
5001,SLN,-0.5929306847322693,-0.0447068880034954,694899200,5280,4576,9856
5002,DMRC,-0.4028008455382757,-0.06571733282182217,495933760,5077,4783,9860
5003,LGVN,-0.9780842861491881,-0.02898862348229826,127011224,5480,4383,9863
5004,FTEK,-0.30738304093567254,-0.08167256081643816,85930728,4942,4922,9864
5005,APEN,-0.2900003672285263,-0.08910003213332804,145249440,4905,4960,9865
5006,SCR,-0.9667592268082926,-0.029906910146878525,1190708992,5474,4394,9868
5007,RRGB,-0.1771480097555624,-0.14153376411810334,588167680,4653,5216,9869
5008,ICD,-0.10070193486310607,-0.2365021869841389,23175696,4414,5456,9870
5009,JMIA,-0.6397688346988034,-0.04308437436370083,3645954304,5321,4549,9870
5010,CPLG,-0.19021134593993325,-0.13408521252948433,542308416,4689,5184,9873
5011,ALK,-0.22212125146046996,-0.11826568403863037,9172425728,4761,5114,9875
5012,MMYT,-0.7119828534363631,-0.038646748413812604,3215589376,5372,4503,9875
5013,SPRB,-0.19211076280041797,-0.13319997155599192,366305888,4696,5181,9877
5014,OPT,-0.39069976932004463,-0.06895599337713883,423207712,5061,4819,9880
5015,EQS,-0.14323356129910886,-0.18038085639372212,25414028,4543,5340,9883
5016,TCRR,-0.2894398685513261,-0.09147337450535273,836353216,4901,4983,9884
5017,NLTX,-0.20542507279405586,-0.12821686594658532,508758528,4725,5160,9885
5018,ULCC,-0.24028548770816813,-0.11437620092746098,4426305024,4794,5093,9887
5019,CDXC,-0.9545192307692307,-0.031126682040181018,637866048,5471,4416,9887
5020,MSN,-0.13857767659217543,-0.19129708271535334,29249282,4525,5365,9890
5021,JUPW,-2.1789224248494548,-0.019868966946307624,45085240,5638,4252,9890
5022,AKTS,-0.4947266017078707,-0.0576737679052045,570462848,5184,4707,9891
5023,HA,-0.15849082866044456,-0.16315664133231542,1345620992,4592,5300,9892
5024,BIMI,-0.3617077457438903,-0.07598251080089907,34022236,5020,4872,9892
5025,VLDR,-0.4321414598512187,-0.06541093355840723,2543973632,5115,4779,9894
5026,MCS,-0.17087061629402045,-0.15258842681902768,663586368,4631,5264,9895
5027,PFIN,-0.15036326649229875,-0.17475729204692872,21282776,4566,5330,9896
5028,AQMS,-0.4987202332739349,-0.057915770896723506,268558528,5190,4708,9898
5029,SANW,-0.2898021611259457,-0.09449668099561796,132599752,4903,4997,9900
5030,NC,-0.10372318524313419,-0.24799502183803332,174647456,4426,5475,9901
5031,DYNT,-0.2946437117904087,-0.09184298390039027,17819656,4916,4985,9901
5032,PTCT,-0.30316974858728146,-0.09009171357681817,3435947776,4934,4968,9902
5033,MBII,-0.5960965125147334,-0.04915042230202913,322678400,5284,4618,9902
5034,LYL,-0.2675439222242269,-0.10222241110936857,18154188,4862,5042,9904
5035,SMIT,-0.18783363203970496,-0.14242474787794232,24144288,4680,5225,9905
5036,CLVR,-0.23772879825019702,-0.118735316643905,261199536,4788,5117,9905
5037,THTX,-0.6809373933487544,-0.043104646011118096,335005824,5355,4550,9905
5038,ZNTL,-0.39645487829706,-0.07159400991982089,1685525120,5068,4840,9908
5039,CLLS,-0.22278416828062803,-0.1256904458710232,843064192,4763,5146,9909
5040,ACRS,-0.9945067333510976,-0.031569981237727016,1533407360,5487,4422,9909
5041,HARP,-0.41505085951776444,-0.06938632249716989,713037568,5091,4824,9915
5042,AWH,-1.3616811813706928,-0.026754042075845842,679239360,5565,4353,9918
5043,ENLV,-0.744300518134715,-0.04107654460389458,207795776,5387,4534,9921
5044,BEST,-0.24280368616443784,-0.1193023293120818,667273792,4802,5121,9923
5045,MGTX,-0.2034744376898737,-0.13992365007347363,602434368,4721,5206,9927
5046,ETNB,-0.24317479712851237,-0.12020663529131005,500654656,4803,5124,9927
5047,HTBX,-0.20800461397186715,-0.13867196337470994,187018336,4730,5198,9928
5048,PGEN,-0.5649471843668346,-0.05536050107847862,1396438144,5248,4680,9928
5049,TUFN,-0.30977208809671647,-0.09133091528733878,379065440,4949,4980,9929
5050,IMVT,-0.6779916869531939,-0.044772729055830095,1509736192,5350,4579,9929
5051,DYAI,-0.3502468365156688,-0.0818068235929228,140801968,5006,4925,9931
5052,ALPN,-0.27932532087094236,-0.10396975616750517,262703104,4879,5053,9932
5053,MGNX,-0.39948791416466,-0.07445301721255593,1890762752,5073,4861,9934
5054,ALDX,-0.4886563601597192,-0.06252079209308578,583497984,5176,4758,9934
5055,PCVX,-0.2589308167011114,-0.11452894324017118,1121508096,4841,5094,9935
5056,ELDN,-0.11685786676989127,-0.23919479860168913,167244144,4472,5464,9936
5057,KALV,-0.4779327665695858,-0.06481104302271298,633471680,5167,4773,9940
5058,ANVS,-0.8805545027857218,-0.03835548498740613,180619392,5448,4500,9948
5059,AFI,-0.15720771850170262,-0.19101882184997135,110923776,4587,5363,9950
5060,MAXN,-0.2835519523234893,-0.10645867980906594,823028672,4888,5065,9953
5061,TFFP,-0.5006360237261033,-0.06293620790895221,331004128,5191,4762,9953
5062,OIS,-0.16335447597790617,-0.18309684368066556,375681952,4606,5348,9954
5063,YY,-0.09256321208525989,-0.3531702088842371,8113394688,4385,5570,9955
5064,PPSI,-0.27201727093783734,-0.11260142407683392,39441700,4868,5087,9955
5065,INSM,-0.3927175380824903,-0.07832216432984636,3444054272,5062,4894,9956
5066,TAOP,-0.7922319076367678,-0.04196297473623662,74937320,5414,4542,9956
5067,NKTR,-0.28215794136891037,-0.10875565679872481,3576529920,4886,5072,9958
5068,CLGN,-0.7595984262650929,-0.04381868122407936,127721552,5398,4564,9962
5069,REAL,-0.364706938178698,-0.08393910861108048,2038360704,5027,4936,9963
5070,WPP,-0.5767783641827227,-0.0574592885336345,15979623424,5260,4703,9963
5071,PTEN,-0.15089140842531198,-0.20008706312246025,1308520704,4570,5394,9964
5072,ONCR,-0.2107624844706403,-0.14244312772274442,385147904,4738,5226,9964
5073,ITCI,-0.3398105366155953,-0.09108328797353826,2561832192,4991,4975,9966
5074,AHPI,-0.2849347554300998,-0.10981151177657826,20228242,4891,5076,9967
5075,AKRO,-0.30801451035246014,-0.09884431006750496,985042624,4944,5023,9967
5076,MYT,-0.34547200296135777,-0.09091502285836106,30604420,4996,4971,9967
5077,TELL,-0.41385943592372243,-0.0766480290506206,858223168,5089,4879,9968
5078,CLSK,-5.003864805814656,-0.021533433312086455,700449920,5695,4275,9970
5079,MYGN,-0.4591503267973856,-0.07007352962593123,2152344064,5144,4829,9973
5080,DAL,-0.22825952115122194,-0.13900224824411997,32034979840,4774,5201,9975
5081,AMRS,-2.244566897630349,-0.025870004204379786,4452330496,5644,4334,9978
5082,AHC,-0.11229777346264196,-0.30274127014638164,44533632,4449,5530,9979
5083,MWK,-5.435344827586207,-0.02177651060841236,899912320,5700,4280,9980
5084,ATOS,-0.5505252085123755,-0.061609166307159464,260979856,5237,4744,9981
5085,BTX,-1.0170612765901872,-0.03729712717641052,238706656,5493,4488,9981
5086,PBYI,-0.5445947156291984,-0.06206940245258295,376819552,5230,4752,9982
5087,VVOS,-0.5980367874041269,-0.0570152833262128,162710304,5287,4699,9986
5088,PPTA,-0.31687753561850374,-0.0988857557086371,309700576,4964,5024,9988
5089,LVTX,-1.1802084294014572,-0.03406434090384938,379777440,5535,4454,9989
5090,BCYC,-0.3764589959644407,-0.08585471241248965,703564480,5045,4947,9992
5091,MTBCP,-0.2704622739975085,-0.12243959793841774,57467860,4864,5131,9995
5092,CVM,-0.8060916495960594,-0.044662550922434326,660222336,5421,4575,9996
5093,AMPE,-0.7524234936323893,-0.04731313957300875,350175904,5394,4603,9997
5094,IMCR,-0.6162550282708374,-0.05687008426073753,1578926848,5302,4696,9998
5095,ADVM,-0.2554711325200998,-0.13130832700299916,939820480,4832,5170,10002
5096,TRHC,-0.9430625020701534,-0.04175739842044985,1065543488,5466,4540,10006
5097,VMAR,-1.2499031767308755,-0.03423852921055526,62000260,5549,4457,10006
5098,NVOS,-0.7585700041074945,-0.04843595390875668,85906360,5397,4613,10010
5099,RCMT,-0.34208821115382954,-0.09760970485260873,41232228,4994,5017,10011
5100,AGIO,-0.4167763045146185,-0.0809401611200686,3677732608,5096,4915,10011
5101,AUMN,-0.4837830989484353,-0.07195293590213511,113322824,5172,4842,10014
5102,CLIR,-0.7933165484092469,-0.04666284209073443,156048032,5416,4599,10015
5103,AZYO,-0.37461218755487913,-0.0909794141855495,135240176,5043,4973,10016
5104,GOEV,-0.2752445555552493,-0.12518350674310105,2263012864,4873,5144,10017
5105,JBLU,-0.1907172189857702,-0.17431596425439302,6665208320,4691,5329,10020
5106,CMRX,-0.5842761517259483,-0.06258954539867352,749692992,5267,4760,10027
5107,CERS,-0.5822014751518668,-0.06352167788664925,987809216,5265,4766,10031
5108,AMC,-0.26716619160593286,-0.13142475608505638,4944237056,4860,5172,10032
5109,SGTX,-0.295688415565741,-0.11762942874955658,582928064,4922,5113,10035
5110,MRSN,-0.362002662328058,-0.09747711912977987,1124018432,5021,5016,10037
5111,XENT,-0.4922030840748643,-0.07416050599920232,670883072,5179,4858,10037
5112,DMAC,-0.48716768327770743,-0.07462253653959873,175557472,5174,4865,10039
5113,NKLA,-0.3892820603877601,-0.09143137848650644,4817016320,5059,4981,10040
5114,MDXG,-1.7522707527051575,-0.03285208947581496,1339582464,5610,4440,10050
5115,VVI,-0.3365902657291572,-0.10615821245874625,857622848,4987,5064,10051
5116,ASPS,-0.4450904392764858,-0.08179033168822196,139988992,5129,4924,10053
5117,ARCH,-0.17841334956743202,-0.200199394852666,692783360,4659,5395,10054
5118,COCP,-0.28367660984848486,-0.13058675930361865,105059136,4889,5166,10055
5119,GTH,-0.14665352451918656,-0.27829297536909425,2057951104,4552,5506,10058
5120,LYV,-0.5846077858750023,-0.06611385531811638,18900314112,5269,4789,10058
5121,FOLD,-0.43619588335148923,-0.08459650336876519,2526864128,5120,4940,10060
5122,QURE,-0.4057019388144573,-0.09147090578177279,1553192960,5082,4982,10064
5123,CERE,-0.3454591376510915,-0.10862200145537267,1676238080,4995,5071,10066
5124,IMMP,-0.5375529456241841,-0.07244818418891785,222207264,5221,4846,10067
5125,ARPO,-0.14763957757775495,-0.2865009392675489,62926692,4556,5514,10070
5126,AWRE,-0.20339457241443626,-0.18459029080461054,79958424,4720,5350,10070
5127,ONDS,-0.7364947831636036,-0.055863252463252536,218956304,5382,4688,10070
5128,DSS,-0.3668168475663868,-0.10239367388311339,99335656,5031,5043,10074
5129,CPST,-0.34604910429343433,-0.11144019178593223,105971728,4998,5081,10079
5130,VGZ,-0.5197466467958272,-0.07563922464752121,117292872,5210,4870,10080
5131,WTTR,-0.17264627461668527,-0.2266969049125842,505011104,4637,5444,10081
5132,CRTX,-0.4574302777294602,-0.08541890675700592,973446144,5142,4944,10086
5133,BLU,-0.3383455557609745,-0.11549695849828458,328457632,4988,5099,10087
5134,TRVN,-0.26521250281088377,-0.14932577979709966,290293184,4853,5245,10098
5135,CNST,-0.3035379984731562,-0.12916102472374189,1099744640,4935,5164,10099
5136,GBT,-0.3785540412732375,-0.10340884612455702,2627993600,5049,5050,10099
5137,TGA,-0.17260317930489733,-0.2396060653555569,106161272,4636,5465,10101
5138,LCTX,-0.5912326628088546,-0.06997145201717801,392780352,5276,4828,10104
5139,PPBT,-0.20997327096558638,-0.19536673237645655,72484416,4737,5377,10114
5140,NVTA,-0.8880830268179385,-0.05320948660129298,7347031040,5454,4660,10114
5141,PBF,-0.19849706499792744,-0.20730298142491554,1767916160,4708,5408,10116
5142,VERI,-0.6623373003706904,-0.06488840684893475,759026496,5340,4776,10116
5143,BBIO,-0.8503871245250556,-0.05539198230688732,8350473728,5436,4682,10118
5144,NES,-0.14149482904482646,-0.3823027744676108,34565284,4533,5590,10123
5145,XCUR,-0.29334563487487025,-0.14060960665883226,183837024,4914,5209,10123
5146,PLCE,-0.46380793360213585,-0.09125318282991221,1038276928,5147,4976,10123
5147,ARNA,-0.37667561623565415,-0.11115851078420066,3999580672,5046,5079,10125
5148,CELC,-0.8118099500230643,-0.05739673422992028,176945760,5425,4702,10127
5149,VNE,-0.29126925898752754,-0.14170089132244928,2680676096,4910,5219,10129
5150,SABR,-0.39679920862515133,-0.10590595876969168,4858399232,5069,5062,10131
5151,USAT,-1.5135713739582537,-0.042993950692931916,877820736,5585,4548,10133
5152,GSX,-0.27170145540998514,-0.1562717485224361,7388480000,4867,5275,10142
5153,EEX,-0.34930448222565685,-0.12355477001449505,396059328,5004,5138,10142
5154,IMTX,-0.3609875571526954,-0.12052762216136229,725336128,5018,5126,10144
5155,PHCF,-0.6032094639017076,-0.07337964678608833,58113124,5293,4852,10145
5156,GOVX,-0.2962730982240853,-0.14179001286764698,28924852,4925,5221,10146
5157,PMD,-0.30236267570531355,-0.14151566685280356,38312512,4933,5215,10148
5158,MRUS,-0.4177659832184465,-0.1034981936606673,849469568,5098,5052,10150
5159,NCSM,-0.17968911413327499,-0.26146417390831944,57207944,4662,5490,10152
5160,EXPE,-1.5661538461538462,-0.043616691976375216,24750532608,5593,4562,10155
5161,WISH,-0.5924882629107981,-0.07673654345444474,8855940096,5278,4880,10158
5162,IMRN,-0.5130209689061359,-0.08851321283290013,35688572,5202,4957,10159
5163,XPEV,-0.11923135974232446,-0.9393528501407133,24298076160,4476,5687,10163
5164,OSW,-1.007837796943562,-0.054558981879858616,992768896,5491,4672,10163
5165,SFT,-0.29472402597402597,-0.14951556650562048,697092032,4917,5247,10164
5166,INMB,-0.5467161865991609,-0.08306629147623995,167394448,5235,4930,10165
5167,UAL,-0.2302194738709514,-0.19948018096468179,19246358528,4777,5390,10167
5168,INZY,-0.3578706317836753,-0.12641645783642683,469281984,5014,5153,10167
5169,VERO,-0.2780342285797694,-0.1600477938831862,114960368,4878,5292,10170
5170,FGEN,-0.29777368082907346,-0.14637326145898655,1807404160,4930,5240,10170
5171,KZR,-0.2953920220082531,-0.15113320840874628,298972384,4919,5253,10172
5172,DOMO,-4.113165931455717,-0.03723393242852968,1758561920,5685,4487,10172
5173,AIM,-0.24258799712662443,-0.1944459362565942,113816128,4801,5374,10175
5174,APRN,-0.24243634263385694,-0.1951123574021336,114541568,4800,5376,10176
5175,MNPR,-0.41478962102387135,-0.11255138378868929,73390696,5090,5086,10176
5176,CURI,-1.0930704722671767,-0.05260143402372673,695735488,5518,4658,10176
5177,CSCW,-0.783491778618247,-0.06398481187525958,81160280,5409,4768,10177
5178,REDU,-0.3402375883211966,-0.13479421865937455,221566336,4992,5186,10178
5179,MTNB,-0.38876352249814394,-0.11890309849319818,212447040,5058,5120,10178
5180,VTNR,-0.37276273180855773,-0.12391874526000861,74833352,5040,5140,10180
5181,NMTR,-0.639212175802508,-0.07450617805973152,308201120,5318,4863,10181
5182,ACIU,-0.27260348341506396,-0.16887016038133362,509638912,4869,5317,10186
5183,USAU,-0.5877701536099247,-0.080869119354209,72921744,5273,4914,10187
5184,KLR,-3.901508268217336,-0.03903296336847107,459466912,5682,4506,10188
5185,GBNH,-0.5428222968907271,-0.08974275553280195,168784928,5228,4966,10194
5186,LEDS,-0.5058737151248165,-0.09500087210524828,19936260,5195,5002,10197
5187,CMCM,-0.13305952170985122,-0.8870247930439155,316226912,4512,5686,10198
5188,MDGS,-0.49237626084916725,-0.09783814522368997,46578600,5180,5018,10198
5189,DWSN,-0.14644714945103252,-0.5828215594658769,57521348,4550,5652,10202
5190,BTAI,-0.3899391621094313,-0.12461447435389766,852437312,5060,5143,10203
5191,GERN,-0.32075416618012575,-0.14533161805757097,484167136,4971,5236,10207
5192,RAPT,-0.49627425928171076,-0.0980752177316278,555759552,5187,5020,10207
5193,TLMD,-0.9146183357586982,-0.061609329212280885,583897856,5462,4745,10207
5194,ITRG,-0.24646785862741444,-0.20213549186758958,158954400,4810,5398,10208
5195,VJET,-0.44736742064246343,-0.10926171687072957,82311696,5134,5074,10208
5196,AUTO,-0.4435878904681603,-0.11197549998763486,37532220,5126,5083,10209
5197,RDUS,-0.7318333570109391,-0.07084985267336087,943046400,5378,4831,10209
5198,CRMD,-0.6029429804025909,-0.08155967953288701,371496448,5291,4919,10210
5199,PASG,-0.36470120456797206,-0.13528675370740736,940973760,5026,5191,10217
5200,AAL,-0.28123807828276404,-0.18104280985394194,15431476224,4882,5342,10224
5201,SRNE,-0.5815492319634782,-0.0891234610182722,2128926336,5264,4961,10225
5202,MICT,-0.609566879917641,-0.08312609720030462,221505984,5294,4932,10226
5203,GTHX,-0.470364537879859,-0.10880423536331538,1050663424,5159,5073,10232
5204,FHTX,-0.2894681264466859,-0.1761821751713418,443273056,4902,5332,10234
5205,SM,-0.24336807588603981,-0.22043742272572797,2051586816,4804,5431,10235
5206,RUBY,-0.6659145282732023,-0.07876689550571109,2101553024,5341,4896,10237
5207,ARQT,-0.5051203081979344,-0.10243191891143703,1401870720,5194,5045,10239
5208,EBON,-1.5731696212672714,-0.051522719874537694,929627392,5595,4644,10239
5209,DCPH,-0.47374397316749356,-0.11058387119391634,2518251776,5165,5077,10242
5210,SESN,-0.711917898918561,-0.07595305508301947,459036544,5371,4871,10242
5211,ARTW,-0.3093496347631398,-0.16149771886868974,15333360,4948,5295,10243
5212,PUYI,-0.1400044990609518,-3.738860397809605,252718592,4530,5715,10245
5213,IQ,-0.4175900127060551,-0.12600438508335904,13891416064,5097,5150,10247
5214,NURO,-0.30563106741698987,-0.16743115106565476,13362444,4937,5311,10248
5215,CMPI,-0.2947627377215473,-0.17814054481889444,242342272,4918,5335,10253
5216,RLMD,-0.5620110789692854,-0.09690462857606959,602232896,5246,5012,10258
5217,QTNT,-0.40408668539816417,-0.13309728681448146,390373376,5079,5180,10259
5218,TELA,-0.32720140848717083,-0.1591619553468442,197976512,4979,5287,10266
5219,RCEL,-0.5737272983908911,-0.0956751934181672,512012192,5259,5007,10266
5220,SEEL,-1.863785394932936,-0.05187126092241354,362585344,5617,4649,10266
5221,YCBD,-0.6366332732747407,-0.08840371955007023,199731792,5315,4954,10269
5222,XSPA,-0.2591943957968476,-0.21941656322892583,175820928,4842,5428,10270
5223,CASI,-0.39416671596757974,-0.14026772005774923,286583840,5064,5207,10271
5224,GIFI,-0.23870278565571612,-0.2539978872012121,65172236,4790,5482,10272
5225,PYPD,-0.3600383719336714,-0.15130395536367452,175079232,5016,5257,10273
5226,EB,-0.5958884329839845,-0.09410119354953529,2157664256,5283,4993,10276
5227,ATXI,-2.2098346757100464,-0.05048077686594111,105513032,5641,4635,10276
5228,INBX,-0.6003418164338933,-0.09306581556851626,792701696,5289,4988,10277
5229,FLDM,-0.41928672948792733,-0.13303975262009274,343661664,5099,5179,10278
5230,PRTA,-0.3670598807659372,-0.1496512359189728,1022843520,5032,5249,10281
5231,SQZ,-0.2745821412437886,-0.20844513985853197,370110944,4872,5411,10283
5232,LYFT,-0.7462899428301233,-0.07831547655778198,20051634176,5390,4893,10283
5233,AREC,-0.9727141363365394,-0.06773081033484557,185435328,5475,4810,10285
5234,INUV,-1.0044444205942167,-0.0666882912919888,119701160,5490,4798,10288
5235,GENE,-0.5182642126073389,-0.11231520677184836,78451808,5208,5084,10292
5236,SRTS,-0.3608828238842517,-0.15673951091765267,62316324,5017,5277,10294
5237,ALEC,-0.4639532752764998,-0.1258201292636982,1531203840,5148,5149,10297
5238,AMST,-2.369622921768587,-0.051872384539432624,80089624,5648,4650,10298
5239,IPWR,-1.3381703070243107,-0.06132678243118042,65766960,5558,4742,10300
5240,LLIT,-0.8931513330453367,-0.07222282088185096,40292932,5458,4844,10302
5241,PBPB,-0.2652966101694915,-0.2327036158497043,171716224,4854,5451,10305
5242,NCMI,-15.102564102564102,-0.045691955750749524,369767168,5714,4593,10307
5243,ADAP,-0.3251092389463346,-0.1771113201436104,771035840,4975,5333,10308
5244,SLGL,-0.5683215218903321,-0.10490573980028763,289350048,5252,5056,10308
5245,ADMS,-0.4598764707263803,-0.1308084230417347,209885680,5145,5167,10312
5246,OMER,-0.7664338281152551,-0.08059084675684408,1109853696,5404,4912,10316
5247,EQ,-0.3779338219305987,-0.1539631280505521,200378080,5048,5269,10317
5248,REED,-0.8263122541022935,-0.07795660590028754,101955888,5430,4892,10322
5249,AIHS,-1.1078861903039783,-0.06680488121472361,73417512,5523,4799,10322
5250,XOG,-0.4532458805759695,-0.1350217296612012,961842432,5138,5188,10326
5251,AYTU,-0.42524663505333776,-0.14177241632529053,162505776,5108,5220,10328
5252,USWS,-0.4002261475459935,-0.1513385323596316,86755968,5076,5258,10334
5253,YMTX,-0.3250526967643591,-0.18925690313774146,180939952,4974,5362,10336
5254,VRNA,-0.3325803080366097,-0.1853736020929889,509056160,4984,5353,10337
5255,ESPR,-0.46846985910709943,-0.13343386297755794,770098048,5155,5182,10337
5256,MESO,-1.222978434478968,-0.06663510691205697,1117464448,5542,4797,10339
5257,HOOK,-0.3196959333789313,-0.19316106935418018,392920864,4969,5371,10340
5258,WHLM,-0.6929805379400831,-0.09130931273160121,27901208,5361,4979,10340
5259,CDEV,-0.22753403614123663,-0.34841745049450307,1218691712,4772,5569,10341
5260,OPTT,-0.976710209694053,-0.07477205871129683,160095280,5479,4866,10345
5261,NRBO,-0.6479089294364605,-0.0979158815094112,93784104,5328,5019,10347
5262,ARDX,-0.5242974137433148,-0.1233509494468513,751943936,5214,5136,10350
5263,VRME,-0.44499875280618606,-0.14374238785757126,32306184,5128,5230,10358
5264,ZYME,-0.4304797297142109,-0.14958021993252346,1409389952,5113,5248,10361
5265,AZUL,-0.4888601713952304,-0.13447996682289018,2386851584,5177,5185,10362
5266,ADCT,-0.47302500448089624,-0.13896208102799665,1940291712,5163,5200,10363
5267,APTO,-0.46706085325203933,-0.14110425709985067,505806496,5153,5211,10364
5268,CABA,-0.3088530636091434,-0.21465794843113228,253862544,4945,5422,10367
5269,HEXO,-0.28551209797025295,-0.24504119368748398,760132032,4895,5473,10368
5270,BCRX,-0.762927779063219,-0.09073652410409062,1848003968,5400,4970,10370
5271,SCPH,-0.300149407883522,-0.22507466346100632,178631424,4932,5441,10373
5272,SDPI,-0.4221987066795125,-0.15569892697357932,21895378,5101,5273,10374
5273,KNSA,-0.49544736129564443,-0.13514371294577063,1246604288,5186,5189,10375
5274,OCX,-1.4081522472668375,-0.06695079925038036,464131552,5573,4802,10375
5275,ADMA,-0.3158961199284761,-0.20948423164133306,217082240,4962,5414,10376
5276,UK,-0.2727516199945402,-0.2783288354155838,250192992,4870,5507,10377
5277,AXDX,-0.7321643379291201,-0.09483395434541823,550424448,5379,4998,10377
5278,LKCO,-1.1069333164611044,-0.07385337913784182,365524064,5522,4855,10377
5279,OBLG,-1.4707144035637683,-0.06691592561195117,132291936,5578,4801,10379
5280,NBSE,-0.5454385043730161,-0.1268373154414162,163419024,5232,5154,10386
5281,NETE,-6.016274314728697,-0.0555657047008318,61717644,5703,4684,10387
5282,MGTA,-0.5240197351337315,-0.13266303221673748,639969408,5213,5176,10389
5283,JILL,-0.3995770686410357,-0.1683576279121929,77245680,5075,5315,10390
5284,NINE,-0.31741799513239655,-0.21800349135258398,70999424,4966,5426,10392
5285,CBAY,-0.3702697821738164,-0.18702450789753058,303362816,5037,5359,10396
5286,ALGS,-0.41661419064962474,-0.16449296151692575,785368512,5094,5305,10399
5287,NAKD,-5.682916307161346,-0.05696540032375617,390983264,5702,4698,10400
5288,COGT,-0.24490905223686593,-0.3904833839893699,308712704,4808,5593,10401
5289,CCM,-0.39473367866587983,-0.17959831052954964,166275616,5065,5338,10403
5290,GNPX,-0.5925007747849116,-0.1203313994130609,176136576,5279,5125,10404
5291,PULM,-0.3744399726630724,-0.19183671182772338,74811304,5042,5367,10409
5292,BCEL,-0.34902963329484854,-0.2092505767310251,468120128,5002,5413,10415
5293,OCFT,-0.35742912732302495,-0.2042244331577447,6134605312,5013,5402,10415
5294,CRNX,-0.4333645551469738,-0.16280075208808423,542995136,5117,5298,10415
5295,LYRA,-0.29243146446159113,-0.27773311949379614,149674256,4912,5505,10417
5296,POLA,-0.9764253973036078,-0.08556892377474859,147831600,5477,4945,10422
5297,RWLK,-0.5130133766400273,-0.14191236199956742,100269416,5201,5222,10423
5298,ABIO,-0.20809716599190284,-1.449678950887264,52308664,4732,5699,10431
5299,NEX,-0.3270309618061458,-0.23510243237276277,802546816,4978,5454,10432
5300,OYST,-0.3797665411281349,-0.19709877182551894,541772672,5050,5383,10433
5301,CUE,-0.5413370917406027,-0.14060982922739412,378887552,5226,5210,10436
5302,SWIR,-0.49494467595918956,-0.150420733646785,561007680,5185,5252,10437
5303,WEI,-0.24405376933870176,-0.503996948937562,102169184,4805,5633,10438
5304,NAK,-0.3616033486930731,-0.21368325565381213,327743904,5019,5419,10438
5305,TARA,-0.2017513545174989,-8.651784512190465,169664144,4717,5722,10439
5306,PRTK,-0.49650492204299307,-0.15161814537947155,328717888,5188,5259,10447
5307,CFMS,-0.6114684211823267,-0.1262214239762473,169342032,5296,5152,10448
5308,CHS,-0.30739827583689083,-0.28273871392802746,403405824,4943,5509,10452
5309,AESE,-0.4822481600009126,-0.15779681763068037,108416416,5171,5281,10452
5310,NOVN,-0.6744363273243286,-0.11681180854372991,221413376,5345,5108,10453
5311,LUMO,-0.21459223966321836,-2.603228506119166,102321992,4745,5710,10455
5312,PTN,-0.290988515578274,-0.32160162836267525,152328512,4909,5548,10457
5313,ATNM,-0.3633457731624209,-0.22225637394318795,159546016,5023,5434,10457
5314,GMDA,-0.46517184478343004,-0.16505163684172108,483073632,5150,5307,10457
5315,CSSE,-0.950223716205917,-0.09351907972438392,390489344,5468,4990,10458
5316,FLXN,-0.472998810117056,-0.1629538940141805,416366176,5162,5299,10461
5317,UNAM,-0.5063179287921787,-0.15300028938164129,26577450,5196,5265,10461
5318,FENC,-0.6152390780873753,-0.1283823675256195,167307408,5301,5161,10462
5319,ANIX,-1.1388878616506395,-0.08344623044679392,124804896,5528,4934,10462
5320,PDSB,-0.5395519300574596,-0.14838352425559218,126000656,5222,5243,10465
5321,ZIOP,-0.6279331442368551,-0.12778563005437876,725574528,5309,5158,10467
5322,ASXC,-1.2386015577141858,-0.08166179888454374,697766976,5546,4921,10467
5323,ICPT,-0.539618796601007,-0.14951101663101438,767282560,5223,5246,10469
5324,PBTS,-1.9036237481521934,-0.07279755705255718,135500832,5621,4849,10470
5325,RVNC,-0.5852785696305015,-0.139267060360055,1945183872,5270,5202,10472
5326,ENOB,-1.1660317126898285,-0.08441042967358721,142840192,5533,4939,10472
5327,PRQR,-0.5708585750733368,-0.14161277215771614,408009152,5255,5218,10473
5328,RIBT,-0.3980843070063168,-0.20471973905940516,43428536,5071,5403,10474
5329,ISEE,-0.4630735189746587,-0.17415698449662123,550760320,5146,5328,10474
5330,EYPT,-0.7109647423479272,-0.11653929778792027,306959232,5369,5105,10474
5331,SQNS,-1.875943066034067,-0.07398707555394875,225776368,5618,4856,10474
5332,MUX,-0.32943426456153635,-0.2631695611772877,495921984,4982,5493,10475
5333,ENZ,-0.4232511463893961,-0.1936989039169239,167353248,5103,5372,10475
5334,CKPT,-0.6557845049323044,-0.12369284160240496,221124464,5337,5139,10476
5335,MRNS,-0.5022548497752544,-0.15862581483193047,556064640,5192,5285,10477
5336,DBI,-0.40536343262558966,-0.20154039097869691,1276447232,5081,5397,10478
5337,CYCC,-0.30994288378598905,-0.30624555503407686,65650300,4951,5532,10483
5338,AERI,-0.5231993494033397,-0.1542004984349615,846384512,5212,5271,10483
5339,CTXR,-1.6204143635439718,-0.07739915424482324,238420752,5598,4886,10484
5340,MBOT,-0.3645223389748937,-0.2379030898661712,56509632,5024,5461,10485
5341,LOGC,-0.4230345827515841,-0.19808214791226658,214894464,5102,5385,10487
5342,NYMX,-4.663748507759649,-0.06684952254610803,177100128,5691,4800,10491
5343,SMMT,-0.7577718894342846,-0.11520033940845517,500813856,5396,5097,10493
5344,CAPR,-0.43260609955668367,-0.1955606691263175,99626824,5116,5378,10494
5345,SLRX,-0.5857354682768638,-0.1422686317285664,63075360,5271,5224,10495
5346,TCON,-0.6031976203755345,-0.1392761629881551,136677808,5292,5203,10495
5347,WKEY,-0.9227028293466619,-0.10172147943909994,195231168,5463,5039,10502
5348,MOSY,-0.549520272361498,-0.15364646636059678,23737498,5236,5267,10503
5349,ASMB,-0.27991141111412954,-0.4614473463923519,166753008,4880,5624,10504
5350,TTOO,-0.5802274892462254,-0.14838343890064856,231647504,5263,5242,10505
5351,PSTX,-0.37673371815748813,-0.2374618121610471,557731584,5047,5459,10506
5352,KZIA,-2.182957393483709,-0.07540932657405869,165401136,5640,4867,10507
5353,VRAY,-0.517994437682987,-0.1638058251927767,689836224,5206,5302,10508
5354,BKYI,-0.29216970455195673,-0.40676401119452427,27908404,4911,5600,10511
5355,ALBO,-0.3960710098121902,-0.2271906153782458,640114496,5067,5445,10512
5356,UTSI,-0.2954042856053481,-0.3964232366815403,52810780,4920,5595,10515
5357,SELB,-0.6773436009917986,-0.13092306778878987,466347968,5347,5168,10515
5358,SYTA,-0.5723666736754052,-0.15184838586108085,50171264,5256,5262,10518
5359,GRAY,-0.3146935029589544,-0.33796769304376567,114689792,4959,5560,10519
5360,AVGR,-0.6763300042746667,-0.13290236841122993,136276272,5346,5178,10524
5361,SINT,-0.308876943193375,-0.3739505945480255,44925972,4946,5582,10528
5362,MDGL,-0.8595687869637911,-0.11269274334351016,1841398272,5440,5088,10528
5363,MTCR,-0.36613112463825964,-0.2732663710315303,145259600,5029,5503,10532
5364,IMUX,-0.38714089205812136,-0.24886858328051145,315829536,5056,5476,10532
5365,DGLY,-4.739554446750561,-0.07176002183611584,93768584,5692,4841,10533
5366,RAIL,-0.3841728423825867,-0.2532595941145048,104051904,5054,5481,10535
5367,ACB,-0.4118254598374354,-0.23249306744332068,1678240768,5088,5450,10538
5368,TYME,-1.076981581957742,-0.09904562460044934,281204544,5514,5025,10539
5369,HYMC,-0.3983739837398374,-0.24052245639123362,241402256,5072,5468,10540
5370,MGY,-0.5330859048800379,-0.1712161336722345,2860327424,5220,5323,10543
5371,QUIK,-0.7875437913585053,-0.12320016446174584,85654280,5411,5135,10546
5372,RGLS,-0.5465461986949303,-0.16816583548826378,103681864,5234,5313,10547
5373,MREO,-1.6525468461335444,-0.0866278830282435,431897536,5600,4950,10550
5374,AKER,-0.35678012758087413,-0.3115650856076579,55786880,5011,5540,10551
5375,VRCA,-1.158655093860838,-0.0984300672511964,379429760,5530,5021,10551
5376,TNXP,-0.5724015230497258,-0.1637331343947603,375744896,5257,5301,10558
5377,LNSR,-0.3160412004851135,-0.4057500986414411,77731496,4963,5599,10562
5378,CHEK,-0.8364051149666807,-0.12110540760158094,119762280,5433,5129,10562
5379,SLS,-0.650676271121499,-0.14474614618286802,140288640,5331,5234,10565
5380,FRLN,-0.3490313359516689,-0.3420622320669461,466027904,5003,5563,10566
5381,PSTI,-0.512225215049092,-0.19153284969014514,154178272,5200,5366,10566
5382,YMAB,-1.0659751848691694,-0.10535064076836057,1233535360,5510,5058,10568
5383,SIEN,-0.7773959287085,-0.12913502728976212,403777472,5407,5163,10570
5384,LIXT,-2.160413928758273,-0.08315336593137528,44134856,5637,4933,10570
5385,IFRX,-0.436464908805658,-0.2333564685943747,161325312,5121,5452,10573
5386,KALA,-0.47763327498608193,-0.207129386929553,442561760,5166,5407,10573
5387,ATNX,-0.4303318887258005,-0.23797955410499005,381295200,5112,5462,10574
5388,ZGNX,-0.49267831837505904,-0.20002123079602832,1076811776,5181,5393,10574
5389,PXLW,-0.5862299784843413,-0.16397255606802236,170212416,5272,5303,10575
5390,EDSA,-1.4983149685149462,-0.09378937261786184,73930824,5583,4992,10575
5391,PLSE,-1.848159792861106,-0.0895724829890265,562694400,5616,4964,10580
5392,DRIO,-1.0539245056920312,-0.11099148823005474,290973056,5507,5078,10585
5393,SENS,-4.804784747100613,-0.07790902165479731,959822848,5694,4891,10585
5394,EIGR,-0.4894893948821347,-0.20881540845569319,278669504,5178,5412,10590
5395,VIRI,-0.33417157386342133,-0.4103170434517865,52648068,4986,5605,10591
5396,MINDP,-0.5661210551106924,-0.18086448823682952,47803348,5250,5341,10591
5397,AEY,-0.4643107067879636,-0.22664495585779004,35615808,5149,5443,10592
5398,MIRM,-0.4689526173325779,-0.22269131775456366,591967360,5156,5436,10592
5399,FTSI,-0.3714609286523216,-0.3312562400057569,348351008,5038,5557,10595
5400,INVO,-0.6439415584696118,-0.15655738326190555,43036252,5324,5276,10600
5401,IPDN,-1.589066168682699,-0.09545363906814047,28203560,5596,5005,10601
5402,DADA,-0.3110859084142775,-0.5622169854228424,6187859968,4954,5648,10602
5403,ONCY,-0.8047363968161539,-0.13379349582352237,218796288,5420,5183,10603
5404,BYSI,-1.1979018069424632,-0.10676125628685458,401987328,5537,5067,10604
5405,HEPA,-0.541410172335274,-0.19589451319072274,138729872,5227,5380,10607
5406,SPCB,-0.7900943396226415,-0.13682213494939524,30437856,5412,5195,10607
5407,SVRA,-0.5315001507184245,-0.1997787314270866,227900640,5218,5391,10609
5408,IDBA,-2.7994910401866187,-0.08478217012915225,314542816,5667,4942,10609
5409,LRMR,-0.4473007712082262,-0.24979063898317538,230515504,5133,5477,10610
5410,ORTX,-0.6373309765797613,-0.16095071489757173,879470400,5316,5294,10610
5411,BIOL,-0.6927274086254578,-0.14987964994013223,113827560,5360,5250,10610
5412,VS,-1.5142165728696504,-0.09924526935589045,84681632,5586,5027,10613
5413,HGEN,-1.842563770447281,-0.09484483695239328,977240832,5614,4999,10613
5414,JAGX,-4.030268634127885,-0.08297862283093708,239189824,5684,4929,10613
5415,BPTS,-2.2447270970858155,-0.09072755770368982,139325856,5645,4969,10614
5416,BIOC,-0.44248956291945957,-0.2622929256670745,60846896,5123,5492,10615
5417,SYRS,-0.4457497860539686,-0.25609663531149546,427160352,5131,5485,10616
5418,EVAX,-1.1603289895321514,-0.11244884369505141,104440928,5531,5085,10616
5419,RYTM,-0.8077585034214775,-0.13767345797259511,1074881280,5422,5196,10618
5420,SLDB,-0.5894238831814247,-0.1814134529714022,606865920,5274,5345,10619
5421,WATT,-0.6427490326877278,-0.16197444364230296,244158592,5323,5296,10619
5422,PIRS,-0.4093525613950401,-0.3101570892030112,157658160,5084,5537,10621
5423,NSPR,-0.7070778851620239,-0.15115973393942259,74764408,5367,5254,10621
5424,BFRA,-0.9766052554622551,-0.12546656150024452,166738560,5478,5145,10623
5425,GOL,-52.23763855589145,-0.08018103999410885,1390334592,5722,4906,10628
5426,APA,-0.45188718374118625,-0.26363403840372307,6750490624,5136,5494,10630
5427,CWBR,-0.7014332242121752,-0.15385100714511496,85267856,5364,5268,10632
5428,LJPC,-1.2311098414512212,-0.11334914806084187,110262168,5543,5090,10633
5429,NBY,-0.5180169286577992,-0.2191604483669443,38439984,5207,5427,10634
5430,PHGE,-0.4787506724470745,-0.24041251603226832,155174672,5168,5467,10635
5431,MIST,-0.35260577825678824,-0.475448695682307,172808144,5009,5627,10636
5432,BLUE,-0.4049636698734959,-0.3310694778240722,2015572864,5080,5556,10636
5433,EVGN,-0.7036837478376768,-0.1548540188530743,196794240,5365,5272,10637
5434,PED,-0.4359291624777666,-0.2967106333890365,119956848,5118,5523,10641
5435,CEMI,-0.5112949428806489,-0.22753368318153266,89004384,5199,5446,10645
5436,FSTX,-0.5735507474925882,-0.19923469336329022,92823264,5258,5388,10646
5437,VNRX,-1.081889702197185,-0.12143304193035777,185576864,5516,5130,10646
5438,ENSV,-0.47087458070850036,-0.26165205164212746,20169540,5160,5491,10651
5439,GTYH,-2.2781422539785643,-0.09642524942665028,328580160,5646,5011,10657
5440,OCUP,-0.6529626819341933,-0.171464459362742,68420776,5334,5324,10658
5441,ARLO,-0.6332979031790511,-0.1848645753454939,516028672,5313,5351,10664
5442,FET,-0.36869457132617034,-0.48518238671180175,109868864,5034,5631,10665
5443,PBLA,-0.6811079545454546,-0.16779412028872953,41949024,5356,5312,10668
5444,SGLB,-1.0759207130241482,-0.12702087447242652,41338876,5513,5155,10668
5445,NTNX,-1.070689628430952,-0.12743554521604836,5568727552,5512,5157,10669
5446,NDRA,-1.4787163333124205,-0.11481731312631202,106079376,5579,5095,10674
5447,HRTX,-0.8865179862419489,-0.14206365138911842,1569277824,5452,5223,10675
5448,RESN,-1.1775755796888758,-0.12417177988759562,245287552,5534,5141,10675
5449,PLAG,-0.6120406419313912,-0.19674000054809299,44822176,5298,5381,10679
5450,TBPH,-0.8618496842129638,-0.1454330877659313,1405441408,5442,5237,10679
5451,LIZI,-0.5148554510623476,-0.24981320555492134,381851264,5203,5478,10681
5452,IMAC,-0.8604150056751109,-0.14638614923822268,41771660,5441,5241,10682
5453,CLBS,-0.5845801526717557,-0.21149493123592225,103528264,5268,5416,10684
5454,LPCN,-0.9588268342901837,-0.14130592777680134,137733328,5472,5212,10684
5455,APTX,-0.34765071255898045,-0.8823349469643089,193979840,5000,5685,10685
5456,LIFE,-0.48174276371563524,-0.28658440596101326,66607420,5170,5515,10685
5457,RKDA,-0.4365822110629232,-0.34237747683671377,55900840,5122,5564,10686
5458,CSPR,-0.6531693073908126,-0.18659922388429986,303303520,5335,5357,10692
5459,LBPS,-2.043696466809422,-0.10663292027964925,288735488,5628,5066,10694
5460,OTLK,-9.447300224130373,-0.09236792165204749,388877440,5708,4986,10694
5461,RMTI,-0.4438267170565637,-0.3571174744089266,94521656,5127,5573,10700
5462,GNFT,-0.46528460745040656,-0.3258704688217195,196716672,5151,5551,10702
5463,TBLT,-0.7436636816822533,-0.16878072973722744,79290728,5386,5316,10702
5464,WBAI,-0.4679577741150616,-0.3229439510454398,825845824,5154,5549,10703
5465,YTEN,-0.7450424929178471,-0.16835380843769088,57847704,5389,5314,10703
5466,VISL,-1.652569809793606,-0.11635097140168059,136466592,5601,5104,10705
5467,APM,-0.800195114727187,-0.15944691777593342,110318712,5418,5289,10707
5468,XBIO,-0.3835469276318644,-0.617499661295181,18193114,5053,5659,10712
5469,ACHV,-0.42802008067090336,-0.40946516908829456,68940600,5109,5603,10712
5470,OEG,-3.47846600532301,-0.10039584307507862,247310320,5680,5033,10713
5471,SGBX,-4.494212388282026,-0.09921853028336455,37301368,5689,5026,10715
5472,ARAV,-0.42990782776172787,-0.41262138165708484,111668232,5111,5606,10717
5473,AFIB,-0.5965125630111998,-0.22227132783482137,374787296,5286,5435,10721
5474,AGTC,-0.5442045955157783,-0.269123993889506,190248176,5229,5499,10728
5475,CHMA,-0.44264349307987744,-0.40959252961294446,171217056,5125,5604,10729
5476,OTIC,-0.4564557945229923,-0.3822476750460012,118381552,5140,5589,10729
5477,MRKR,-0.7366384215362385,-0.18509657239107036,171008640,5383,5352,10735
5478,CNSP,-0.6778475656410274,-0.1987261659252748,59710120,5349,5387,10736
5479,ARMP,-0.7362300057978923,-0.18606001511579248,118965704,5381,5355,10736
5480,GOSS,-0.4205054884051575,-0.5212748520091531,678993984,5100,5637,10737
5481,QLGN,-0.6785856668684611,-0.19930901731938017,76556664,5351,5389,10740
5482,SPRO,-0.5687286582078286,-0.2579983297760851,377507520,5253,5488,10741
5483,AGLE,-0.5612605476149475,-0.269525756925417,375964480,5245,5500,10745
5484,XAIR,-0.8190368557973499,-0.16991748108073712,117387648,5426,5321,10747
5485,KPTI,-0.6796600315605881,-0.2006495904684063,764255232,5352,5396,10748
5486,YSG,-0.3858686294920624,-1.219504609079919,6796155904,5055,5694,10749
5487,MIND,-0.5661210551106924,-0.2719376161815637,29999374,5250,5502,10752
5488,EXPR,-0.44512637215869344,-0.4635498299674842,254698080,5130,5625,10755
5489,ATNF,-5.640642239809578,-0.10407815659064608,190900464,5701,5054,10755
5490,XERS,-0.6250458211143695,-0.23022518513091067,277874112,5308,5448,10756
5491,SEED,-0.8845114374077067,-0.16451340628277664,93820152,5451,5306,10757
5492,INFI,-1.3616652518392756,-0.13822455345465948,296056576,5564,5197,10761
5493,GLYC,-0.3949991487978111,-1.3110929192304255,163894016,5066,5698,10764
5494,SYBX,-0.44611514029172417,-0.5240155205517802,139595712,5132,5638,10770
5495,AVCO,-1.6086823131790293,-0.13174183812559848,89469928,5597,5174,10771
5496,SLGG,-2.387962480458572,-0.11943615812205753,158376112,5649,5122,10771
5497,CLRB,-0.4361142564749652,-0.607142573517371,78786392,5119,5657,10776
5498,BHVN,-2.062291697955245,-0.12570290930321665,4610572800,5629,5147,10776
5499,FULC,-0.6962528681989655,-0.20950565827648546,372136384,5362,5415,10777
5500,KIN,-0.6120470545896219,-0.24997695997149652,203930064,5299,5479,10778
5501,EKSO,-0.8230173462203162,-0.1842690363471749,74591408,5429,5349,10778
5502,EYEN,-1.259787528735453,-0.14389227292155704,147335696,5550,5231,10781
5503,ZSAN,-0.5697043478260869,-0.30144223333230025,128610904,5254,5528,10782
5504,EPZM,-0.6495314715136985,-0.23381065741288612,859065344,5330,5453,10783
5505,JG,-0.5629026116455664,-0.3105003726011415,472149824,5247,5538,10785
5506,CTEK,-0.5779552546055442,-0.2970409305009478,24302004,5261,5524,10785
5507,LTBR,-0.5217415483447886,-0.36152651906205896,41654500,5211,5575,10786
5508,BTU,-0.4245853965259766,-0.8459326032059074,337255456,5105,5683,10788
5509,MBIO,-0.5658813567764108,-0.3111517406071349,270855872,5249,5539,10788
5510,NVIV,-0.4564704701691003,-0.6003763687320661,32673162,5141,5655,10796
5511,CLSD,-1.9122507730035185,-0.13166950263271462,143556256,5623,5173,10796
5512,DPW,-17.397442377637255,-0.11138101378883411,158795904,5716,5080,10796
5513,AVRO,-0.4721860026706465,-0.5185814226491217,474908160,5161,5636,10797
5514,MYO,-0.8870454136404687,-0.18138718733651263,67273584,5453,5344,10797
5515,LEXX,-1.6412289483882812,-0.13891817303473647,28839464,5599,5199,10798
5516,FBIO,-0.5553065773490111,-0.34113217192626766,402407360,5241,5561,10802
5517,IMRA,-0.4929132927477983,-0.44417203426914326,135329040,5183,5620,10803
5518,PRVB,-0.8917424791347986,-0.1824827539546625,631845760,5457,5347,10804
5519,UBX,-0.6311611775321453,-0.26371138999459653,318351104,5311,5495,10806
5520,ABEO,-0.6443744769040692,-0.25417518266718936,160038016,5326,5483,10809
5521,GRTS,-0.5448532472671769,-0.36599971498027234,432732160,5231,5580,10811
5522,NUZE,-1.3443555657729298,-0.15025545287253997,65223764,5560,5251,10811
5523,RMBL,-1.57067356438555,-0.1416002307675857,96142864,5594,5217,10811
5524,ISIG,-0.5174645686865306,-0.41503781256724115,12611476,5205,5607,10812
5525,CLXT,-0.765261963037849,-0.20765424310959646,216618896,5403,5409,10812
5526,ATRA,-0.6117188783478056,-0.29012724360643677,1182732160,5297,5519,10816
5527,CLSN,-1.2068512317102724,-0.1575977018971805,123777504,5539,5279,10818
5528,SBBP,-0.5898382099827882,-0.3186174710640266,183723488,5275,5544,10819
5529,NAVB,-0.8932507129998348,-0.1911452133361177,53992268,5459,5364,10823
5530,DBVT,-0.6163823738450604,-0.29247787656534713,605664320,5303,5521,10824
5531,EFOI,-0.8533057851239669,-0.1986381503084783,14804575,5439,5386,10825
5532,CEI,-1.8854794719889825,-0.14044993370262956,34421736,5619,5208,10827
5533,THMO,-0.7111448672849376,-0.23699382169496064,31923624,5370,5458,10828
5534,CFRX,-0.7599428979509616,-0.21980859346362028,165194816,5399,5429,10828
5535,VBLT,-0.7148947353052822,-0.23542918096377513,109718056,5375,5455,10830
5536,AXLA,-0.5287993085022789,-0.4333277354992487,162822528,5216,5617,10833
5537,ETON,-1.235125284738041,-0.16074555104032628,179395856,5544,5293,10837
5538,INPX,-0.9341029538638511,-0.19467738984583557,122672224,5465,5375,10840
5539,YTRA,-1.3115016482241457,-0.15850005003483383,156815120,5556,5284,10840
5540,ENTX,-1.7930764411027569,-0.14266485536597828,85557000,5613,5228,10841
5541,EYEG,-0.8034293158819859,-0.21493998027969147,35418568,5419,5423,10842
5542,APVO,-0.7048297785069729,-0.2516024810380276,114661552,5366,5480,10846
5543,ONTX,-2.508078273958856,-0.13576138622647205,193099056,5656,5193,10849
5544,BLCT,-0.45123587354212835,-4.608691296590088,313731456,5135,5717,10852
5545,CNCE,-0.48728577657041283,-0.7714718672679716,161190752,5175,5677,10852
5546,KDMN,-1.201835401391239,-0.16977822108398077,646031872,5538,5319,10857
5547,MTEM,-0.9855165943473672,-0.19788815376149346,482329888,5484,5384,10868
5548,ACRX,-0.8418207973695027,-0.22370404130637261,179611472,5434,5439,10873
5549,HJLI,-1.2426034488809379,-0.1733524537725101,58845188,5547,5326,10873
5550,CYTH,-0.8522163327710158,-0.22322740454009724,49273800,5437,5437,10874
5551,ONVO,-0.5940848045872944,-0.3964990453608202,65263624,5281,5596,10877
5552,IMV,-0.8301156703292155,-0.22981351999405694,202718272,5431,5447,10878
5553,BPTH,-0.7126617012936104,-0.2814310319044955,51345052,5373,5508,10881
5554,STSA,-0.6621453135489882,-0.31835764765054586,179042112,5339,5543,10882
5555,CRVS,-0.5963477786862905,-0.3997313980390069,113779512,5285,5598,10883
5556,STG,-0.6174766740146573,-0.3658635046377736,178323792,5304,5579,10883
5557,AEMD,-0.6312133392573127,-0.35777282646534814,25111790,5312,5574,10886
5558,ACOR,-0.6738499147508311,-0.31328386116636425,44222792,5344,5542,10886
5559,AKBA,-0.6696008069208985,-0.31879254328905854,486601344,5342,5545,10887
5560,MCHX,-0.8709368370628892,-0.22508386836808164,125985736,5446,5442,10888
5561,AGRX,-0.7465187417248779,-0.26837736918680927,173505216,5391,5498,10889
5562,EVLO,-1.2977148829195266,-0.17900813804979185,532282272,5552,5337,10889
5563,OPGN,-1.2093699641873386,-0.1853859484734131,102554224,5540,5354,10894
5564,HX,-0.5398892453925354,-0.7161663872102706,32174608,5224,5674,10898
5565,RDHL,-3.287708474930726,-0.1425089117700051,315937632,5677,5227,10904
5566,FIXX,-0.5403332517556486,-0.7766325900583302,362500960,5225,5680,10905
5567,HOTH,-1.4809524939495107,-0.1730517220544351,44512848,5580,5325,10905
5568,PHIO,-0.649265303108617,-0.3636798895650632,35994856,5329,5578,10907
5569,LPTX,-0.6023106874614353,-0.43905667522486996,109173592,5290,5619,10909
5570,BCDA,-0.8098143512724238,-0.25781452442260105,77392224,5424,5487,10911
5571,DFFN,-0.9591814187985086,-0.22324585717122988,87637440,5473,5438,10911
5572,AYLA,-0.7644733126235527,-0.2850815013134601,139598832,5401,5511,10912
5573,OPTN,-0.6383076821744571,-0.3991192807226161,185310656,5317,5597,10914
5574,GALT,-1.0680151245956904,-0.20513039482263623,136031280,5511,5404,10915
5575,YVR,-2.485482660677379,-0.15172635106597515,49019740,5655,5260,10915
5576,UCL,-1.131223507435879,-0.19992747224784987,296474240,5525,5392,10917
5577,CTIC,-1.05742300317938,-0.20799525968066623,232827120,5508,5410,10918
5578,BLPH,-0.5269557353162839,-1.9758325982989904,47740284,5215,5704,10919
5579,CDAK,-0.6800658239210113,-0.3466537734451695,308577216,5353,5568,10921
5580,SNOA,-0.6880156765676567,-0.34179838107153254,18343354,5359,5562,10921
5581,VSTM,-0.8361018826135105,-0.258540198233737,475514816,5432,5489,10921
5582,ALRN,-1.655439786770051,-0.169779174417287,123588520,5602,5320,10922
5583,GLMD,-0.6808807951497667,-0.35711590499908363,83529384,5354,5572,10926
5584,AQST,-1.0291520706367867,-0.22005638631306224,171292224,5497,5430,10927
5585,GHSI,-1.0436125248349895,-0.21512296525470073,49831080,5505,5424,10929
5586,NEPT,-0.7872514344756619,-0.2907574942034014,226009056,5410,5520,10930
5587,CPG,-0.579014148155873,-0.692201561501333,2114215552,5262,5673,10935
5588,ASTC,-5.135443037974683,-0.14569782723132255,54357604,5697,5238,10935
5589,WTER,-8.882294362319172,-0.14355854349762373,90732720,5707,5229,10936
5590,ADTX,-0.768253336826991,-0.3073980215841546,38136152,5405,5533,10938
5591,CGA,-0.5564979607393615,-1.2815864313347303,36830756,5244,5696,10940
5592,CREX,-2.7436548223350252,-0.15831720382234263,20375320,5664,5282,10946
5593,MYOV,-13.143692815359232,-0.14626594520632782,1674340992,5713,5239,10952
5594,ECOR,-0.9807101967875803,-0.24269801939813548,95014528,5481,5472,10953
5595,BCLI,-0.7921198029950749,-0.3128152934097665,127882608,5413,5541,10954
5596,MBRX,-1.3193878232974672,-0.20239406902336937,109795384,5557,5399,10956
5597,SCYX,-0.6717756763856054,-0.4307186423792854,171581696,5343,5614,10957
5598,ANTE,-1.4150943396226414,-0.19675184196863757,54453924,5575,5382,10957
5599,BLRX,-1.5351188483428189,-0.19378428393651603,121761968,5589,5373,10962
5600,DTIL,-1.0365434708747028,-0.23805895930649265,508316896,5500,5463,10963
5601,KSPN,-0.8710210722439446,-0.2887572781762622,59985752,5447,5517,10964
5602,FBIOP,-0.5553065773490111,-18.261268193396855,131512816,5241,5724,10965
5603,GNCA,-0.6393235190073199,-0.5534024078404622,139683280,5319,5647,10966
5604,SRRA,-0.6519137048591994,-0.514086158527863,219079984,5332,5634,10966
5605,SFET,-0.9509883250491272,-0.26581466394848796,37233136,5470,5497,10967
5606,CBIO,-0.7341985723556133,-0.3875430921611864,158534864,5380,5591,10971
5607,ADXS,-0.7401013323325202,-0.3809266743195411,84009192,5384,5588,10972
5608,ZEAL,-0.5995542556944687,-1.045465227418726,1378703616,5288,5690,10978
5609,AUTL,-0.6456065580064889,-0.5855403538901498,406827104,5327,5653,10980
5610,DCTH,-0.8659756097560976,-0.3088392122432719,87517640,5445,5536,10981
5611,HSTO,-0.8891081593927894,-0.30148476485320774,42463368,5456,5529,10985
5612,CLVS,-1.0355677857776833,-0.2564676582832213,687807424,5499,5486,10985
5613,NVFY,-0.5946647279745714,-2.3982653205146383,17537752,5282,5709,10991
5614,CSSEP,-0.950223716205917,-0.29870156140524023,94601512,5468,5526,10994
5615,APLT,-1.134440561540032,-0.24266677577672122,425513792,5526,5471,10997
5616,SPPI,-0.9852769192214519,-0.2871411266431276,485780896,5483,5516,10999
5617,CYRN,-3.186189366659606,-0.1734409809698277,61825908,5673,5327,11000
5618,LQDA,-0.6443534869536462,-0.7719618679432273,108690280,5325,5678,11003
5619,XFOR,-0.7143675280979311,-0.4764761449656349,159242016,5374,5629,11003
5620,CERC,-3.7725933542435777,-0.1750954134601538,273796864,5681,5331,11012
5621,ELOX,-1.7691568002884788,-0.20569623083615765,151563088,5612,5405,11017
5622,BBI,-0.7688867710127928,-0.4309992690107745,72284296,5406,5615,11021
5623,DUOT,-6.63189461625659,-0.16947376630278307,38697520,5704,5318,11022
5624,ADMP,-1.5560226471598326,-0.22068983620094695,131595736,5592,5433,11025
5625,SINO,-2.70130448834165,-0.19301393847678439,84371064,5661,5370,11031
5626,SRGA,-0.9907750293222283,-0.32070551339620046,231562784,5485,5547,11032
5627,TC,-0.6362426543888428,-8.58383169498557,82268312,5314,5721,11035
5628,ZYNE,-0.8656383110748009,-0.38794718426279295,179444016,5444,5592,11036
5629,AGEN,-3.9729461319817814,-0.18651470065224937,573117952,5683,5356,11039
5630,NAOV,-3.1698461538461538,-0.19222283787931077,27726024,5672,5369,11041
5631,HTGM,-0.7004493744871079,-0.772642987151388,31942016,5363,5679,11042
5632,TXMD,-1.9219925464016143,-0.21354332663554507,511930304,5624,5418,11042
5633,MRIN,-0.7242634730538923,-0.6667189963980682,19356720,5376,5670,11046
5634,APDN,-2.0239579481731096,-0.21427353479582825,61503364,5626,5420,11046
5635,ATHX,-2.1309031556039173,-0.2144282545375835,393898336,5634,5421,11055
5636,SLNO,-0.7646411219874112,-0.6065798986609638,93276720,5402,5656,11058
5637,APRE,-0.6816632055939656,-1.8300630846143742,102544112,5357,5703,11060
5638,MTP,-0.8808467585026072,-0.42998497446038175,26824850,5449,5612,11061
5639,URGN,-1.1945927671548886,-0.2983568155892977,434096864,5536,5525,11061
5640,LXRX,-1.541146755129448,-0.2425296338083989,793947008,5591,5470,11061
5641,TCDA,-0.7485185570225595,-0.6818604302410749,256749408,5392,5671,11063
5642,ARTL,-2.5531829683730116,-0.2063028866400139,24352980,5657,5406,11063
5643,RENN,-1.0129136856790053,-0.37312858612686534,194297552,5492,5581,11073
5644,GRTX,-1.0531713215208014,-0.34644362335531964,205553296,5506,5567,11073
5645,BNTC,-0.7923643670462157,-0.6223831872212203,21970308,5415,5660,11075
5646,CYAD,-1.4092373791621913,-0.27010074510749144,102548936,5574,5501,11075
5647,KLDO,-1.8478153918238256,-0.2397596831857605,340159072,5615,5466,11081
5648,VYNE,-1.3456404155542336,-0.2966780259200615,330816704,5561,5522,11083
5649,EVOK,-6.872918412681188,-0.19584445307902865,62154240,5705,5379,11084
5650,YI,-1.1350057072698148,-0.3346345386514342,974311680,5527,5559,11086
5651,BVXV,-0.809486419191867,-0.6410187812587775,51956868,5423,5665,11088
5652,ONCS,-2.1462624383004525,-0.23773024702182918,192793952,5636,5460,11096
5653,SNGX,-1.3480729305984045,-0.3088042566706446,62832188,5563,5535,11098
5654,TRVI,-0.7814364056186262,-1.1908951085657649,52773160,5408,5693,11101
5655,SONM,-0.9254641732019573,-0.5286443127757943,53717500,5464,5641,11105
5656,ACST,-2.1792402354200107,-0.24239276713789668,107664840,5639,5469,11108
5657,CYCN,-0.7978989291447381,-1.2952024568968417,98077536,5417,5697,11114
5658,TTNP,-1.9024327122153208,-0.26492186552852975,28605804,5620,5496,11116
5659,BDR,-1.7076332213154104,-0.28586261878126246,16861080,5605,5512,11117
5660,ALNA,-0.9749154195495139,-0.5652934627008112,75650000,5476,5649,11125
5661,CALA,-0.8526020189203813,-1.0390910257701214,176693984,5438,5689,11127
5662,CATB,-0.901840938976282,-0.7836143582271404,65801768,5460,5681,11141
5663,WISA,-1.3408172962698979,-0.378435728356172,34288408,5559,5585,11144
5664,SNCA,-1.1012437383182583,-0.4724059139451873,29921562,5521,5626,11147
5665,NTEC,-0.888638992417427,-1.2555119872387905,20351630,5455,5695,11150
5666,WVE,-1.0203094648891726,-0.6304889746869798,306723744,5494,5661,11155
5667,PRPO,-25.195592286501377,-0.22415541494387733,38440048,5717,5440,11157
5668,KRBP,-1.689555627920895,-0.32987731050213714,66876960,5604,5555,11159
5669,TMBR,-2.24435900514623,-0.28894012703601374,73686000,5643,5518,11161
5670,PTE,-1.0961087022563452,-0.5767801666098156,84335312,5519,5650,11169
5671,CHFS,-1.03658610823644,-0.6880814021149654,35599072,5501,5672,11173
5672,ATHE,-1.9365106970531596,-0.3257359158985596,49246156,5625,5550,11175
5673,CAN,-1.491491006720533,-0.3925479618771715,2920422144,5582,5594,11176
5674,ADIL,-2.745407565959713,-0.2860232784740909,41102364,5665,5513,11178
5675,PIXY,-3.2239899892742225,-0.2756725676951554,57898816,5674,5504,11178
5676,ODT,-0.9049803640288894,-6.505013178173645,149781968,5461,5720,11181
5677,MOTS,-1.4024082057380705,-0.4286350767067777,54227796,5571,5611,11182
5678,LMNL,-1.0865608905517448,-0.6570565586777609,123967328,5517,5667,11184
5679,ERYP,-1.363928189275948,-0.43876347843771235,157597232,5566,5618,11184
5680,HUGE,-1.2996121378309888,-0.5180736957140047,69549864,5553,5635,11188
5681,FTK,-1.2497919077491524,-0.5414376734445776,121881144,5548,5644,11192
5682,SIOX,-1.1222317763680907,-0.6611006688173807,153339056,5524,5669,11193
5683,IDRA,-1.0371762976365486,-1.1275843894889845,58737924,5502,5692,11194
5684,ETTX,-1.023361576057215,-1.7051568677660298,76486112,5495,5701,11196
5685,OVID,-1.5208281101990444,-0.41557588831189307,245918464,5588,5608,11196
5686,GNLN,-2.1426022903838406,-0.3452617791278646,88572016,5635,5566,11201
5687,SNES,-1.517406273909717,-0.43221809115753596,20557160,5587,5616,11203
5688,CANF,-1.7129876423552217,-0.40807385331506973,41647140,5606,5602,11208
5689,TOUR,-1.2354632943699408,-0.657231576601643,437956384,5545,5668,11213
5690,OBLN,-2.027463651050081,-0.3799514792373925,28156480,5627,5586,11213
5691,OGEN,-2.6215156917413838,-0.3428975727343426,93999512,5659,5565,11224
5692,VIVE,-1.4897301651228352,-0.544445376629914,31335350,5581,5645,11226
5693,WINT,-2.1039193248462307,-0.4070613274552591,65642752,5632,5601,11233
5694,TENX,-2.0775779160406658,-0.4302070815692015,26944740,5630,5613,11243
5695,OBSV,-4.651356871899621,-0.32776039632240506,227347488,5690,5553,11243
5696,RZLT,-2.6387130120170563,-0.37998564387033157,60470504,5660,5587,11247
5697,INM,-1.7634884749959487,-0.524645082090063,28713358,5611,5639,11250
5698,AMPY,-1.34720049283769,-1.0808443367273255,101687776,5562,5691,11253
5699,CRTD,-4.263056011314158,-0.3531958436409029,48828168,5688,5571,11259
5700,FGF,-1.3804179104477612,-1.7630328862591405,24791900,5569,5702,11271
5701,CRBP,-1.744535523802509,-0.6359003184000341,228634720,5608,5663,11271
5702,MYSZ,-2.3148775894538605,-0.48380348573090654,13481505,5647,5630,11277
5703,PSTV,-2.8323680823680824,-0.42034590700647817,20749276,5669,5609,11278
5704,ASLN,-1.3726674678980328,-2.9108364927589245,214250352,5568,5712,11280
5705,EVFM,-3.1673244607618174,-0.4539200869135686,174464576,5671,5622,11293
5706,PROG,-2.721983600156189,-0.4907394685612467,255467616,5662,5632,11294
5707,OXBRW,-1.4395973154362416,-4.9483858270270975,1124357,5577,5718,11295
5708,BSGM,-2.4635364635364634,-0.5347546424552972,133835056,5653,5643,11296
5709,RMED,-1.4043854182894533,-49.991335149486,15286305,5572,5725,11297
5710,NBRV,-1.660122514561157,-1.5367318083916721,60179280,5603,5700,11303
5711,PHAS,-2.3972653049693475,-0.5857143567109215,150706080,5650,5654,11304
5712,NVCN,-3.415658054468094,-0.47630719249865133,70869856,5679,5628,11307
5713,BXRX,-2.233703504933328,-0.6500680548818096,86976824,5642,5666,11308
5714,SONN,-5.324668410028726,-0.4492558020963045,41256364,5699,5621,11320
5715,MITO,-2.589847283563029,-0.7172290105997403,83151776,5658,5675,11333
5716,ORGS,-2.408667240767945,-0.8692044021726573,130847248,5651,5684,11335
5717,CDTX,-3.286779505946935,-0.6349826225329367,110499128,5676,5662,11338
5718,PT,-3.239331708705397,-0.6400243842845666,57805324,5675,5664,11339
5719,CHK,-5.278433809819764,-0.5798611273606046,4415610368,5698,5651,11349
5720,ACER,-27.634201309578195,-0.525316159775025,42644396,5718,5640,11358
5721,WLL,-2.41186947790465,-2.1179206502367336,1304550016,5652,5707,11359
5722,OAS,-2.830800568580689,-1.990295842738263,1249990272,5668,5705,11373
5723,HSDT,-5.061639483160348,-0.9590523650778756,26573262,5696,5688,11384
5724,HUSN,-16.839726915551697,-2.6937858013276834,19666880,5715,5711,11426
