,ticker,roc,yield,market_cap,most_recent,roc_rank,yield_rank,magic_rank
0,VHC,4.574034100555408,0.9578014787213192,379452928,2020-12-31,6,16,22
1,SCPL,1.249005568814638,0.9162591861694867,388648896,2020-12-31,22,18,40
2,BWMX,1.3023062272250159,0.5185799063170464,1347235712,2020-12-31,18,32,50
3,SURF,1.1935140478272441,0.3321936761193667,331735200,2020-12-31,23,44,67
4,CIH,0.6969406630528209,1.1819158664631577,204409184,2020-12-31,56,15,71
5,QIWI,0.6224223959023271,4.9892640777720825,667266368,2020-12-31,76,3,79
6,SAGE,1.2618868977679267,0.21674926752476406,4472637440,2020-12-31,20,77,97
7,SIGA,2.853377247325958,0.19314123601981587,544913664,2020-12-31,7,93,100
8,QDEL,1.2752799708897304,0.21052780731465026,5213712896,2020-12-31,19,83,102
9,APT,0.7266076153226734,0.284047247502845,128625728,2020-12-31,51,54,105
10,CODX,1.5072442266451587,0.18747826218803698,260857888,2020-12-31,15,96,111
11,ASR,0.9756749544947728,0.20801315811099289,5413794816,2020-12-31,33,84,117
12,HNNA,1.9338800615069196,0.16501637655235524,73456192,2020-09-30,11,123,134
13,MSGN,1.8026370661106341,0.15900960686386426,927606976,2020-06-30,12,128,140
14,SBSW,0.4421273987680058,1.47693247658236,13242626048,2020-12-31,149,12,161
15,GBL,0.6729169045204532,0.18007992458835495,498526496,2020-12-31,61,105,166
16,GMAB,0.46770025839793283,0.38766353058852193,22348490752,2020-12-31,133,38,171
17,SPKE,0.6306560322724981,0.18270844194359165,367026816,2020-12-31,73,100,173
18,SPKEP,0.6306560322724981,0.17190897567549848,397557984,2020-12-31,73,116,189
19,FHI,1.0069522038992063,0.13299246210132587,3105543680,2020-12-31,29,162,191
20,NLS,0.6322476678415737,0.16784404694115154,503027264,2020-12-31,72,120,192
21,EDTK,0.4425135113010443,0.2923269471607705,39480000,2020-03-31,148,50,198
22,NVO,0.4428511039573375,0.24879634378582693,161442201600,2020-12-31,147,63,210
23,HHR,0.4407513717571729,0.24019373762658258,1760623360,2020-12-31,151,67,218
24,VCTR,1.6058302889482992,0.11571344188766833,2036189184,2020-12-31,14,205,219
25,CHRS,0.5548598465890738,0.1526567546850728,1015472064,2020-12-31,94,130,224
26,INVA,0.4287061248285231,0.24242993613162256,1186473600,2020-12-31,166,66,232
27,UWMC,0.4712357832971443,0.18020324623415496,12375861248,2020-12-31,132,104,236
28,CPRX,0.7138369870708833,0.12074077931938414,449562240,2020-12-31,53,186,239
29,BPT,54.589928057553955,0.10477913254808821,72546000,2020-12-31,3,241,244
30,FINV,0.3566337287748025,21.463221928519406,1946865920,2020-12-31,245,1,246
31,EAF,0.6051072491480208,0.12808338562403757,3115960064,2020-12-31,81,169,250
32,PRG,0.5141201744040949,0.13677427209573903,2975260160,2020-12-31,109,150,259
33,GTN,0.5084151472650772,0.13623194955605927,1865805952,2020-12-31,110,153,263
34,TGNA,0.7006697485800626,0.10607726657207264,4500790784,2020-12-31,54,236,290
35,UPC,0.6455694592366925,0.10747936596628052,97440000,2020-09-30,66,229,295
36,FLGT,0.5035720312763683,0.11729069863605754,2475976192,2020-12-31,111,199,310
37,BRBR,0.797979797979798,0.0988759434684118,945060096,2020-09-30,46,265,311
38,JHG,0.44490823560591003,0.12174964739706585,5582416384,2020-12-31,145,183,328
39,HAPP,0.3131492503588959,0.6510336929974098,51800000,2020-03-31,314,24,338
40,BDSI,0.5605975943299121,0.10087766639168304,358060096,2020-12-31,89,259,348
41,HEAR,0.49260356495288676,0.10464799157862037,443117952,2020-12-31,112,242,354
42,AMCX,0.3785204417574524,0.14440881333142028,2140154880,2020-12-31,217,139,356
43,LFVN,0.4337558896118465,0.11823671611335411,127924392,2020-06-30,162,196,358
44,IRWD,0.8107727548682996,0.0913309265213025,1640202752,2020-12-31,43,320,363
45,CIXX,0.43837436476881203,0.11530324021777065,3211877888,2020-12-31,157,210,367
46,TRIB,0.4342290707507282,0.11411392873898121,78381000,2020-12-31,160,212,372
47,UONE,0.41079111129872553,0.1199937593709417,120735944,2020-12-31,187,190,377
48,UONEK,0.41079111129872553,0.11971140898278099,123031288,2020-12-31,187,191,378
49,ONEW,0.43390322013708527,0.10953521584980377,609793408,2020-09-30,161,222,383
50,MVO,0.5590978314048675,0.09461377306210718,60062496,2020-12-31,91,293,384
51,GILD,0.5161988034974689,0.0966796124029669,81977393152,2020-12-31,108,278,386
52,LPX,0.47707736389684813,0.0999664785079396,6563233280,2020-12-31,130,261,391
53,GSS,0.31274416739505695,0.21214077577472068,359753600,2020-12-31,315,81,396
54,DGX,0.48083067092651754,0.09793889283626786,16907414528,2020-12-31,126,272,398
55,LH,0.48276400912585554,0.09639097387287753,24874018816,2020-12-31,124,282,406
56,USNA,0.5561994982919235,0.09210192858769718,2060101376,2021-01-02,92,315,407
57,PHAR,0.9572087740469937,0.08249374818741581,799938176,2020-12-31,34,388,422
58,BTG,0.31065229455160204,0.18022837977364892,4965470208,2020-12-31,322,103,425
59,TVTY,1.0758769720701253,0.08162108163093282,1159962496,2020-12-31,28,399,427
60,EBS,0.41346153846153844,0.10440738921594374,4122754816,2020-12-31,184,243,427
61,NATH,1.1140072888607193,0.0804033044848953,266119744,2020-03-29,25,412,437
62,OBCI,0.36702588763250515,0.1132078808217241,111220968,2020-12-31,232,216,448
63,ELVT,0.27942789932218204,0.2958479021400673,109779032,2020-12-31,400,49,449
64,PRDO,0.3062379997439945,0.17111629103478235,840748800,2020-12-31,336,119,455
65,NRT,17.87893608687137,0.07661702466054317,43359152,2020-10-31,4,453,457
66,VALE,0.27100271752666333,0.49629296415929386,93466951680,2020-12-31,429,34,463
67,RKT,0.3074992619201212,0.1395876969780772,45146238976,2020-12-31,331,144,475
68,SBS,0.2908778127769664,0.1834348974419186,5094514688,2020-12-31,376,99,475
69,ICON,0.5822351656352385,0.08207673664783562,31191266,2020-12-31,85,394,479
70,SBR,92.59860315294623,0.0738028385934489,460705888,2020-12-31,2,480,482
71,PBH,0.9938947716743878,0.07607610263295639,2158253056,2020-03-31,31,457,488
72,WLKP,0.26893627136516085,0.270111694569485,884548352,2020-12-31,436,57,493
73,RGR,0.3944015565179188,0.09429693382600125,1204556544,2020-12-31,200,295,495
74,MNDO,0.3891579997150591,0.09593857570886542,59557684,2020-12-31,208,287,495
75,TSM,0.25544444338101346,0.7373454102663465,555628298240,2020-12-31,476,22,498
76,ZIM,0.2936556658252504,0.15104198821232115,3570749952,2020-12-31,369,132,501
77,BTI,0.5525352593821677,0.08084765451938034,88113168384,2020-12-31,95,410,505
78,SBGI,0.3532320308731307,0.10136410950043001,2209914624,2020-12-31,249,258,507
79,WTRH,0.8391899389680044,0.07492535370711441,323391648,2020-12-31,39,473,512
80,PAC,0.27268495828764544,0.19112296503930087,6028924928,2020-12-31,423,94,517
81,WFG,0.33632425742574257,0.10290477017847313,9832164352,2020-12-31,277,251,528
82,GSMG,0.3002467056957688,0.12109058901109439,234274192,2020-12-31,350,184,534
83,TKC,0.24757833266295298,0.3527303289786076,4072080896,2020-12-31,501,43,544
84,VGR,0.4006017056550463,0.08677757821537158,2231201792,2020-12-31,198,348,546
85,ALSN,0.5717192268565615,0.0758363035399769,4794698752,2020-12-31,87,460,547
86,MO,0.3719379248428883,0.09101018271483965,95369265152,2020-12-31,225,322,547
87,HIBB,0.3021246964185398,0.11566680439534478,1206818688,2021-01-30,344,206,550
88,GPL,0.266631003782813,0.17654847726938355,289041440,2020-12-31,440,110,550
89,PZN,0.6365217191026763,0.072953010305205,783246080,2020-12-31,70,489,559
90,NXST,0.33580787211409624,0.09617801668195966,6440492544,2020-12-31,278,284,562
91,VNT,0.5478806907378336,0.07509494098465029,5182820352,2020-12-31,96,470,566
92,OMAB,0.24041782362978675,0.3231480001947948,2603397632,2020-12-31,523,47,570
93,BSIG,0.2948110185778347,0.11566069587651252,1820639872,2020-12-31,366,207,573
94,ALXN,0.4197660358667308,0.08184903002485347,34078638080,2020-12-31,178,396,574
95,ABEV,0.244370923794953,0.23224310542161575,42607308800,2020-12-31,508,70,578
96,KBAL,0.2789321392565825,0.1209627526780024,510728992,2020-06-30,402,185,587
97,CMCL,0.2405515799937552,0.23711992220406278,168330144,2020-12-31,522,68,590
98,DISCB,0.3898613639546282,0.08257921409688464,17564084224,2020-12-31,205,387,592
99,MARPS,204.52796579978624,0.06564066563346255,9680000,2020-06-30,1,593,594
100,QRTEB,0.2995426829268293,0.10437084179395777,4728677888,2020-12-31,354,244,598
101,SPWH,0.25924153259169835,0.14417700143167012,766025856,2021-01-30,462,140,602
102,THRY,0.2900855247950783,0.10790873972280489,778500928,2020-12-31,377,228,605
103,QRTEA,0.2995426829268293,0.10260681120492529,4987620352,2020-12-31,354,252,606
104,APAM,0.39682381859861354,0.0810410102731018,4236037120,2020-12-31,199,408,607
105,BIIB,0.33284476348452785,0.09184017147187565,40851947520,2020-12-31,290,317,607
106,TOMZ,0.4851144483365631,0.0725591016903228,64724272,2020-12-31,120,497,617
107,DISCK,0.3898613639546282,0.07986738547582879,18708783104,2020-12-31,205,417,622
108,RMR,0.23961588217733107,0.19323416920034003,661726400,2020-09-30,530,92,622
109,DISCA,0.3898613639546282,0.0796967672483046,18783408128,2020-12-31,205,420,625
110,BCC,0.2813321280762251,0.10526370289758505,2565122304,2020-12-31,396,240,636
111,KOF,0.22516361693602244,0.2736300015790798,10033112064,2020-12-31,581,56,637
112,KHC,0.4525328618648628,0.07206156364504172,49096036352,2020-12-26,138,501,639
113,HLG,0.2229703390657403,0.2907834647164902,1387635200,2020-06-30,589,53,642
114,NOG,0.2556453021501861,0.12561448355213609,756329600,2020-12-31,475,174,649
115,GPP,0.256267641575269,0.12324187481206166,282675872,2020-12-31,471,179,650
116,WW,0.4883992175385679,0.06935080215032692,2063939328,2021-01-02,116,535,651
117,AU,0.24758953168044076,0.13547386879628565,9196593152,2020-12-31,500,156,656
118,VVV,0.33884297520661155,0.08261206746987378,4805841920,2020-09-30,272,386,658
119,CEPU,0.21476469714230176,0.5369541821393968,538475840,2020-12-31,627,31,658
120,XPER,0.3718184341407428,0.07745721708762554,2349428736,2020-12-31,226,443,669
121,STC,0.23909731408554313,0.14825884683170623,1559694080,2020-12-31,534,135,669
122,GNE,0.2987232471276611,0.09238204173922014,167124944,2020-12-31,360,312,672
123,REYN,0.4830997526793075,0.06798932742243309,6290999808,2020-12-31,123,556,679
124,GIB,0.4315315711535375,0.07057290895990184,21278687232,2020-09-30,165,519,684
125,HLF,0.3327619344449639,0.08223772756249874,5302512128,2020-12-31,291,393,684
126,PINC,0.30809490168835557,0.08566473778504237,4185529856,2020-06-30,329,361,690
127,WIT,0.20359299468418263,0.9202607237490236,33470638080,2020-03-31,674,17,691
128,DLX,0.3452222030832831,0.07695858471855425,1780842624,2020-12-31,259,446,705
129,PBT,10.868140728435773,0.060655615354873016,181769472,2020-12-31,5,701,706
130,DISH,0.3179714149179607,0.08157619340072794,19800805376,2020-12-31,307,401,708
131,ENDP,0.40440099744089975,0.07092420112588291,1429106048,2020-12-31,195,514,709
132,GFI,0.22644355844275796,0.14369546361529267,8763827200,2020-12-31,576,141,717
133,DHT,0.21040910659738013,0.22015728190878853,1040998976,2020-12-31,643,76,719
134,OESX,0.593476636335663,0.0632876383552808,204861600,2020-03-31,84,640,724
135,HUM,0.3695249388571852,0.07260383909055113,53893054464,2020-12-31,228,496,724
136,SAMG,0.24386456366847328,0.11392027532264658,208800656,2020-12-31,511,214,725
137,MAS,0.47763457164518575,0.06506626341656437,15990874112,2020-12-31,128,601,729
138,TGS,0.1961002831504825,0.5045233503874649,694044736,2020-12-31,701,33,734
139,HMTV,0.37062896229562897,0.07157761872399236,509465728,2020-12-31,227,509,736
140,TSN,0.2768591977459776,0.08991316424503498,27923957760,2020-10-03,407,330,737
141,DHIL,0.25745854115518874,0.09656806380286238,524278944,2020-12-31,466,281,747
142,BKE,0.2939760300936051,0.08295312533757007,2137935360,2021-01-30,368,382,750
143,SUPN,0.2452187697995729,0.1035512837278485,1498252928,2020-12-31,506,247,753
144,STEP,0.2750166686705506,0.08771895002275024,1376831232,2020-03-31,414,340,754
145,MUSA,0.2400240281472582,0.10731478574508257,3894902016,2020-12-31,527,230,757
146,ITIC,0.21779862567684977,0.13322678554599077,314973216,2020-12-31,608,160,768
147,BHAT,0.2140447474405507,0.1454875533697858,64823704,2020-12-31,632,138,770
148,QFIN,0.18983549912083283,0.2916165641565508,4030968064,2020-12-31,721,51,772
149,JRSH,0.21918446610825337,0.1274496980209447,75424496,2020-03-31,602,171,773
150,JAZZ,0.3331234254186444,0.07265610892577516,9090919424,2020-12-31,289,494,783
151,NVR,0.426371535121191,0.06444376892756189,18126800896,2020-12-31,170,617,787
152,FOXA,0.24830946698488465,0.09257269677451734,21766395904,2020-06-30,495,310,805
153,FOX,0.24830946698488465,0.09255814957703477,21770635264,2020-06-30,495,311,806
154,TROW,0.3439821600831861,0.06882409159484316,40832360448,2020-12-31,263,544,807
155,KL,0.20695704421673836,0.13675608910946857,9815642112,2020-12-31,661,151,812
156,CDK,0.5330162283156128,0.05991375177349737,6580911616,2020-06-30,102,717,819
157,SJM,0.4209428860000652,0.06316079873801549,13886426112,2020-04-30,175,647,822
158,WINA,1.8026323457553872,0.05547698777876374,701900672,2020-12-26,13,818,831
159,PBFX,0.21440947646172837,0.11613551985755083,901806592,2020-12-31,631,203,834
160,SEE,0.33044304058796814,0.06851749492616778,7154028544,2020-12-31,293,547,840
161,HYW,0.17921798411178094,0.26281201770069434,210840000,2020-06-30,779,61,840
162,MOMO,0.17601893696712315,0.3560727855846778,3297554944,2020-12-31,800,41,841
163,ERIC,0.18142371148450862,0.21398678705876226,46386339840,2020-12-31,765,79,844
164,RIO,0.20802057440996236,0.12051599347567175,126743838720,2020-12-31,656,189,845
165,ATHM,0.18021874635579696,0.2217103355420799,11764367360,2020-12-31,773,74,847
166,STRL,0.2557352605313795,0.08401607266158564,610311232,2020-12-31,474,374,848
167,EGRX,0.36170656480841207,0.06469484536506684,549310976,2020-12-31,241,610,851
168,EVC,0.25696652012174503,0.08291580620898349,324114912,2020-12-31,468,383,851
169,SIM,0.16771012840721994,1.4947687101674774,2154622208,2020-12-31,846,11,857
170,PM,0.36425796425796425,0.06425456411914585,141933494272,2020-12-31,235,624,859
171,MIK,0.21817824618990164,0.10251493285622758,3112204032,2021-01-30,606,254,860
172,VYGR,0.17496645581751966,0.26963876912383233,179232096,2020-12-31,806,58,864
173,VRTX,0.6821609557418782,0.05587708953784164,55462469632,2020-12-31,60,805,865
174,KGC,0.1865922370617696,0.1647293505116717,9294288896,2020-12-31,742,124,866
175,VIPS,0.18479143990498706,0.17288817211902435,19321706496,2020-12-31,751,115,866
176,EPC,0.2840595697738555,0.07403067187967716,2094588032,2020-09-30,391,477,868
177,SGC,0.21768285257480466,0.09933375292017643,385784704,2020-12-31,610,263,873
178,ESCA,0.23441414205928482,0.09042870521161937,292642240,2020-12-26,550,327,877
179,LB,0.2640924464487035,0.07838315055638538,18619199488,2021-01-30,449,432,881
180,ASO,0.22053885389546177,0.09583782568059396,2815578112,2021-01-30,595,288,883
181,MTH,0.1903180310352114,0.12803072009868977,3599997184,2020-12-31,716,170,886
182,MHH,0.37635243706480986,0.062067960092346594,199244112,2020-12-31,219,671,890
183,BBY,0.2945798223639262,0.07014354618657398,30625511424,2021-01-30,367,525,892
184,SCU,0.1856689070954498,0.13879458896921196,1291317376,2020-12-31,746,147,893
185,MN,0.18131628808502298,0.16279243293139475,110216624,2020-12-31,767,126,893
186,STMP,0.6101283673727026,0.05559410103336458,3777730048,2020-12-31,80,814,894
187,VIAC,0.2333868545087274,0.08749561111451487,26480726016,2020-12-31,553,343,896
188,PDEX,0.3127380636017362,0.06611822406656162,104704552,2020-06-30,316,581,897
189,CURO,0.19813804727904688,0.11556456251060496,585618112,2020-12-31,689,208,897
190,WTM,0.17944370860927153,0.16537211403250088,3590916608,2020-12-31,776,122,898
191,JCTCF,0.20989571738608634,0.10258303648538337,37578256,2020-08-31,647,253,900
192,VIACA,0.2333868545087274,0.08671056831233055,26946983936,2020-12-31,553,349,902
193,AAN,0.17557765832674857,0.18132569911557586,843150784,2020-12-31,801,101,902
194,HESM,0.17116475164039072,0.2224289607349771,569338752,2020-12-31,829,73,902
195,SGRP,0.17942897218684828,0.15225974001892142,35918416,2020-12-31,777,131,908
196,MRK,0.30835802735639856,0.06607972780459045,193163509760,2020-12-31,327,582,909
197,MED,1.153749797619149,0.05304493520787376,2604850432,2020-12-31,24,887,911
198,MIXT,0.3117252410361221,0.06557921162421561,311374368,2020-03-31,319,594,913
199,MNSO,0.21293854728746575,0.09614276851626753,7505143296,2020-06-30,633,286,919
200,MEI,0.2558448018570718,0.07685691445726399,1744326784,2020-05-02,473,450,923
201,PHM,0.19650279883255406,0.1072888459044393,14429810688,2020-12-31,698,231,929
202,BGS,0.30062151898994427,0.06588042846278028,1911364736,2021-01-02,348,585,933
203,RVP,0.3383216101839518,0.062386246178378804,372789120,2020-12-31,273,667,940
204,HZO,0.2176177763503884,0.0893107150016075,1089524096,2020-09-30,611,334,945
205,LOW,0.3409717004758327,0.061701716202306,142382694400,2021-01-29,267,680,947
206,TG,0.21467958408049106,0.09067735461724913,510782208,2020-12-31,628,324,952
207,MOH,0.42077922077922075,0.05715369689755471,14068773888,2020-12-31,177,777,954
208,CAG,0.3342729232299784,0.06217174661006633,17681674240,2020-05-31,284,670,954
209,CWH,0.2048184381018245,0.09475080755711335,3388211456,2020-12-31,669,292,961
210,RDY,0.15636082858512168,0.36068104170120646,10648879104,2020-03-31,921,40,961
211,LMT,0.2759746315985824,0.06823793274401457,107646935040,2020-12-31,412,550,962
212,AYI,0.4063792728064446,0.05734215502864912,6076344832,2020-08-31,191,774,965
213,CBOE,0.4516761543327008,0.055248485489305665,10722141184,2020-12-31,141,825,966
214,PETS,0.9978739168250491,0.05128688508337711,683413568,2020-03-31,30,938,968
215,SBOW,0.16709754147240594,0.17144309317860587,94483432,2020-12-31,852,118,970
216,IMKTA,0.17266205768007042,0.1349660444165791,1256715392,2020-09-26,821,157,978
217,DKS,0.185169088977546,0.10600041225560644,7335351808,2021-01-30,748,237,985
218,RGP,0.23433942945527028,0.07797461485201199,464543616,2020-05-30,551,436,987
219,SFM,0.18273062296789075,0.10698995253972526,3078573312,2021-01-03,756,234,990
220,NGVT,0.25988650469941477,0.06936558871547822,3069838080,2020-12-31,458,534,992
221,VTRU,0.15615505240859445,0.23422389759182272,309209120,2020-12-31,923,69,992
222,GIS,0.3499809207425198,0.05837496744434954,36677558272,2020-05-31,251,743,994
223,BPMC,0.29989401459315107,0.06295705438375834,5457287680,2020-12-31,353,651,1004
224,ITRN,0.25179252296108007,0.07038655167997818,522092896,2020-12-31,483,522,1005
225,LAZY,0.1741346792879852,0.11838574567335305,211705632,2020-12-31,810,195,1005
226,ABBV,0.4268700546537238,0.054594808338690064,189789814784,2020-12-31,169,838,1007
227,TWNK,0.38460215170590484,0.056278012647176114,1914640000,2020-12-31,211,796,1007
228,WSM,0.2780179067613461,0.06497423376878131,13960081408,2021-01-31,404,605,1009
229,PKI,0.4075422213786011,0.05534073528876916,14947950592,2021-01-03,189,821,1010
230,ATKR,0.34817587753410917,0.05780633199174988,3347675136,2020-09-30,256,758,1014
231,ORCL,0.4373802311924337,0.05367570593356259,214434824192,2020-05-31,158,864,1022
232,HD,0.4805013278665611,0.05266632212128929,343242473472,2021-01-31,127,896,1023
233,MTR,0.2486110269270252,0.06952666634924162,9262029,2020-12-31,492,531,1023
234,VIVO,0.4332174584781769,0.05369319831818503,1080350848,2020-09-30,163,863,1026
235,ANTM,0.29150197628458496,0.06283255237422282,88413519872,2020-12-31,374,653,1027
236,NUS,0.2080402310409362,0.08407278501577638,2618017536,2020-12-31,655,373,1028
237,HOLX,0.4923423806687654,0.052020842994145826,18971652096,2020-09-26,113,916,1029
238,MLI,0.22676367870760764,0.07633586745012814,2513293312,2020-12-26,574,456,1030
239,UTMD,0.6462989156058463,0.05051762805776481,319149824,2020-12-31,65,969,1034
240,HBI,0.2631308900836936,0.06572768734495853,7105823232,2021-01-02,451,587,1038
241,DOOO,0.25021285291012496,0.06798614245981412,7555414016,2021-01-31,489,557,1046
242,LGIH,0.20946005301365694,0.08178245823446144,3930686464,2020-12-31,649,397,1046
243,WILC,0.14230914676797063,0.35414389132572155,324487808,2020-12-31,1013,42,1055
244,UFPI,0.24961053178201006,0.06727674691005296,4948267520,2020-12-26,491,566,1057
245,SPB,0.3095257074531686,0.05897599920634192,3858134272,2020-09-30,324,735,1059
246,SEIC,0.4401365784843571,0.052361535143808376,8999950336,2020-12-31,156,906,1062
247,MBT,0.1492311376532234,0.1863506648850018,7044141056,2020-12-31,965,98,1063
248,CRWS,0.187713807409564,0.08982820138793104,77356080,2020-03-29,733,332,1065
249,STX,0.31228861330326946,0.058190361181657865,18645192704,2020-07-03,318,748,1066
250,MSM,0.27262504151247746,0.06327155037136332,5034462208,2020-08-29,424,642,1066
251,DFIN,0.2764592687620269,0.06271722861536332,979022976,2020-12-31,409,658,1067
252,BC,0.3002084018865855,0.05937173165884127,7751975936,2020-12-31,351,727,1078
253,AZO,0.2965825966821025,0.0599243978290295,31699937280,2020-08-29,362,716,1078
254,INTC,0.2259957595032561,0.07218426383771995,277978611712,2020-12-26,578,500,1078
255,OXLCO,0.15851393452606868,0.12363098470597814,463695200,2020-03-31,903,178,1081
256,FORTY,0.19139039868279673,0.08497934091819771,1346468224,2020-12-31,713,369,1082
257,OXLCM,0.15851393452606868,0.1221782063699859,472199200,2020-03-31,903,181,1084
258,CSCO,0.31172328543363576,0.057637747653322524,219913043968,2020-07-25,320,766,1086
259,BXC,0.1564570510056063,0.12997456201674792,432310720,2021-01-02,920,166,1086
260,EURN,0.14870002470607044,0.17303566250883295,1772925056,2020-12-31,972,114,1086
261,SSD,0.33738412213944835,0.055603555034032866,4613219840,2020-12-31,275,813,1088
262,SNX,0.20826290358917948,0.07746182548247404,6143451648,2020-11-30,653,442,1095
263,VZ,0.19076289361288482,0.0829683282426227,238008614912,2020-12-31,715,381,1096
264,RLGY,0.21496311907270813,0.07365556667456138,1808296192,2020-12-31,625,482,1107
265,BRC,0.3582003642299744,0.053661912153302536,2861396992,2020-07-31,244,866,1110
266,AMOV,0.14362971320962528,0.1774668597617421,45913427968,2020-12-31,1004,107,1111
267,AMX,0.14362971320962528,0.1773718573817956,46412484608,2020-12-31,1004,108,1112
268,KMB,0.28274019954434754,0.05973624472723123,46202179584,2020-12-31,393,720,1113
269,AMEH,0.27911338862230606,0.06003330013294889,1189239424,2020-12-31,401,712,1113
270,ECPG,0.1555018857655528,0.12066571104577709,1217776512,2020-12-31,926,187,1113
271,DKL,0.23156011653156322,0.06770682028933578,1639115648,2020-12-31,557,562,1119
272,DHI,0.19766214025813308,0.07882188453308975,34162530304,2020-09-30,692,429,1121
273,NPK,0.19016937107663154,0.0813181436667075,722007488,2020-12-31,717,405,1122
274,GHLD,0.14899792959188396,0.1358947895745105,850200000,2020-12-31,968,154,1122
275,SNA,0.21961809720289785,0.07006371791496821,12824977408,2021-01-02,601,527,1128
276,VEON,0.1537767982368263,0.11962319024873175,3095960064,2020-12-31,938,192,1130
277,ATGE,0.19277073478690762,0.07888811508110026,1974045696,2020-06-30,707,427,1134
278,KOP,0.17028380634390652,0.09348876078117889,726264384,2020-12-31,831,305,1136
279,SAIC,0.35516969218626676,0.05295570482459628,4946668032,2021-01-29,246,891,1137
280,ZTO,0.13346875126854305,0.2469250170156533,24119488512,2020-12-31,1074,64,1138
281,LOMA,0.1296273308906649,0.49034863905248194,1209179776,2020-12-31,1103,35,1138
282,GWW,0.3116883116883117,0.05538569831500327,21021192192,2020-12-31,321,819,1140
283,CPB,0.27603164421637805,0.059297318308313335,14565642240,2020-08-02,411,729,1140
284,AMGN,0.38890973525119865,0.05135774569187004,143345909760,2020-12-31,209,933,1142
285,ORLY,0.3347580870919078,0.0537882438197573,36122116096,2020-12-31,282,860,1142
286,NEU,0.22663824150905884,0.06722761243241585,4232997120,2020-12-31,575,567,1142
287,MHO,0.1495921979853793,0.12175375492855484,1776273920,2020-12-31,962,182,1144
288,HCA,0.21444735588375416,0.07090499349684368,64314535936,2020-12-31,630,515,1145
289,AB,0.1920284327906089,0.07793095343199344,3957400576,2020-12-31,709,437,1146
290,DVA,0.187997061554784,0.07922981347709764,11866829824,2020-12-31,732,423,1155
291,LIVE,0.1455169907582246,0.12818787463976583,43545040,2020-09-30,990,168,1158
292,EXPD,0.41705891900665476,0.050185005517964724,18374150144,2020-12-31,182,977,1159
293,CL,0.48114285714285715,0.048309743222722745,67615383552,2020-12-31,125,1039,1164
294,FSI,0.17305823454144184,0.0870460656159511,43709376,2020-12-31,818,346,1164
295,PVAC,0.13977717346371024,0.14865355268576014,195284144,2020-12-31,1033,134,1167
296,WDR,0.18560337265112953,0.07939514856628575,1550724352,2020-12-31,747,421,1168
297,OXLC,0.15851393452606868,0.09834365943066842,647592000,2020-03-31,903,269,1172
298,NOMD,0.34511115127417313,0.05212548322656928,5031350784,2020-12-31,260,913,1173
299,OLLI,0.3745619061666643,0.05079801176348638,5812232192,2021-01-30,223,955,1178
300,MMM,0.34477379095163807,0.05198946101451631,114724569088,2020-12-31,262,917,1179
301,CACI,0.3008567995402539,0.054815412897414144,6341887488,2020-06-30,347,833,1180
302,CRI,0.23910929799879138,0.06307754473366617,4100123648,2021-01-02,533,648,1181
303,GSK,0.2258880545348032,0.06506237548636695,91988574208,2020-12-31,579,602,1181
304,AMG,0.19614526919401082,0.07373291825399177,6633308672,2020-12-31,700,481,1181
305,BABA,0.13778106405524052,0.1479502553030806,608164642816,2020-03-31,1045,136,1181
306,WLMS,0.23522033416954607,0.06360358523791695,100799776,2020-12-31,547,636,1183
307,EME,0.24083691140672436,0.06243076835374119,6411213824,2020-12-31,521,665,1186
308,GLDD,0.17390586371754627,0.0839433038516829,1008681600,2020-12-31,812,375,1187
309,FANH,0.12868441134587474,0.21265596426813443,737226816,2020-12-31,1107,80,1187
310,TPB,0.3345708494712127,0.052260977529296836,979531264,2020-12-31,283,907,1190
311,CTSH,0.30667352449530666,0.05388130503985476,42740961280,2020-12-31,335,856,1191
312,BEN,0.18842223230247884,0.0756065639836585,15505795072,2020-09-30,727,465,1192
313,KFRC,0.25117464036479986,0.060015675785403455,1222515456,2020-12-31,484,713,1197
314,GGB,0.1327380575536065,0.17169443642636528,8778137600,2020-12-31,1080,117,1197
315,HSY,0.45174357401693566,0.0477827085120591,33003102208,2020-12-31,140,1059,1199
316,SGU,0.14974004455419782,0.10589168982409032,444592832,2020-09-30,961,238,1199
317,UG,0.3218694963420481,0.052486489655066,68455368,2020-12-31,304,903,1207
318,BBL,0.16512071502534198,0.08812994978613876,149635891200,2020-06-30,870,338,1208
319,SIRI,0.3840759075907591,0.04915020111067063,26288873472,2020-12-31,213,1000,1213
320,WHR,0.18676659106596982,0.0747398950001424,14876218368,2020-12-31,739,474,1213
321,STRA,0.2706703252373478,0.05682892060331611,2230616832,2020-12-31,430,784,1214
322,IEA,0.16523572860080643,0.08687482288520172,313569440,2020-12-31,867,347,1214
323,TUP,0.15897097625329815,0.09164271320217111,1339500288,2020-12-26,898,319,1217
324,TPX,0.3263719034179994,0.05189661720281608,7854828544,2020-12-31,296,922,1218
325,WETF,0.4208794042256298,0.04813317854671709,985789248,2020-12-31,176,1043,1219
326,SMP,0.1588019166384238,0.0908274439349909,949742336,2020-12-31,901,323,1224
327,TNK,0.12093320626115155,0.2689713917673362,457151264,2020-12-31,1167,59,1226
328,PGTI,0.2991822271859807,0.05362028028554198,1536154368,2021-01-02,358,869,1227
329,GOLD,0.1376829990691377,0.12238250357362727,37560152064,2020-12-31,1048,180,1228
330,IMOS,0.11729106377500242,0.3610827746678422,1252587776,2020-12-31,1196,39,1235
331,JOAN,0.14020781270551097,0.1153389998006215,480964096,2021-01-30,1027,209,1236
332,APR,0.2055669959510948,0.0669729322087248,1084847872,2020-12-31,666,571,1237
333,DLHC,0.24095437421515278,0.05977805282540545,133592528,2020-09-30,519,719,1238
334,JBSS,0.21480978885873314,0.06457324084760996,1031710720,2020-06-25,626,612,1238
335,CNC,0.2150706436420722,0.06449331183002917,36413538304,2020-12-31,624,615,1239
336,CLX,0.4896686159844055,0.04610249582515179,23916644352,2020-06-30,115,1126,1241
337,UHS,0.16699219001931764,0.08242132132385224,11762944000,2020-12-31,853,390,1243
338,VOC,0.20777656908247713,0.06570246255921552,58820000,2020-12-31,658,588,1246
339,GPI,0.1574062950504565,0.08820099328919317,2966909952,2020-12-31,909,337,1246
340,TGI,0.19668191027090753,0.06823368226439919,1005003392,2020-03-31,697,551,1248
341,CIG,0.12453700746344258,0.17524139876063227,3637656064,2020-12-31,1136,112,1248
342,CRCT,0.9769351074558946,0.043106198457605514,4427319808,2020-12-31,32,1217,1249
343,REZI,0.2622088655146506,0.05635867554588115,4016480512,2020-12-31,455,794,1249
344,LZB,0.17422305541639058,0.07759391407744791,1995387648,2020-04-25,809,440,1249
345,LSXMB,0.27352161023560617,0.05489072791009485,16411176960,2020-12-31,419,831,1250
346,REGN,0.22732698132343504,0.06171598258914619,50905915392,2020-12-31,572,679,1251
347,FRO,0.13006981178621388,0.13627024218126055,1456990080,2020-12-31,1099,152,1251
348,DG,0.22941559228820685,0.06142935884216916,49446297600,2021-01-29,564,689,1253
349,CMCO,0.24089848186469112,0.058887961965137806,1275544832,2020-03-31,520,736,1256
350,BIG,0.12837044388471547,0.1392905044539697,2361028352,2021-01-30,1111,145,1256
351,DOX,0.2565507448175074,0.05655624540105252,9639186432,2020-09-30,469,788,1257
352,HMPT,0.13625787691688546,0.11658310940899244,1355273600,2020-12-31,1056,201,1257
353,SWK,0.34723845963084987,0.049086205725446364,32513163264,2021-01-02,257,1003,1260
354,BGFV,0.13038417400854938,0.13050709632085147,372663744,2021-01-03,1095,165,1260
355,BLD,0.6445074564167191,0.04394010654147434,7250842624,2020-12-31,68,1196,1264
356,PVG,0.15502755078162814,0.08900645571739448,2132381440,2020-12-31,930,335,1265
357,MBUU,0.3757672861322015,0.048104426372680184,1728577536,2020-06-30,221,1046,1267
358,TIG,0.1658678569163933,0.08119034960579076,824007168,2020-12-31,860,407,1267
359,CRTO,0.2270453133792938,0.06096311083147197,2183764736,2020-12-31,573,695,1268
360,OMC,0.2814153546502191,0.053458036168523536,16701016064,2020-12-31,395,875,1270
361,UL,0.3251789561470568,0.05025332122913329,149719547904,2020-12-31,298,973,1271
362,FBHS,0.3410143769968051,0.04897194118614916,13938315264,2020-12-31,266,1007,1273
363,FKWL,2.0319829314127347,0.041929059063888136,153501744,2020-06-30,10,1265,1275
364,CW,0.2462298067796044,0.057402550438974284,5108724736,2020-12-31,503,772,1275
365,LU,0.11939584356726798,0.1890410461300859,35998822400,2020-12-31,1180,95,1275
366,RCKY,0.18963832516834064,0.06816133800412631,406921056,2020-12-31,723,553,1276
367,FLO,0.23828693263731746,0.05866782033255774,5055395840,2021-01-02,538,740,1278
368,BAH,0.3824734522572418,0.04759152581046068,11327695872,2020-03-31,214,1066,1280
369,TIMB,0.11375069781638694,0.2669859506770282,5286912512,2020-12-31,1223,60,1283
370,HI,0.2500190099612197,0.0561728715721742,3787159296,2020-09-30,490,799,1289
371,EVTC,0.6924090243532172,0.04272241417173593,2852588800,2020-12-31,57,1235,1292
372,MTSC,0.2303604165252119,0.05927751321619583,1139075200,2020-10-03,562,730,1292
373,CCU,0.11052224566289054,0.3306121572602517,3375630848,2020-12-31,1248,45,1293
374,BRFS,0.13269147829453679,0.11402187107144535,3397267200,2020-12-31,1081,213,1294
375,KMDA,0.15656894502954438,0.08361250821216785,275267232,2020-12-31,918,377,1295
376,LHX,0.34067253803042435,0.04848597978086829,42782396416,2021-01-01,269,1028,1297
377,GNTX,0.36338161407166814,0.04775647834896634,8625776640,2020-12-31,238,1060,1298
378,TARO,0.13966896639242937,0.0987827554016511,2786352128,2020-03-31,1034,266,1300
379,TGLS,0.16770020924481643,0.07569869205849006,626446912,2020-12-31,847,464,1311
380,LSXMA,0.27352161023560617,0.05281701021413126,17665064960,2020-12-31,419,893,1312
381,SPGI,0.8129072945133488,0.04180539635193838,88911020032,2020-12-31,42,1273,1315
382,LSXMK,0.27352161023560617,0.05264222570356829,17775263744,2020-12-31,419,897,1316
383,LEGH,0.14526737290592734,0.09043068450888879,454524832,2020-12-31,991,326,1317
384,SWM,0.19433911159263273,0.06453436142192538,1516121600,2020-12-31,704,614,1318
385,AMWD,0.2485196203162027,0.05518951199687713,1746182912,2020-04-30,494,826,1320
386,FHS,0.12048684973892863,0.13736197867390723,212754560,2020-12-31,1172,149,1321
387,ABM,0.2304097471417842,0.05767606654390069,3575880960,2020-10-31,560,762,1322
388,MODV,0.26639314598309355,0.053212108861018646,2000860544,2020-12-31,441,882,1323
389,COKE,0.17329943395476058,0.07172490746252244,2841634048,2020-12-31,817,507,1324
390,FMC,0.2461583723719646,0.05527192964141194,14489466880,2020-12-31,504,824,1328
391,HII,0.165607476635514,0.07548866982068576,8336860672,2020-12-31,863,466,1329
392,MGIC,0.27443698143026474,0.05205397834182794,790576448,2020-12-31,416,915,1331
393,SYX,0.3820990458882326,0.046214196339939395,1655787136,2020-12-31,215,1117,1332
394,TSCO,0.25407272083330484,0.05390774833092154,20647755776,2020-12-26,478,854,1332
395,CHT,0.10449335353866397,0.4463440660819356,30338476032,2020-12-31,1295,37,1332
396,ALLE,0.5394823529411765,0.042715435330880534,11948536832,2020-12-31,100,1236,1336
397,CRSR,0.5173608558488009,0.042846226186267024,3080487936,2020-12-31,107,1231,1338
398,BHP,0.16512071502534198,0.07494364921466447,179880542208,2020-06-30,870,472,1342
399,SSP,0.16778766079218324,0.07223969952749516,1702294656,2020-12-31,845,498,1343
400,MMC,0.3778212923837988,0.04608454969545805,64286437376,2020-12-31,218,1128,1346
401,VIV,0.10592845727653309,0.2427244479804797,13161795584,2020-12-31,1284,65,1349
402,IRBT,0.3331562541159942,0.04754520503082867,3317103872,2021-01-02,288,1067,1355
403,SLGN,0.18861465458803228,0.06400596354240616,4634500096,2020-12-31,726,629,1355
404,HBB,0.16804721792246402,0.07066297391303629,246540944,2020-12-31,843,518,1361
405,OMP,0.12830094268150788,0.10324710967280239,741891328,2020-12-31,1112,250,1362
406,TPH,0.12390900012838083,0.10928978561974831,2608125184,2020-12-31,1139,224,1363
407,CMC,0.1377189310739002,0.09164585004792875,3570711296,2020-08-31,1047,318,1365
408,SBH,0.17763534845461096,0.06636614461155295,2293508608,2020-09-30,790,578,1368
409,PATK,0.22791906298031714,0.05570041141024407,2072107520,2020-12-31,567,809,1376
410,BKEP,0.15373554582568533,0.07789281319221789,139747488,2020-12-31,939,438,1377
411,SMTS,0.14064214602084388,0.08579790735796139,502016800,2020-12-31,1021,358,1379
412,MD,0.2533814552710617,0.05251959209609357,2219513600,2020-12-31,479,901,1380
413,NTES,0.1140761898967421,0.1338432889332646,70996320256,2020-12-31,1221,159,1380
414,ASGN,0.36198250728862974,0.04578920748568384,5603689984,2020-12-31,240,1142,1382
415,DMLP,0.3028059907040799,0.04816376402636143,484130016,2020-12-31,340,1042,1382
416,NOC,0.21737342585453612,0.057417866013043266,54719033344,2020-12-31,613,771,1384
417,BJ,0.16367384065042306,0.07181052102875227,6086504960,2021-01-30,879,505,1384
418,PII,0.2415567443949851,0.05365966935433916,8474576384,2020-12-31,518,867,1385
419,TAP,0.1844461603066878,0.06387944700786269,10853550080,2020-12-31,753,632,1385
420,DOOR,0.182385320564326,0.0641022885634018,3078089728,2021-01-03,759,627,1386
421,ENIC,0.10415552787508117,0.1979604064182713,5307770880,2020-12-31,1298,91,1389
422,TME,0.1199953035106258,0.11390002466570788,32242124800,2020-12-31,1175,215,1390
423,CCF,0.4057240112867828,0.04379057853142644,1110234240,2020-08-31,193,1200,1393
424,MCFT,0.3045540889386781,0.04797067239047951,512957536,2020-06-30,339,1054,1393
425,FCN,0.24760637695884755,0.05281143475912527,4931360256,2020-12-31,499,894,1393
426,QSR,0.30518234165067176,0.04788108789855885,20339265536,2020-12-31,338,1056,1394
427,CPRI,0.19008729935229512,0.061890350160175384,8085385216,2020-03-28,718,676,1394
428,ELA,0.2662556343417857,0.050861192954506466,123314664,2020-12-31,443,953,1396
429,INGR,0.15371939736346515,0.07576794790407357,6077420032,2020-12-31,941,462,1403
430,LEU,0.1405176967776017,0.08333322472862943,316300832,2020-12-31,1024,379,1403
431,CHE,0.4878708832962166,0.04140549212145217,7461230592,2020-12-31,117,1289,1406
432,HPQ,0.2104782865424875,0.05766442166534311,41112866816,2020-10-31,642,764,1406
433,ENR,0.22051490790678743,0.055612735587661104,3341778944,2020-09-30,596,812,1408
434,UCTT,0.27442688626752726,0.049354742580072844,2235740160,2020-12-25,417,993,1410
435,MMS,0.3174809120588962,0.04657851963368052,5780836864,2020-09-30,309,1105,1414
436,DLTR,0.1700700981999282,0.06606437597392965,27438639104,2021-01-30,834,584,1418
437,HOLI,0.1106371297765802,0.12583378173118995,781683776,2020-06-30,1247,173,1420
438,RRD,0.14208702348864075,0.0808428572597032,285646400,2020-12-31,1014,411,1425
439,CIEN,0.21465505172604732,0.056269020201118874,8751469568,2020-10-31,629,797,1426
440,MLHR,0.19595917946603442,0.05947346333985891,2572183552,2020-05-30,702,725,1427
441,PRGS,0.33416348710174704,0.04577636356611824,2026156288,2020-11-30,285,1145,1430
442,JOUT,0.25747574503851084,0.050563816650623414,1512380544,2020-10-02,465,965,1430
443,OCCIP,0.11535257907923355,0.11155622678820923,44831364,2020-10-31,1211,219,1430
444,TKR,0.18981750552132978,0.06010763443547634,6191678976,2020-12-31,722,709,1431
445,FRA,0.11264882841153567,0.11663737668689099,461829760,2020-12-31,1231,200,1431
446,VMD,0.24277570504947513,0.05183970408403545,405923264,2020-12-31,513,923,1436
447,FSS,0.2563471011746874,0.050518461448629495,2399128832,2020-12-31,470,968,1438
448,MDP,0.17017673827918298,0.06480661618676206,1381356288,2020-06-30,832,608,1440
449,CSGS,0.17517079335508534,0.06354753432643255,1538551168,2020-12-31,804,637,1441
450,TAYD,0.11569720785043255,0.10707263674391913,40466716,2020-05-31,1210,232,1442
451,KDP,0.4019185319060197,0.042453719725480926,49493684224,2020-12-31,197,1247,1444
452,HCSG,0.22359788702972772,0.05387568815426408,2152596736,2020-12-31,587,857,1444
453,MDC,0.13698951024296033,0.08157264638117169,4317892608,2020-12-31,1052,402,1454
454,K,0.20631742853965077,0.05638701451170807,21326645248,2021-01-02,662,793,1455
455,BERY,0.1776444320401898,0.06221306416030316,8429940224,2020-09-26,789,668,1457
456,GCI,0.13322108679489703,0.08304926818970045,721586496,2020-12-31,1077,380,1457
457,ZEPP,0.10208009076077784,0.1391126232913535,675869056,2020-12-31,1311,146,1457
458,FMX,0.09934105431309904,0.16767509968587507,28908521472,2020-12-31,1336,121,1457
459,LDOS,0.27101335428122547,0.04847119247575252,14227889152,2021-01-01,428,1030,1458
460,RCII,0.15107880605411583,0.0716381802696431,3163068416,2020-12-31,953,508,1461
461,INSW,0.09950403623418515,0.15409536291187248,537270464,2020-12-31,1333,129,1462
462,SJT,1.3711770618349954,0.03809097559058022,195756944,2020-12-31,16,1448,1464
463,LEN,0.13645527360037357,0.08103470094543348,32305367040,2020-11-30,1055,409,1464
464,CORT,0.2643411060502653,0.04871007401627247,2660636160,2020-12-31,448,1019,1467
465,BZUN,0.09680502540478451,0.17657563091954587,2784502016,2020-12-31,1358,109,1467
466,VIOT,0.1147459393517557,0.10247413754640948,665390592,2020-12-31,1217,255,1472
467,HUBB,0.32459093862602634,0.04465062030296114,10181159936,2020-12-31,300,1173,1473
468,CSL,0.2761528608027327,0.04761809566032848,9041417216,2020-12-31,410,1064,1474
469,MLR,0.1585485935602455,0.06685197925522397,524892192,2020-12-31,902,573,1475
470,WMK,0.11712939734112005,0.09700991816162499,1472418432,2020-12-26,1199,277,1476
471,NMIH,0.11915575502214158,0.09443266360097731,1982828416,2020-12-31,1183,294,1477
472,PBR,0.09262032578393199,0.2072485500854317,54221987840,2020-12-31,1392,86,1478
473,LPG,0.10004167352583185,0.13871478642061003,533455936,2020-03-31,1331,148,1479
474,LOPE,0.22043862548547238,0.05320686889387331,5266728960,2020-12-31,597,883,1480
475,LKQ,0.18467317608799014,0.05932812500016175,13330454528,2020-12-31,752,728,1480
476,FONR,0.10233281190580439,0.1274086862552015,124416240,2020-06-30,1308,172,1480
477,ATVI,0.5686708224411824,0.03913431915583027,74205937664,2020-12-31,88,1393,1481
478,TER,0.4401433530884531,0.0404086514401473,22163136512,2020-12-31,155,1328,1483
479,EMR,0.3184257602862254,0.044525906419080004,55166763008,2020-09-30,306,1177,1483
480,FIZZ,0.6499868626935792,0.03848091613088764,4470055936,2020-05-02,64,1421,1485
481,UNH,0.24794440202295187,0.049803220068709936,355723509760,2020-12-31,497,989,1486
482,FMS,0.15170025802652237,0.0692329728247915,22025177088,2020-12-31,950,537,1487
483,EHC,0.19297566206917097,0.05656628569736049,8104051200,2020-12-31,706,787,1493
484,TEVA,0.15669881001231023,0.06632469833413492,12343272448,2020-12-31,916,579,1495
485,MPX,0.31233252560995933,0.04435008564167024,559199680,2020-12-31,317,1182,1499
486,CENT,0.18738257650687765,0.057670639387026774,2951484672,2020-09-26,737,763,1500
487,CHRW,0.3292824402392192,0.043523624277120726,12779787264,2020-12-31,294,1208,1502
488,FTDR,0.48314606741573035,0.03924455870214379,4671466496,2020-12-31,122,1383,1505
489,SCCO,0.22447291680035364,0.05193660918178801,54872727552,2020-12-31,585,920,1505
490,CENTA,0.18738257650687765,0.0575053628063494,2961351168,2020-09-26,737,769,1506
491,CI,0.16536588991712195,0.06318530361383631,85490712576,2020-12-31,866,644,1510
492,AUY,0.09699706602128148,0.13584424415720234,4496648192,2020-12-31,1355,155,1510
493,FIX,0.2358838819869969,0.050551107043648895,2869124608,2020-12-31,545,966,1511
494,ABG,0.15687864396308737,0.06523644186163753,3836514048,2020-12-31,913,599,1512
495,PLPC,0.1149141236795322,0.09427081449058054,322904768,2020-12-31,1216,296,1512
496,LEE,0.14883381217018202,0.06883377283175224,167420064,2020-09-27,971,543,1514
497,TV,0.09897006387009825,0.12494419580923405,5500077056,2020-12-31,1340,175,1515
498,NVT,0.308816758747698,0.044165152266695866,4819425280,2020-12-31,326,1190,1516
499,AM,0.13390635077157786,0.07706196211865565,4068016640,2020-12-31,1072,444,1516
500,USDP,0.151194051611022,0.06729760739069042,171523008,2020-12-31,952,565,1517
501,BCE,0.13957831488348174,0.07364713165043418,41672093696,2020-12-31,1037,483,1520
502,LXFR,0.17139334155363747,0.06105300855873577,565713024,2020-12-31,828,693,1521
503,PG,0.32392588883324985,0.04299458799005933,335808364544,2020-06-30,302,1220,1522
504,SYKE,0.16628241921485734,0.062434206930695964,1745397248,2020-12-31,858,664,1522
505,HOME,0.10853505027596871,0.10039672995056169,1879598848,2021-01-30,1264,260,1524
506,POST,0.23632733179910653,0.05012670768305376,6833897472,2020-09-30,544,981,1525
507,LND,0.08957957903395511,0.18689488761067163,344651456,2020-06-30,1429,97,1526
508,CHD,0.5308032675289313,0.038433122298555264,21271187456,2020-12-31,103,1424,1527
509,AIT,0.2424636556918515,0.04875297230152276,3686710272,2020-06-30,514,1014,1528
510,SIMO,0.2897502284495888,0.04559543928972252,2437402880,2020-12-31,378,1151,1529
511,BRO,0.4407192188959228,0.0393304022458256,13559136256,2020-12-31,152,1378,1530
512,WTS,0.29218045112781954,0.045299500733569344,3997130496,2020-12-31,373,1159,1532
513,MCO,0.6591952470969484,0.03763062704612935,58819375104,2020-12-31,63,1470,1533
514,FLNT,0.26356152024359986,0.04711893708871867,334370144,2020-12-31,450,1083,1533
515,BKCC,0.10232857562248451,0.10918648247273512,282794464,2020-12-31,1309,225,1534
516,PNR,0.41253581040020837,0.04012057678746085,10314296320,2020-12-31,185,1350,1535
517,SMPL,0.747330558320514,0.0369935641814307,3000113664,2020-08-29,49,1487,1536
518,SON,0.18182606446509147,0.057239417995319126,6451285504,2020-12-31,763,775,1538
519,TX,0.10408045467126337,0.1055608246725767,7569636864,2020-12-31,1299,239,1538
520,CROX,0.30050867369292766,0.044043383793815276,5332697088,2020-12-31,349,1192,1541
521,OC,0.16663481750429965,0.061482593377574266,10392876032,2020-12-31,856,685,1541
522,ZUMZ,0.13085407952750638,0.07681682412547634,1202593408,2021-01-30,1090,451,1541
523,FRTA,0.17728080735984025,0.05818697542481133,1557018496,2020-12-31,794,749,1543
524,ELP,0.11336557606460297,0.09194400482062139,30375706624,2020-12-31,1227,316,1543
525,RCI,0.13987772622815767,0.0712278322576676,24438284288,2020-12-31,1032,512,1544
526,BUD,0.22478503909224284,0.050650681689145986,128229130240,2020-12-31,583,962,1545
527,HRL,0.2965141520773235,0.044335775926791936,25035857920,2020-10-25,364,1183,1547
528,FDS,0.724539520412384,0.036729814838445396,11701251072,2020-08-31,52,1498,1550
529,AIMC,0.3164057181756297,0.04261508181573472,3939268352,2020-12-31,311,1240,1551
530,GRBK,0.12979773089783742,0.07664202423557606,1293398400,2020-12-31,1101,452,1553
531,COLL,0.21670700312928737,0.05129563438684476,821304640,2020-12-31,619,935,1554
532,WIRE,0.13422285836183345,0.07314178556618488,1422927488,2020-12-31,1068,486,1554
533,UTHR,0.15912334078242374,0.06258518574469839,9058529280,2020-12-31,897,660,1557
534,ISDR,0.4356038923869491,0.039055463376906775,92917440,2020-12-31,159,1399,1558
535,CHKP,0.19980995735089385,0.05351364935309311,15608523776,2020-12-31,688,870,1558
536,CCS,0.11874309604255973,0.08420953508247152,2212950016,2020-12-31,1187,371,1558
537,RS,0.16381343858747693,0.06163645758721643,9811228672,2020-12-31,878,682,1560
538,PLUS,0.1655867702186918,0.06079483203150329,1293625728,2020-03-31,864,698,1562
539,DPZ,0.6009552117176171,0.03720086426804532,15145736192,2021-01-03,82,1481,1563
540,BGSF,0.17759358891243993,0.057375793425923645,148321600,2020-12-27,791,773,1564
541,NRG,0.13119437424458852,0.07381868908897238,9476765696,2020-12-31,1085,479,1564
542,ESGRO,0.07977745637783319,0.2978387429538076,3915374080,2020-12-31,1517,48,1565
543,DOV,0.3742674730850448,0.04020850584433274,20134225920,2020-12-31,224,1345,1569
544,ESGRP,0.07977745637783319,0.2912011343835176,4038635520,2020-12-31,1517,52,1569
545,EBAY,0.21122599704579026,0.051436448776579984,42507464704,2020-12-31,639,931,1570
546,KFY,0.16926671271642837,0.05911430214716085,3563368960,2020-04-30,839,732,1571
547,PGR,0.12207982714360759,0.0802274170434204,55987441664,2020-12-31,1161,414,1575
548,NODK,0.09723337039846242,0.10854512360703371,399518048,2020-12-31,1352,226,1578
549,WES,0.1186839738154378,0.08233346495509151,7740782080,2020-12-31,1188,391,1579
550,TDG,0.6214116852414725,0.0366513429972501,33646798848,2020-09-30,77,1503,1580
551,GD,0.18029278315212738,0.05577220292203395,52386492416,2020-12-31,772,808,1580
552,GEF,0.14614423288980372,0.06543285009975468,2838358528,2020-10-31,985,595,1580
553,ASX,0.09242260079200068,0.12058312444365395,17356972032,2020-12-31,1399,188,1587
554,MWA,0.2183248647762662,0.04995235655237271,2275140864,2020-09-30,605,984,1589
555,ESGR,0.07977745637783319,0.22802127908810932,5571133952,2020-12-31,1517,72,1589
556,UMC,0.07487995397718536,0.6444288163611409,23418501120,2020-12-31,1565,25,1590
557,ELMD,0.19459918449026756,0.05304093554418169,86782152,2020-06-30,703,888,1591
558,HUYA,0.08015669650335269,0.2108717050166041,4346678784,2020-12-31,1509,82,1591
559,AEIS,0.2999616978412059,0.04260431163421294,4545601536,2020-12-31,352,1241,1593
560,SUZ,0.10737239845597144,0.09113753613908894,16883063808,2020-12-31,1272,321,1593
561,OTIS,0.25974930362116994,0.04598133655054405,30406934528,2020-12-31,459,1135,1594
562,AOS,0.39350985111883746,0.03910157455602354,10868947968,2020-12-31,201,1394,1595
563,CARG,0.4189462756293797,0.038553583797081376,2845248000,2020-12-31,179,1417,1596
564,IBP,0.3543889664280462,0.03993101367936258,3592677376,2020-12-31,247,1353,1600
565,TSQ,0.16833958922019315,0.05779053606718432,164729024,2020-12-31,842,759,1601
566,BUR,0.10423652761156882,0.09350506468467594,2137928064,2020-12-31,1297,304,1601
567,LPLA,0.21052501372167495,0.050679035982493646,11706992640,2020-12-31,641,961,1602
568,TMO,0.44193874116459103,0.037995567910202865,188207972352,2020-12-31,150,1453,1603
569,SII,0.31022128556375134,0.04156816656208539,1006810688,2020-12-31,323,1283,1606
570,NRC,0.8365474703310432,0.03541364733193789,1186673408,2020-12-31,40,1567,1607
571,CDW,0.42340736515632243,0.03831546030569258,24653531136,2020-12-31,173,1434,1607
572,JOBS,0.07811568153129275,0.22989423042907092,4254037248,2020-12-31,1537,71,1608
573,SUN,0.15651849084796413,0.06120439956131678,3285913088,2020-12-31,919,690,1609
574,CLW,0.09705526935063283,0.10196340628229286,590415360,2020-12-31,1353,256,1609
575,FLIR,0.29935345748938985,0.0422961053208703,7576369664,2020-12-31,357,1254,1611
576,AN,0.12378637688167254,0.0750802856463056,7674996736,2020-12-31,1140,471,1611
577,GMS,0.1763625029746674,0.05554020710282638,1812411136,2020-04-30,797,816,1613
578,HEP,0.13398989151094348,0.06864419830666146,2056080000,2020-12-31,1071,546,1617
579,BIOX,0.23695438164501886,0.047200814901206575,589159936,2020-06-30,542,1077,1619
580,STN,0.17251908396946564,0.056186293436640236,4901616640,2020-12-31,823,798,1621
581,SUMR,0.16141093269955364,0.058989639771063,26900408,2021-01-02,887,734,1621
582,FERG,0.24855861627162076,0.046055153954507565,28429725696,2020-07-31,493,1129,1622
583,AAWW,0.08763762228550698,0.12437868383013753,1779697792,2020-12-31,1450,177,1627
584,LL,0.14348930030577292,0.06431219886941386,773069440,2020-12-31,1006,623,1629
585,YUM,0.3762545376895153,0.03863521952356669,34327056384,2020-12-31,220,1412,1632
586,PFMT,0.12976476092821376,0.06936638619551122,126746224,2020-12-31,1102,533,1635
587,BAK,0.09753512744074613,0.09578524920682906,5896358400,2020-12-31,1349,289,1638
588,APEI,0.1779000458505273,0.054010829702858434,645555136,2020-12-31,787,853,1640
589,BIPC,0.10932395074139231,0.08274268623891207,3337524480,2020-12-31,1258,385,1643
590,YNDX,0.07175535438286597,0.46889099049113425,22056110080,2020-12-31,1607,36,1643
591,MKSI,0.2914150532279151,0.041892860549006115,10579141632,2020-12-31,375,1269,1644
592,SJR,0.14686014510883164,0.06241214751286244,13338440704,2020-08-31,979,666,1645
593,ATUS,0.20624390601558676,0.05004165208123883,15594863616,2020-12-31,663,983,1646
594,PKG,0.1728002608305824,0.055130877895569926,13094179840,2020-12-31,820,827,1647
595,JNJ,0.2993866866118175,0.04120926519292759,424524480512,2021-01-03,356,1293,1649
596,RTLR,0.10469875186770472,0.0862346309328238,1571972224,2020-12-31,1294,356,1650
597,AVY,0.26609808102345417,0.04345136849305173,16365635584,2021-01-02,444,1210,1654
598,RBC,0.21292460646230324,0.048653083436417874,5817285120,2021-01-02,634,1021,1655
599,NTAP,0.2016897746967071,0.050189327209789476,16445760512,2020-04-24,680,975,1655
600,VSEC,0.1499124007664933,0.06080855328804438,531016544,2020-12-31,960,697,1657
601,CP,0.15291556783456822,0.060011160634164444,49916010496,2020-12-31,944,714,1658
602,OCCI,0.11535257907923355,0.0769248282468042,72033896,2020-10-31,1211,448,1659
603,TGT,0.17816122944189808,0.05338513237144751,102395781120,2021-01-30,785,877,1662
604,LCII,0.19228581773641937,0.050762270875017834,3424027136,2020-12-31,708,957,1665
605,VST,0.09891039881519094,0.09067381189493316,8425374720,2020-12-31,1342,325,1667
606,MTG,0.09064189547780348,0.10348179666149618,4858045440,2020-12-31,1422,248,1670
607,ITW,0.4110464290785177,0.03699446866126472,70457942016,2020-12-31,186,1486,1672
608,SNY,0.19699166364624865,0.05017418436345805,126541692928,2020-12-31,694,979,1673
609,ABC,0.43309482138204275,0.036413209934693956,23911706624,2020-09-30,164,1510,1674
610,BWXT,0.22745877152930552,0.046638725399990866,6404845056,2020-12-31,571,1103,1674
611,ENIA,0.1004539930877907,0.08661992769543171,12889193472,2020-12-31,1324,350,1674
612,GLP,0.09975843208519,0.08759017555878103,738764864,2020-12-31,1332,342,1674
613,URI,0.1654594641766297,0.055638203824945186,23486304256,2020-12-31,865,810,1675
614,DXC,0.1066289825282631,0.08185632206585229,8004435456,2020-03-31,1280,395,1675
615,GFF,0.14369325001034639,0.061922417220375725,1550696576,2020-09-30,1002,675,1677
616,LEG,0.23097872340425532,0.046188327461787526,6310215168,2020-12-31,558,1120,1678
617,HWKN,0.1823369811369587,0.051932177252212934,706271488,2020-03-29,760,921,1681
618,WVVIP,0.07968766561690954,0.1309552727912705,39501292,2020-12-31,1520,163,1683
619,HRC,0.2987404781657742,0.04039230076091891,7494924288,2020-09-30,359,1329,1688
620,GFNCP,0.09821221646641011,0.08715787766605108,250662256,2020-06-30,1344,345,1689
621,CSAN,0.09705499252590458,0.08886132304368742,5959325184,2020-12-31,1354,336,1690
622,QD,0.0656179769213557,1.8849845131031273,553107456,2020-12-31,1682,9,1691
623,RLGT,0.2571967970835232,0.042921435304616604,353270240,2020-06-30,467,1225,1692
624,HCKT,0.350758035172832,0.0381447525904666,537603200,2021-01-01,250,1446,1696
625,ELTK,0.11675009626492107,0.07260489803370036,36794268,2020-12-31,1202,495,1697
626,NAT,0.08902554907326932,0.09979832989589127,497464416,2020-12-31,1435,262,1697
627,NLSN,0.2559195588712293,0.04292069245136633,9148741632,2020-12-31,472,1226,1698
628,BLDR,0.24232451596719007,0.04433175296006623,10031563776,2020-12-31,515,1184,1699
629,STLD,0.1365574974872693,0.06316774505785683,10812300288,2020-12-31,1054,645,1699
630,KNX,0.14428034086963004,0.06038997344051588,8295702016,2020-12-31,999,704,1703
631,LMB,0.12666405782762466,0.06676295996118463,116216856,2020-12-31,1127,576,1703
632,PHI,0.08059343296607396,0.11781413240835842,5603672576,2020-12-31,1506,198,1704
633,WWE,0.20824280064560582,0.04797982224860599,4542456832,2020-12-31,654,1053,1707
634,TPVG,0.09639177532323077,0.08746141124887948,481141568,2020-12-31,1363,344,1707
635,FAST,0.32471526195899775,0.03867924612672677,28751511552,2020-12-31,299,1410,1709
636,LANC,0.3934830911434031,0.03647506639096052,4927138816,2020-06-30,202,1508,1710
637,FCFS,0.1582590814519985,0.055887978017638326,2749559296,2020-12-31,907,804,1711
638,CAH,0.3071477900552486,0.0393281602857825,17634762752,2020-06-30,333,1379,1712
639,MYE,0.21878908918904713,0.0465511902827031,742734848,2020-12-31,604,1108,1712
640,VEC,0.20776226854172022,0.04794277728700553,603451648,2020-12-31,659,1055,1714
641,MPLX,0.11978253871740763,0.06910048665612878,27028649984,2020-12-31,1177,538,1715
642,APH,0.40321472392638036,0.03629517592932115,41031979008,2020-12-31,196,1523,1719
643,NVEC,0.21776494348146283,0.04648219025519661,341048544,2020-03-31,609,1110,1719
644,AIN,0.16609838784419892,0.05378798362361867,2805037056,2020-12-31,859,861,1720
645,PH,0.3172259930855342,0.038587978320903916,41446617088,2020-06-30,310,1416,1726
646,MANT,0.2687334953710766,0.04134304036251025,3512342272,2020-12-31,437,1290,1727
647,LUMN,0.10814635132403477,0.07575831872057523,14062515200,2020-12-31,1267,463,1730
648,HMLP,0.08924406300602968,0.09373980089193486,502956864,2020-12-31,1431,302,1733
649,DECK,0.3748134213013257,0.03639912830617035,9645373440,2020-03-31,222,1513,1735
650,SMG,0.3461934156378601,0.03730319572975985,13869514752,2020-09-30,258,1477,1735
651,THS,0.17332470435959288,0.05194253192802001,2849052672,2020-12-31,816,919,1735
652,SPH,0.14558978141133272,0.05821208688818155,939188608,2020-09-26,989,747,1736
653,WVVI,0.07968766561690954,0.11235942360279479,45822608,2020-12-31,1520,218,1738
654,GSL,0.08878971125487957,0.09381934157703625,485530208,2020-12-31,1438,301,1739
655,TK,0.06904721642709788,0.1776615087149304,323548800,2020-12-31,1634,106,1740
656,LWAY,0.14596613988792362,0.05788320587035178,81767576,2020-12-31,987,754,1741
657,OXSQ,0.09275618401581247,0.08648385099495912,245964416,2020-12-31,1390,353,1743
658,RH,0.23917696583064424,0.04324056402201919,12874397696,2021-01-30,532,1213,1745
659,CCK,0.1848439821693908,0.04924544039729278,14148221952,2020-12-31,750,995,1745
660,SHW,0.4223453779649745,0.03530013541879996,68322496512,2020-12-31,174,1572,1746
661,NS,0.10182206114043083,0.0782552450941549,1918255744,2020-12-31,1313,433,1746
662,SANM,0.1263538738406431,0.064440350719877,2691207680,2020-10-03,1128,619,1747
663,VEDL,0.07343571504280953,0.1298070305423662,11363786752,2020-03-31,1581,167,1748
664,NOA,0.08858933476021194,0.09325494883524726,340604864,2020-12-31,1443,306,1749
665,NX,0.17355839545835433,0.051289040801185806,913667840,2020-10-31,814,937,1751
666,ESNT,0.09898999153418127,0.080281012266994,5630766080,2020-12-31,1339,413,1752
667,CIX,0.1357745248983156,0.06082575776324443,251763248,2020-12-31,1057,696,1753
668,THC,0.11902054431051474,0.06714934025316414,5556721152,2020-12-31,1185,568,1753
669,INS,0.47291073522023114,0.03422981029720943,357869536,2020-12-31,131,1628,1759
670,EML,0.13113809235495374,0.0619643499276329,160947968,2021-01-02,1086,674,1760
671,ICMB,0.08506373651507576,0.09505969447349166,78480032,2020-06-30,1471,290,1761
672,AGRO,0.08497870403841538,0.09484947035372844,963008384,2020-12-31,1473,291,1764
673,MNST,0.699564504924161,0.032735312639752434,50326175744,2020-12-31,55,1710,1765
674,G,0.20074751643355954,0.04710703334466304,8316900864,2020-12-31,685,1086,1771
675,ECC,0.09190466482803038,0.08545750448097966,393112032,2020-12-31,1407,364,1771
676,MTEX,0.09089450139421051,0.08639009227857519,42668144,2020-12-31,1419,354,1773
677,UGI,0.11472656660018894,0.06789911092931483,8738412544,2020-09-30,1218,558,1776
678,CNR,0.16007126704130942,0.053071201700367054,1837593600,2020-12-31,894,886,1780
679,CVS,0.11929521264985025,0.0652052460131175,97218355200,2020-12-31,1181,600,1781
680,NATR,0.1354468130717965,0.05960097257067912,380427360,2020-12-31,1058,724,1782
681,AMKR,0.12995724686181037,0.061502829962515326,6111523328,2020-12-31,1100,684,1784
682,LX,0.08079368893259672,0.09626262747635624,1685615104,2020-12-31,1503,283,1786
683,PEP,0.2330903287033043,0.04283210252276029,196753752064,2020-12-26,555,1232,1787
684,CSV,0.10863159397922222,0.07010032720125625,634590464,2020-12-31,1263,526,1789
685,ERII,0.36550748163409713,0.035610900238853986,1064909376,2020-12-31,233,1557,1790
686,IPG,0.1968943369624814,0.046825737577708075,11485933568,2020-12-31,695,1095,1790
687,LW,0.21979200171544977,0.044033339374220624,11323689984,2020-05-31,600,1194,1794
688,FLWS,0.19681490897822845,0.04665428983835281,1701587840,2020-06-28,696,1101,1797
689,PLTK,0.5425766871165644,0.03302610659504372,11059307520,2020-12-31,98,1700,1798
690,IAG,0.06755163235740036,0.14248197720242883,1555195520,2020-12-31,1660,142,1802
691,GFN,0.09821221646641011,0.07584313707380622,353664096,2020-06-30,1344,459,1803
692,NVS,0.17739276356463626,0.04883943419024154,197087330304,2020-12-31,792,1012,1804
693,ECCB,0.09190466482803038,0.08173024605524591,417705568,2020-12-31,1407,398,1805
694,CRMT,0.12297603048500416,0.06262586422115911,954773440,2020-04-30,1149,659,1808
695,NBLX,0.08372089223437854,0.0898947977286348,1289018496,2020-12-31,1478,331,1809
696,FLS,0.15499605586669918,0.0532336270103579,5177168384,2020-12-31,931,880,1811
697,WMT,0.1566288869514676,0.05280566427760132,393770041344,2021-01-31,917,895,1812
698,SNFCA,0.0629001385276254,0.20223638098417643,163284768,2020-12-31,1723,89,1812
699,SAFT,0.08659007769928666,0.08580811155690386,1265815552,2020-12-31,1457,357,1814
700,TRMD,0.07700034376996936,0.09876191162956598,669923840,2020-12-31,1547,267,1814
701,BKEPP,0.15373554582568533,0.05343784005532966,335102976,2020-12-31,939,876,1815
702,REPX,0.12360088568252983,0.06200173630482206,569045504,2020-09-30,1142,673,1815
703,CTB,0.11082000610131282,0.0668626916596453,2870194688,2020-12-31,1246,572,1818
704,VRSN,0.5596165388825065,0.032200401330062835,23218403328,2020-12-31,90,1732,1822
705,VHI,0.07227226147456987,0.10944231151361605,638689344,2020-12-31,1599,223,1822
706,CCMP,0.3398084228105044,0.03562054102032373,5628589568,2020-09-30,270,1556,1826
707,ALL,0.0772403415580413,0.09660403166812731,35466428416,2020-12-31,1546,280,1826
708,AME,0.5419865823959299,0.03233361392904191,30301730816,2020-12-31,99,1728,1827
709,BMY,0.2511177347242921,0.04021347064649197,139866357760,2020-12-31,485,1344,1829
710,CHCI,0.13310173182619517,0.05794219305806029,41331776,2020-12-31,1079,752,1831
711,WSTG,0.4593649461463142,0.03306913471165165,110780208,2020-12-31,135,1697,1832
712,DCI,0.23840690711600054,0.04119267310004339,7524557824,2020-07-31,537,1295,1832
713,MGRC,0.12356032248776275,0.061468011638508346,1965000704,2020-12-31,1145,687,1832
714,IEX,0.5807943878273254,0.031758026963876806,16506569728,2020-12-31,86,1747,1833
715,NWPX,0.09290278316793259,0.07643274144535998,336916992,2020-12-31,1386,454,1840
716,MRCC,0.08453334720632609,0.08527354989308225,227734400,2020-12-31,1476,365,1841
717,TTC,0.3670789284309386,0.034559318686665126,11434625024,2020-10-31,231,1611,1842
718,CPSI,0.26066608889439147,0.03919880925583122,438977152,2020-12-31,457,1387,1844
719,SXI,0.17642006081269795,0.04800914488310394,1191432960,2020-06-30,796,1050,1846
720,RL,0.1282865300208804,0.05906693145017908,9325520896,2020-03-28,1113,733,1846
721,MTX,0.12373453318335208,0.06038115980973054,2592344576,2020-12-31,1141,705,1846
722,TXN,0.5293487000804074,0.03186949712120269,180383449088,2020-12-31,104,1743,1847
723,CR,0.18647410243025347,0.046580147305347604,5553582080,2020-12-31,743,1104,1847
724,ACU,0.120669350272159,0.06181904189255796,123394384,2020-12-31,1171,677,1848
725,FAF,0.07941394801815169,0.09026350907979755,6573186560,2020-12-31,1522,329,1851
726,LII,0.3532648038222094,0.03470295260184716,12543404032,2020-12-31,248,1605,1853
727,GGG,0.4057553334198797,0.03378229634511497,12397701120,2020-12-25,192,1662,1854
728,TTEC,0.25922558022049863,0.03914342177307489,4923050496,2020-12-31,463,1392,1855
729,WGO,0.23370454770263285,0.04110765937924182,2525726976,2020-08-29,552,1303,1855
730,PCH,0.12461671812954238,0.05972831336247017,3810303232,2020-12-31,1134,721,1855
731,TRGP,0.09010916686935745,0.07871293960339397,7097451520,2020-12-31,1426,431,1857
732,CMCSA,0.1764527875566136,0.047608683608323224,245385969664,2020-12-31,795,1065,1860
733,NTGR,0.1273197650229344,0.058785144040883815,1246366464,2020-12-31,1123,738,1861
734,QCOM,0.3336548250549215,0.035204952228162285,159687524352,2020-09-27,286,1577,1863
735,PAX,0.8681757656458056,0.03033457916767602,2119462272,2020-12-31,38,1828,1866
736,PRAA,0.09092199632621066,0.07688158192399148,1673734656,2020-12-31,1418,449,1867
737,CNI,0.13095126302939242,0.05695118845166669,83246522368,2020-12-31,1088,780,1868
738,YETI,0.76968926157859,0.03044543698144571,6891880960,2021-01-02,48,1821,1869
739,CNXC,0.19633790894654196,0.04481545345636144,7886956032,2020-11-30,699,1170,1869
740,RBA,0.31364422921451907,0.03553117555045652,6835648000,2020-12-31,313,1559,1872
741,LSTR,0.2730950741156328,0.03800271946639433,6507185152,2020-12-26,422,1451,1873
742,ODP,0.0891234242157725,0.07754413702084927,2259347968,2020-12-26,1432,441,1873
743,SNDR,0.11637306489743003,0.06217542837370768,4504791552,2020-12-31,1205,669,1874
744,VPG,0.11435135629062998,0.0628027304294791,428718144,2020-12-31,1220,654,1874
745,GRMN,0.2350339317085351,0.04043025176880211,26369748992,2020-12-26,548,1327,1875
746,CECE,0.16979736484893806,0.04823541861998176,290229248,2020-12-31,835,1041,1876
747,OSIS,0.16507950277672664,0.04898085821084839,1732278656,2020-06-30,873,1006,1879
748,SUNS,0.08211549015223886,0.08243380792586955,254858128,2020-12-31,1490,389,1879
749,SMTX,0.14331276917704575,0.05348542269111354,172223344,2021-01-03,1007,874,1881
750,WAT,0.4174499356881977,0.032862198043535386,19060832256,2020-12-31,181,1705,1886
751,MSI,0.2623515234980203,0.038339655049368794,32356966400,2020-12-31,454,1432,1886
752,AMAT,0.36446692226119587,0.033841232635413374,127472287744,2020-10-25,234,1657,1891
753,WERN,0.11284642129780699,0.06251245983540511,3270256384,2020-12-31,1230,663,1893
754,MCI,0.07998084630493037,0.08279344997583836,297846976,2020-12-31,1513,384,1897
755,SSNC,0.27020067954979826,0.037726085346808394,18518831104,2020-12-31,433,1465,1898
756,TNET,0.15384615384615385,0.050599454375963575,5355805696,2020-12-31,935,963,1898
757,ETRN,0.07871559867905616,0.08489478048836178,3332590080,2020-12-31,1528,370,1898
758,CBPO,0.1656157081755883,0.04835183104031436,4576995840,2020-12-31,862,1037,1899
759,TILE,0.10273313611792509,0.065648688531641,742406464,2021-01-03,1307,592,1899
760,IBEX,0.14143222775770725,0.05318260334784251,417412160,2020-06-30,1017,884,1901
761,ICLR,0.27470149889372,0.036940329979037484,10455739392,2020-12-31,415,1490,1905
762,SNBR,0.16664788945661158,0.04799376419962182,3200799488,2021-01-02,855,1051,1906
763,TAIT,0.14640922350326435,0.051804222112912364,25978832,2020-12-31,982,925,1907
764,PLAB,0.07695659815433212,0.08575442657997032,826223552,2020-10-31,1548,359,1907
765,T,0.11464831530967914,0.061076211674101266,214439346176,2020-12-31,1219,692,1911
766,CLGX,0.2261382463237986,0.040300389969657784,5870238208,2020-12-31,577,1336,1913
767,PAYX,0.26825729189626035,0.037407674478481236,34724290560,2020-05-31,439,1475,1914
768,JELD,0.12767455905592334,0.05633817207242166,2868032000,2020-12-31,1120,795,1915
769,NIU,0.14589919414150182,0.051442007230654854,2720772608,2020-12-31,988,930,1918
770,LAWS,0.1673027571231164,0.04750832805575136,465567328,2020-12-31,849,1070,1919
771,CPAC,0.06839740506003951,0.0966774401895549,658225344,2020-12-31,1642,279,1921
772,NDAQ,0.22555760523226565,0.04021569291796053,25724655616,2020-12-31,580,1342,1922
773,HSII,0.09366990539552043,0.06894314467723824,720757888,2020-12-31,1382,540,1922
774,FB,0.2705986615425391,0.03682534330377884,889782927360,2020-12-31,431,1496,1927
775,CRUS,0.21696527312053368,0.04073109404127563,4930922496,2020-03-28,617,1312,1929
776,PHT,0.08871030434469811,0.07288910361493349,277680224,2020-03-31,1440,490,1930
777,EA,0.2716373173473211,0.03653042054213548,40399945728,2020-03-31,426,1505,1931
778,SAP,0.27131881121242823,0.03658457959070864,156284108800,2020-12-31,427,1504,1931
779,USLM,0.17737661303837773,0.04577846756489943,811819648,2020-12-31,793,1144,1937
780,LCUT,0.10112527579226611,0.06444062559338852,310899872,2020-12-31,1319,618,1937
781,EGO,0.06190570998670665,0.11594405560988774,2045667968,2020-12-31,1734,204,1938
782,SEM,0.13431622022072914,0.05350591918482456,4688352256,2020-12-31,1067,872,1939
783,MGPI,0.20051316347922266,0.04223996801504711,1406436224,2020-12-31,686,1256,1942
784,ULH,0.11758637643326642,0.05813031427710727,717943040,2020-12-31,1193,750,1943
785,RXN,0.24017591046905654,0.03852710126828518,5810848256,2020-12-31,525,1419,1944
786,UFPT,0.16642947731211213,0.047055235154534525,373968608,2020-12-31,857,1087,1944
787,EPD,0.10228637056588742,0.06360451735862444,49915006976,2020-12-31,1310,635,1945
788,LECO,0.24002780700435894,0.038505274716636645,7286848000,2020-12-31,526,1420,1946
789,GOOS,0.23820058997050148,0.03877075085006131,4670913536,2020-03-29,540,1406,1946
790,HWM,0.18197763648322737,0.044327160327716685,13975411712,2020-12-31,761,1185,1946
791,SENEB,0.07840099200761892,0.07988322759192837,456027328,2020-03-31,1533,416,1949
792,SAH,0.0917890093324282,0.06894098959211428,2096007040,2020-12-31,1409,541,1950
793,VRSK,0.4775470109458322,0.030416421623544427,29662806016,2020-12-31,129,1822,1951
794,SENEA,0.07840099200761892,0.07975654746050874,457317152,2020-03-31,1533,418,1951
795,MATX,0.11301176572743456,0.05960703102792774,3184234496,2020-12-31,1229,723,1952
796,AMCR,0.18674528745726562,0.04322350591553214,18322024448,2020-06-30,740,1214,1954
797,DLNG,0.06830361223478995,0.09259723545437831,97222400,2020-12-31,1645,309,1954
798,PVL,0.06522919964450448,0.09868663473990177,47133900,2020-12-31,1686,268,1954
799,SCL,0.1423840345974526,0.051147053973560945,2872652800,2020-12-31,1012,944,1956
800,MCK,0.24622984919396776,0.03779272094603205,30380206080,2020-03-31,502,1458,1960
801,J,0.21039217527144194,0.04070005531991202,17575919616,2020-10-02,644,1316,1960
802,FDUS,0.07821569025199417,0.07917089971227866,414213952,2020-12-31,1536,424,1960
803,CARR,0.2202797202797203,0.03970570223607929,37161889792,2020-12-31,598,1363,1961
804,SIFY,0.06397733043060957,0.10163739744929472,673878528,2020-03-31,1705,257,1962
805,GPC,0.20418056141262,0.04122451486241841,16879499264,2020-12-31,671,1292,1963
806,ROCK,0.30145204208415766,0.03450047513265122,2921292288,2020-12-31,346,1619,1965
807,CQP,0.11918084153983885,0.056925516762978044,20164315136,2020-12-31,1182,783,1965
808,ORAN,0.09232588656503637,0.06764170947392646,33170749440,2020-12-31,1402,563,1965
809,LLY,0.25043777028998965,0.03728470667443821,176924442624,2020-12-31,488,1478,1966
810,OSK,0.15144848954298992,0.04873219144275033,8210230784,2020-09-30,951,1015,1966
811,AINV,0.07681256248186577,0.07998084251949426,937774720,2020-03-31,1551,415,1966
812,OMI,0.1526851063883756,0.04860239936895597,2697600256,2020-12-31,946,1024,1970
813,RDN,0.08328893439573294,0.07307454760095329,4552613376,2020-12-31,1483,487,1970
814,ESI,0.24207434417097135,0.03790120547831979,4741868032,2020-12-31,516,1455,1971
815,MSA,0.23930494251127973,0.038174105759049407,5961102848,2020-12-31,531,1442,1973
816,TT,0.2929456309965813,0.03466958061569618,40425635840,2020-12-31,371,1606,1977
817,PSEC,0.07745150138952253,0.0782181475955677,3095968000,2020-06-30,1543,435,1978
818,IVZ,0.07105031606108535,0.08507426239272657,12140889088,2020-12-31,1611,367,1978
819,GLOP,0.06203453710020686,0.10422268214156132,141719760,2020-12-31,1733,245,1978
820,BWA,0.11681117533718689,0.05707327485861813,11109695488,2020-12-31,1201,778,1979
821,CBD,0.058166451335055984,0.11879004393141449,1577760256,2020-12-31,1789,193,1982
822,NEM,0.1000636961994601,0.06273641156511912,49276092416,2020-12-31,1330,656,1986
823,SPTN,0.08552837895939024,0.07068812224945227,698139776,2021-01-02,1469,517,1986
824,MIDD,0.2854129906156453,0.03476771023958733,9045707776,2021-01-02,388,1600,1988
825,ACN,0.2840449956398847,0.03479821029071086,182881992704,2020-08-31,392,1597,1989
826,IESC,0.17798799435909596,0.04362264116501705,1118672256,2020-09-30,786,1205,1991
827,HIHO,0.08358509566968782,0.07114780360920331,14338270,2020-03-31,1479,513,1992
828,LOCO,0.12264467430807939,0.054437798329006803,608154496,2020-12-30,1151,842,1993
829,ENS,0.15983854820512006,0.04666998958209992,4010016768,2020-03-31,895,1099,1994
830,NDSN,0.3349373937797083,0.03268854477005767,11835924480,2020-10-31,281,1715,1996
831,LCI,0.09534905189450146,0.06422624958775441,204938400,2020-06-30,1371,625,1996
832,IEC,0.11968488683692248,0.055384715049749726,127284472,2020-09-30,1178,820,1998
833,BPMP,0.13997705294214063,0.050363537459384815,1341171200,2020-12-31,1029,971,2000
834,AEM,0.11038287503665783,0.057982680588493984,14764618752,2020-12-31,1249,751,2000
835,NUE,0.12001080921665275,0.05500632403689486,23981740032,2020-12-31,1174,828,2002
836,UVV,0.08131229995427526,0.07188917823331999,1413038848,2020-03-31,1499,504,2003
837,MPV,0.07395169719656658,0.07916269661363905,135647696,2020-12-31,1578,425,2003
838,HNI,0.15029175364024824,0.048064463510579504,1728599296,2021-01-02,958,1047,2005
839,AMSF,0.088846693977946,0.0671099449287076,1259614592,2020-12-31,1436,569,2005
840,WNS,0.21203397149848854,0.039534840697556015,3600227584,2020-03-31,637,1370,2007
841,MCY,0.0786803382624671,0.07395693485796774,3532656896,2020-12-31,1529,478,2007
842,WSO,0.2594275655582087,0.03577413591097487,10567920640,2020-12-31,460,1550,2010
843,AVNT,0.18894395197878133,0.04151238902424187,4467044864,2020-12-31,725,1286,2011
844,MKC,0.27967161420105474,0.0345532835271163,23521404928,2020-11-30,399,1613,2012
845,V,0.6230976223035863,0.02770068405703757,490623205376,2020-09-30,75,1938,2013
846,MMAC,0.06175172906037606,0.09752697069597448,103188944,2020-12-31,1740,275,2015
847,POOL,0.40655587984196,0.030343125647528026,14668235776,2020-12-31,190,1827,2017
848,INFY,0.3219178082191781,0.03269936552602026,83073531904,2020-03-31,303,1714,2017
849,TSLX,0.08190039116273956,0.07018403947901343,1582657920,2020-12-31,1493,524,2017
850,PHK,0.08143336060467848,0.07044433663242693,931616896,2020-07-31,1497,521,2018
851,NWL,0.169424743892829,0.04438778898085749,11496697856,2020-12-31,838,1181,2019
852,JKHY,0.34839585432850684,0.0313834890154868,11846756352,2020-06-30,254,1769,2023
853,LOV,0.13959583152946997,0.04984873062168901,194123904,2020-12-31,1036,988,2024
854,FSK,0.07252341754186772,0.078220816673575,2582787840,2020-12-31,1592,434,2026
855,ALG,0.16903913096775386,0.044273486845294814,1896375424,2020-12-31,840,1188,2028
856,CXW,0.06812453115640121,0.08341537787556927,905640640,2020-12-31,1650,378,2028
857,ARRY,0.5549609963049131,0.027701336574085265,3786961152,2020-12-31,93,1937,2030
858,KLAC,0.40442854065042894,0.030137383933819976,54365368320,2020-06-30,194,1836,2030
859,CVCO,0.18598781219271274,0.041551160431674575,2064760960,2020-03-28,745,1285,2030
860,TRU,0.6448527831506555,0.027285562855185914,18333515776,2020-12-31,67,1964,2031
861,MTZ,0.15625530963155893,0.04650861575056832,7319579648,2020-12-31,922,1109,2031
862,KNL,0.11880064829821718,0.054247189329529016,833022080,2020-12-31,1186,847,2033
863,NP,0.11229293809938971,0.05593425011584296,882951808,2020-12-31,1236,803,2039
864,MRTN,0.11191432360061475,0.05594043185259365,1456389504,2020-12-31,1238,802,2040
865,DAC,0.07061228939852829,0.07925938630831943,1155432704,2020-12-31,1618,422,2040
866,QGEN,0.2371225847130903,0.036716052314945145,11687503872,2020-12-31,541,1500,2041
867,VMI,0.16187322891594835,0.045308961748935644,5025415680,2020-12-26,885,1157,2042
868,NSP,0.14310927050576952,0.048389799322034875,3303869952,2020-12-31,1009,1036,2045
869,WAB,0.18935104529616725,0.0404847375606831,15057429504,2020-12-31,724,1324,2048
870,KAI,0.2663021012473691,0.034665849032459985,2134714880,2021-01-02,442,1607,2049
871,LPI,0.08184508004978092,0.0680512811204882,438460832,2020-12-31,1495,554,2049
872,AVTR,0.36353346456692914,0.030544456505997915,18428721152,2020-12-31,236,1814,2050
873,HSIC,0.1648037351763808,0.04460153558929964,9871976448,2020-12-26,874,1176,2050
874,TU,0.12326275533998694,0.052395292951581844,27812462592,2020-12-31,1147,905,2052
875,EQX,0.08770763493240587,0.06504611407848988,2594177792,2020-12-31,1449,603,2052
876,ZTS,0.4473172628304821,0.02837080150231824,75926511616,2020-12-31,143,1910,2053
877,SKY,0.28509713766010664,0.0337398755632728,2621243648,2020-03-28,389,1664,2053
878,ICFI,0.17506466492425932,0.04237176734325213,1723467136,2020-12-31,805,1249,2054
879,UI,1.0962212074530517,0.02592070844456654,17698375680,2020-06-30,26,2035,2061
880,GOLF,0.17391594039215,0.042331229456101856,3239996160,2020-12-31,811,1250,2061
881,PLOW,0.2040333954516864,0.03915728490360936,1062873728,2020-12-31,673,1390,2063
882,ACCO,0.12136253041362531,0.0526306690785441,794440960,2020-12-31,1165,898,2063
883,MMP,0.10735010952353033,0.056453287149743875,9978517504,2020-12-31,1273,790,2063
884,NGL,0.08233511310320815,0.06654235761618225,289336320,2020-03-31,1487,577,2064
885,PRGO,0.13419278399954865,0.04923681279957842,5413470208,2020-12-31,1069,996,2065
886,SHYF,0.26972387655657826,0.034186519465251634,1361928064,2020-12-31,434,1632,2066
887,TCPC,0.07505407753522537,0.07202131382935228,841091904,2020-12-31,1564,502,2066
888,CNXN,0.12769713133233832,0.051012222519020496,1185718400,2020-12-31,1119,950,2069
889,BEDU,0.053468589101724744,0.11634250634646881,690045312,2020-08-31,1868,202,2070
890,AAME,0.05308512915323744,0.11788938851939085,81252496,2020-12-31,1873,197,2070
891,TDY,0.316100807196993,0.031454061874592085,15538999296,2021-01-03,312,1764,2076
892,TFII,0.1915885795473766,0.03970061900519403,7079677952,2020-12-31,712,1364,2076
893,FCRD,0.06655906518585623,0.08143531330382164,123147448,2020-12-31,1675,404,2079
894,MXIM,0.5288047566337857,0.027086329811372004,25670285312,2020-06-27,105,1975,2080
895,HON,0.22003968253968254,0.03717218665771333,157864804352,2020-12-31,599,1482,2081
896,HIO,0.06343093818944716,0.08507270495795906,488334400,2020-09-30,1713,368,2081
897,SPNT,0.05861925244015427,0.09406798655366051,1654875776,2020-12-31,1782,299,2081
898,HTLD,0.12444183350962422,0.05107480539127212,1581513856,2020-12-31,1137,947,2084
899,BIDU,0.059006092916984006,0.09285175239897182,73940918272,2020-12-31,1776,308,2084
900,TM,0.04917498857009586,0.14868703720793036,215504470016,2020-03-31,1953,133,2086
901,FUL,0.1589178334758616,0.044298000417516636,3346981120,2020-11-28,900,1187,2087
902,NSIT,0.13995189806066438,0.04787315217832908,3442248192,2020-12-31,1031,1057,2088
903,TPC,0.07461013358192951,0.07046282019847983,941963840,2020-12-31,1568,520,2088
904,UNIT,0.1113396785963485,0.0542503199964766,2505476352,2020-12-31,1243,846,2089
905,DHF,0.07853729949528722,0.06772478748113324,224666768,2020-03-31,1530,560,2090
906,HOV,0.09751735493309384,0.05846681385462166,695200256,2020-10-31,1350,742,2092
907,EM,0.07263302997947155,0.07193948219733991,2032903296,2020-12-31,1590,503,2093
908,OFS,0.06907771270440922,0.07580422080475124,123495968,2020-12-31,1633,461,2094
909,PPG,0.20853080568720378,0.03815586378986108,35653263360,2020-12-31,652,1444,2096
910,AGI,0.07097595731134221,0.07334075774470382,3265549568,2020-12-31,1613,485,2098
911,FLT,0.29320166136523895,0.03232055545289036,23892099072,2020-12-31,370,1729,2099
912,CGBD,0.0691146363685085,0.07537818783609637,758022016,2020-12-31,1632,467,2099
913,RPRX,0.1109025982548282,0.05390612908206231,25686865920,2020-12-31,1245,855,2100
914,ET,0.06992506324280463,0.07445708061912625,21736058880,2020-12-31,1624,476,2100
915,RMD,0.4903560246360175,0.026716334345612505,28979570688,2020-06-30,114,1987,2101
916,ARW,0.14259565636115956,0.0469303024124892,8570002432,2020-12-31,1010,1092,2102
917,BCOR,0.2531763386599383,0.03436497484015637,810410112,2020-12-31,480,1623,2103
918,CELP,0.12493798064996278,0.05050194090904396,27622112,2020-12-31,1133,970,2103
919,PRSP,0.2023888520238885,0.03838413188852555,4702991872,2020-03-31,678,1427,2105
920,JBT,0.242808128793877,0.034807137765961185,4347672064,2020-12-31,512,1594,2106
921,AAP,0.1406001946113468,0.04711092296568926,12037488640,2021-01-02,1022,1085,2107
922,JAKK,0.09115817671414679,0.06104166426745555,43454484,2020-12-31,1414,694,2108
923,PRFT,0.3691013508048208,0.029176330104081476,2116711296,2020-12-31,229,1880,2109
924,PNNT,0.06773597335202629,0.07638390547863175,409645568,2020-09-30,1656,455,2111
925,ARC,0.07175570751139186,0.07181040467808195,96282448,2020-12-31,1606,506,2112
926,SMID,0.10479801499902423,0.055284845939856796,60969316,2020-12-31,1291,823,2114
927,GLAD,0.08029931197686138,0.06487998652453639,342123904,2020-09-30,1508,607,2115
928,TMHC,0.07609641233917104,0.06773876502153174,4076149504,2020-12-31,1558,559,2117
929,HAS,0.1918043999984185,0.038731106016091456,13101119488,2020-12-27,711,1409,2120
930,CPLP,0.060380845508213654,0.08546189153984185,200012096,2020-12-31,1757,363,2120
931,ROK,0.2884014214337243,0.03192135763814487,30733451264,2020-09-30,380,1741,2121
932,TGP,0.054990804535198876,0.09740517641070753,1275574144,2020-12-31,1848,276,2124
933,SVM,0.11366885767268918,0.052495812560301156,955717440,2020-03-31,1224,902,2126
934,MFGP,0.16573167253018922,0.04191894238151471,2568149504,2020-10-31,861,1266,2127
935,THR,0.14940777529851165,0.044989721252101544,644027584,2020-03-31,964,1165,2129
936,GEO,0.07742688096617768,0.06570125623907454,689642112,2020-12-31,1544,589,2133
937,GAINL,0.06876428964012936,0.07219035033498956,363197824,2020-03-31,1638,499,2137
938,CINR,0.0681531342027766,0.07287117391250839,259920256,2020-12-31,1648,491,2139
939,WU,0.09937888198757763,0.05577739735873476,10335481856,2020-12-31,1335,807,2142
940,STNG,0.049460300176369036,0.11851150890042858,1022438592,2020-12-31,1949,194,2143
941,UNVR,0.13010070869078702,0.048056104558585326,3811582976,2020-12-31,1098,1048,2146
942,NBIX,0.21714626707333246,0.03604075391522364,8769635328,2020-12-31,616,1536,2152
943,GBX,0.07428976135180587,0.06624716883903285,1505359104,2020-08-31,1572,580,2152
944,CNS,0.33326939307910686,0.02947968647377792,3207248384,2020-12-31,287,1869,2156
945,ATSG,0.08859714100557793,0.0599969307649081,1776612608,2020-12-31,1442,715,2157
946,RSG,0.1635002724260207,0.04165476943038483,33032347648,2020-12-31,880,1279,2159
947,HRZN,0.07849525990476264,0.06406921274701856,303237248,2020-12-31,1531,628,2159
948,ATCO,0.06240261703230264,0.07877644357727229,3489893376,2020-12-31,1729,430,2159
949,UNF,0.15022865363106142,0.043699420227760195,4217403136,2020-08-29,959,1202,2161
950,KNOP,0.06404967486920414,0.07601068892121483,593724864,2020-12-31,1703,458,2161
951,ROP,0.48726591760299626,0.02581293092836674,44240605184,2020-12-31,118,2044,2162
952,GECC,0.06811406974459314,0.07130821458726917,77341976,2020-12-31,1651,511,2162
953,RM,0.07458701547814309,0.06535037617578116,393146368,2020-12-31,1569,597,2166
954,CPRT,0.335276275631042,0.02897328746446589,27892494336,2020-07-31,280,1887,2167
955,CAJ,0.0462911278105714,0.13088403928120154,24545865728,2020-12-31,2003,164,2167
956,BAX,0.18130913303726587,0.038901997308848156,42950156288,2020-12-31,768,1400,2168
957,EC,0.049236856532206164,0.11260415688625446,25492291584,2020-12-31,1951,217,2168
958,MYRG,0.12079384749437737,0.049016058070866855,1262485504,2020-12-31,1168,1004,2172
959,CSX,0.12067173568185548,0.04910851047605042,74650861568,2020-12-31,1170,1002,2172
960,MTD,0.44298749498592166,0.026071853684160012,28507580416,2020-12-31,146,2029,2175
961,REGI,0.12245169569292928,0.04862504113124152,2888647168,2020-12-31,1154,1022,2176
962,ARCE,0.09169042879431862,0.05755099457036877,1728203904,2020-12-31,1410,767,2177
963,HAYW,0.3843482905982906,0.027108693116994684,3911960320,2020-12-31,212,1973,2185
964,RFP,0.052192711550339714,0.09413844530506864,976228288,2020-12-31,1889,298,2187
965,RMRM,0.04294832793514907,0.16033944897106764,125076520,2020-12-31,2061,127,2188
966,SWKS,0.3026255782135644,0.029930321757322548,31157057536,2020-10-02,342,1848,2190
967,MDCA,0.10728525256780921,0.051950701327705746,271313504,2020-12-31,1274,918,2192
968,XOMA,0.2530469163983206,0.03270723701569054,438766176,2020-12-31,481,1712,2193
969,CTS,0.15349511635707003,0.04229812491451591,1001829952,2020-12-31,942,1253,2195
970,XLNX,0.44028878714844855,0.025813878303046368,31879858176,2020-03-28,153,2043,2196
971,RHI,0.21034503551218123,0.03569549367749107,9202718720,2020-12-31,645,1553,2198
972,PTVE,0.10872274143302181,0.05128911622498185,2570562560,2020-12-31,1262,936,2198
973,LRCX,0.36139687396938847,0.027336207287400372,94605099008,2020-06-28,242,1958,2200
974,ARCC,0.07052054144798017,0.066066009073972,8453105664,2020-12-31,1619,583,2202
975,LESL,0.3787508085825518,0.02669878021133517,4662481408,2020-10-03,216,1990,2206
976,SONY,0.04272237883812149,0.1420078690574661,136557068288,2020-03-31,2064,143,2207
977,EHI,0.05030339148811462,0.09616534317074751,234236128,2020-05-31,1923,285,2208
978,CSWC,0.08075768318409006,0.06031847001501254,474443040,2020-03-31,1504,707,2211
979,RPM,0.18743759869026194,0.03731825515904559,11883929600,2020-05-31,736,1476,2212
980,GOGO,0.14250146045752915,0.04358590285201588,920978112,2020-12-31,1011,1206,2217
981,AOD,0.07242413998880785,0.0639755808464021,1031604160,2020-10-31,1594,630,2224
982,CTAS,0.3061378774556134,0.028954596147749576,37029081088,2020-05-31,337,1888,2225
983,CHTR,0.18239676781719052,0.03768000585554022,132229283840,2020-12-31,758,1467,2225
984,THO,0.17543046567838308,0.03841339466021884,7441217024,2020-07-31,802,1426,2228
985,KBH,0.0873226100460621,0.05704813589273457,4849615872,2020-11-30,1452,779,2231
986,CC,0.09585179218687072,0.05362968792424914,4600680960,2020-12-31,1364,868,2232
987,PBA,0.07124321774003303,0.06436276000463607,16176925696,2020-12-31,1610,622,2232
988,KO,0.19709428740857876,0.03598338613923025,229169102848,2020-12-31,693,1540,2233
989,PANL,0.05175321201745321,0.08979079895367605,139135632,2020-12-31,1900,333,2233
990,MAT,0.17204226541034504,0.03866406979323059,7015625216,2020-12-31,825,1411,2236
991,OI,0.09239346873755476,0.05455197971466952,2317649152,2020-12-31,1400,839,2239
992,SXT,0.146214792779508,0.04215762641663995,3364474880,2020-12-31,983,1258,2241
993,WCC,0.12219766994096871,0.04711648575949878,4384643072,2020-12-31,1158,1084,2242
994,ACLS,0.14615039835621405,0.04211423663987609,1497228032,2020-12-31,984,1260,2244
995,CTG,0.10475290186422793,0.05074428501142678,159524400,2020-12-31,1293,958,2251
996,BSM,0.09112147080785453,0.05463654578455509,1906847104,2020-12-31,1415,836,2251
997,EGY,0.07370514406929468,0.06201604578731151,129742200,2020-12-31,1579,672,2251
998,DHR,0.4135384615384615,0.024988280598392337,165688246272,2020-12-31,183,2069,2252
999,AROC,0.07428092805092554,0.06166855618454433,1434679424,2020-12-31,1573,681,2254
1000,EBR,0.04537701281889043,0.10701699995157322,9780471808,2020-12-31,2021,233,2254
1001,SFL,0.05818887888168659,0.07526802485736235,1010906240,2020-12-31,1787,468,2255
1002,MDU,0.08061194925753269,0.0578853632849159,6391965696,2020-12-31,1505,753,2258
1003,B,0.1551849900048518,0.04031221106995642,2589228032,2020-12-31,928,1335,2263
1004,SRT,0.10723489529928693,0.04991518139436431,323465760,2020-12-31,1277,986,2263
1005,INT,0.11665995435628944,0.04769231874297721,2129192704,2020-12-31,1204,1061,2265
1006,MSCI,0.5969407924746333,0.021972747244898377,37114048512,2020-12-31,83,2183,2266
1007,DMS,0.5349221448956091,0.02244287265913213,732945280,2020-12-31,101,2166,2267
1008,RELX,0.3090775450202132,0.02758299809532504,50597593088,2020-12-31,325,1942,2267
1009,IAA,0.21072538160205323,0.03427924971645523,7804016128,2020-12-27,640,1627,2267
1010,SCI,0.06695545499023492,0.0653283942813301,8759919616,2020-12-31,1670,598,2268
1011,KR,0.07796826331150516,0.05924853938450587,28410331136,2021-01-30,1539,731,2270
1012,AMN,0.210341039691661,0.03428653494062793,3579112704,2020-12-31,646,1625,2271
1013,VFC,0.20973037210684184,0.03433752697973907,33278814208,2020-03-28,648,1624,2272
1014,NLOK,0.175190731845154,0.03763354840079115,12564662272,2020-04-03,803,1469,2272
1015,CORR,0.05307471778134614,0.08153197760044217,95423984,2020-12-31,1874,403,2277
1016,AEGN,0.11719000980238717,0.047126318627636284,874575808,2020-12-31,1197,1082,2279
1017,UNP,0.12900795860216815,0.04462722623553666,148835008512,2020-12-31,1106,1174,2280
1018,IRCP,0.038807724796288086,0.14746077490608822,492663168,2020-06-30,2143,137,2280
1019,LEJU,0.06043392959606311,0.0697180077564326,313549792,2020-12-31,1753,529,2282
1020,CMI,0.13515232911571357,0.04295028462359309,38010585088,2020-12-31,1061,1223,2284
1021,CSWI,0.31778308157732205,0.02699307215011888,2196643840,2020-03-31,308,1977,2285
1022,STE,0.2694415316775277,0.029910906228251342,16997929984,2020-03-31,435,1850,2285
1023,BR,0.2506920207004453,0.03075803252974403,18064644096,2020-06-30,486,1804,2290
1024,GAIN,0.06876428964012936,0.06285800287221274,445279040,2020-03-31,1638,652,2290
1025,ACA,0.11743695978284163,0.046766854209868924,3050910208,2020-12-31,1194,1097,2291
1026,AXTA,0.15235635894125243,0.040131979463648354,6956274688,2020-12-31,947,1349,2296
1027,MDLZ,0.16270262081502804,0.038590013566311365,82690138112,2020-12-31,882,1415,2297
1028,CRH,0.09677543927399111,0.05125011156899787,38194454528,2020-12-31,1359,939,2298
1029,CINF,0.059431326776625465,0.06956422630781096,16923693056,2020-12-31,1768,530,2298
1030,NMFC,0.06527513610330021,0.06448046798116942,1251008640,2020-12-31,1685,616,2301
1031,HNW,0.06021477437384649,0.06872940117161719,123408624,2020-04-30,1758,545,2303
1032,FF,0.09735296168462156,0.05084012770519366,604531008,2020-12-31,1351,954,2305
1033,PAHC,0.121041595727522,0.045841959685160735,977776704,2020-06-30,1166,1140,2306
1034,STLA,0.09651825604683408,0.05113676269826568,55378759680,2020-12-31,1361,945,2306
1035,WOW,0.12069595730682067,0.04585533700707518,1165853312,2020-12-31,1169,1139,2308
1036,THRM,0.1813338015213566,0.03583960925299865,2523683584,2020-12-31,766,1546,2312
1037,CBT,0.1044776119402985,0.04872317091150715,3009733120,2020-09-30,1296,1017,2313
1038,FL,0.06971017238113279,0.061432944477396244,6026271232,2021-01-30,1625,688,2313
1039,CCAP,0.06245984074664463,0.06584064604800757,510956608,2020-12-31,1727,586,2313
1040,CMPR,0.17262015742669767,0.03686672053062025,2763412992,2020-06-30,822,1492,2314
1041,PPL,0.06677172833642761,0.06319324712389582,22036103168,2020-12-31,1671,643,2314
1042,PLXS,0.1153183256104726,0.04664870876022914,2647841280,2020-10-03,1213,1102,2315
1043,GNRC,0.4401589775815495,0.022500484235585382,20770035712,2020-12-31,154,2162,2316
1044,AGCO,0.12949153931249233,0.043354563744264045,11079379968,2020-12-31,1104,1212,2316
1045,CMRE,0.059326772552642196,0.06850114228477241,1241168128,2020-12-31,1769,548,2317
1046,ABCL,0.6129981330321344,0.020363701361649177,8243943424,2020-12-31,79,2239,2318
1047,AVO,0.12293314162473042,0.044780463541799674,1402551808,2020-10-31,1150,1171,2321
1048,TRTN,0.06901643129994015,0.06147257925180817,3693332992,2020-12-31,1635,686,2321
1049,FNF,0.046064598593972765,0.09235442032959766,12712394752,2020-12-31,2010,313,2323
1050,PFLT,0.06439375918582013,0.06421671489320967,490467040,2020-09-30,1700,626,2326
1051,ADI,0.368701819339334,0.024170081040304648,59480473600,2020-10-31,230,2097,2327
1052,VRTS,0.0552680819253891,0.07336537020076637,1934756992,2020-12-31,1843,484,2327
1053,CERN,0.18816340503843673,0.034786794424164214,22000560128,2020-12-31,729,1599,2328
1054,OKE,0.09253043257248994,0.05136751696188118,22686590976,2020-12-31,1396,932,2328
1055,WBT,0.23082866525014487,0.03138235659898594,2244772096,2020-12-31,559,1770,2329
1056,CX,0.08314778293784592,0.054181767917176896,10516505600,2020-12-31,1484,849,2333
1057,AWI,0.20235800929599818,0.03385372528805503,4518384128,2020-12-31,679,1656,2335
1058,TEO,0.049690437861419266,0.08226831732362579,2261374464,2020-12-31,1943,392,2335
1059,AZRE,0.053975273064533494,0.07461767773893838,1332954624,2020-03-31,1863,475,2338
1060,AGD,0.06863986033720629,0.0607583207324413,144069408,2020-10-31,1640,700,2340
1061,KMPR,0.05713741469555423,0.06946105822382764,5298083840,2020-12-31,1808,532,2340
1062,GMLP,0.04676905652915145,0.08655141449003587,242555600,2020-12-31,1989,352,2341
1063,LAD,0.10663353663127777,0.04762834255909866,10717398016,2020-12-31,1279,1063,2342
1064,BCPC,0.27997763306347856,0.02755538535050459,3928274688,2020-12-31,397,1947,2344
1065,CRVL,0.23476798143851507,0.030939590711844666,1911777152,2020-03-31,549,1795,2344
1066,BDC,0.1607725620194451,0.03796076186366612,2026981248,2020-12-31,890,1454,2344
1067,AAPL,0.2721450389200907,0.02815327305570203,2188496732160,2020-09-26,425,1921,2346
1068,SWBI,0.12246196634955578,0.0440381366251916,968070464,2020-04-30,1153,1193,2346
1069,RMAX,0.2151983064293447,0.03251223837226504,1273142784,2020-12-31,622,1725,2347
1070,CMT,0.07654276090777637,0.05639900566256225,99678352,2020-12-31,1555,792,2347
1071,STCN,0.10039050896128329,0.04862067565675543,119700568,2020-07-31,1326,1023,2349
1072,AES,0.07439616593138033,0.056938721692661884,18520064000,2020-12-31,1570,782,2352
1073,DORM,0.16051244403793385,0.03778041316489649,3363146496,2020-12-26,892,1461,2353
1074,TREX,0.44666022993304805,0.021144628871118787,11348486144,2020-12-31,144,2210,2354
1075,LFUS,0.25200121680935206,0.029405343009039086,6626921984,2020-12-26,482,1873,2355
1076,AZPN,0.3428308431731958,0.024227064126866715,10383718400,2020-06-30,264,2093,2357
1077,MKTX,0.6432600807831862,0.018781126505076046,20311089152,2020-12-31,69,2290,2359
1078,IPLDP,0.0418013134577296,0.09792455809992481,352989120,2020-12-31,2087,273,2360
1079,FLY,0.05814634203348223,0.06681001512716576,511777696,2020-12-31,1790,574,2364
1080,VSH,0.0946107206430531,0.049561974878963556,3696948224,2020-12-31,1374,991,2365
1081,TNP,0.04478496116651854,0.08761493209384169,177104832,2020-12-31,2026,341,2367
1082,CPTA,0.05424984476593558,0.07132542591066457,44027776,2020-12-31,1858,510,2368
1083,HZNP,0.301497012288092,0.02611227564504942,20503230464,2020-12-31,345,2024,2369
1084,MTCH,0.8101249012062555,0.017867799944240433,38697000960,2020-12-31,44,2326,2370
1085,OTEX,0.17909164321517432,0.03493222734441098,13434756096,2020-06-30,780,1590,2370
1086,ROLL,0.2171900271766039,0.03161218920406461,4978395136,2020-03-28,615,1756,2371
1087,TPL,0.7880460586642697,0.017918543533471085,12395816960,2020-12-31,47,2325,2372
1088,TRS,0.13328406038714458,0.04118859057024938,1332395520,2020-12-31,1076,1296,2372
1089,LNG,0.0782676528371663,0.05459817688882792,18538041344,2020-12-31,1535,837,2372
1090,AVYA,0.15541490857946555,0.038128514013565644,2433187072,2020-09-30,927,1447,2374
1091,FELE,0.20123609126055267,0.03313629522618423,3752784896,2020-12-31,683,1693,2376
1092,ADUS,0.2769543532473165,0.027121917025831697,1690881792,2020-12-31,406,1971,2377
1093,AAON,0.27513838354470754,0.027221992445304332,3600663040,2020-12-31,413,1966,2379
1094,JCI,0.1671163307411522,0.036192038017360664,44366594048,2020-09-30,851,1529,2380
1095,EMN,0.11627082594824531,0.04449430172836473,15321191424,2020-12-31,1206,1178,2384
1096,SHC,0.28670570042378385,0.026477160451261365,7310135808,2020-12-31,383,2003,2386
1097,DMO,0.05518264097291617,0.06884707211413524,163531888,2020-12-31,1845,542,2387
1098,DSSI,0.04598077874383941,0.08390053268127634,442498560,2020-12-31,2011,376,2387
1099,KBR,0.13197767145135567,0.04108095533894192,5434261504,2020-12-31,1083,1305,2388
1100,FSKR,0.05901520637219406,0.06455096391586226,3486409728,2020-12-31,1775,613,2388
1101,MA,0.4278226229164483,0.020857928628648156,377557024768,2020-12-31,168,2221,2389
1102,ZBRA,0.3491335372069317,0.02302952211472414,27151429632,2020-12-31,253,2139,2392
1103,KTB,0.17924023092292324,0.034548547811850044,3267335424,2021-01-02,778,1614,2392
1104,CBZ,0.13437309748297452,0.04046452972085054,1802092416,2020-12-31,1066,1326,2392
1105,INMD,0.33047506272316063,0.02390019430578089,3081623808,2020-12-31,292,2103,2395
1106,KT,0.04143006748467095,0.09406400221875388,5871916032,2020-12-31,2095,300,2395
1107,MMI,0.11822843241756352,0.04356266829252907,1385728256,2020-12-31,1190,1207,2397
1108,INTU,0.4843089249944358,0.019175806704953693,114358321152,2020-07-31,121,2277,2398
1109,NGMS,0.9154875959647231,0.016915409111683884,872276224,2020-12-31,36,2363,2399
1110,ENTG,0.34083415703590203,0.02313016234381054,16425869312,2020-12-31,268,2132,2400
1111,UNFI,0.07574892360153612,0.05454161201069477,1987248768,2020-08-01,1560,840,2400
1112,MTL,0.057019058886518884,0.06566087539509832,494443296,2020-12-31,1809,591,2400
1113,PRI,0.05562521178786898,0.0676126231836628,6055688192,2020-12-31,1836,564,2400
1114,PDCO,0.14068948003301376,0.03928400195994551,3140637440,2020-04-25,1020,1381,2401
1115,GLPI,0.09029268049182378,0.050181508650820446,10070105088,2020-12-31,1423,978,2401
1116,ROL,0.4245132004447048,0.020454126680148926,17436131328,2020-12-31,172,2234,2406
1117,ORCC,0.060573766844138226,0.06271878522583567,5518768128,2020-12-31,1749,657,2406
1118,GRFS,0.12537856218678112,0.04173067009833162,16715628544,2020-12-31,1130,1277,2407
1119,A,0.30714916151809357,0.02456313805828557,40192712704,2020-10-31,332,2081,2413
1120,NFG,0.06521202724314373,0.05945525835994291,4577040384,2020-09-30,1687,726,2413
1121,TEL,0.17101136809094472,0.035040231026995786,43522899968,2020-09-25,830,1585,2415
1122,LMAT,0.28661363130301004,0.025983573214009122,1055929408,2020-12-31,384,2033,2417
1123,OFLX,0.6354879473546172,0.017344214426107125,1538470400,2020-12-31,71,2349,2420
1124,TRIN,0.07175874408903717,0.055551498567349186,388304896,2020-12-31,1605,815,2420
1125,VRA,0.06735676150938608,0.057680519975307674,373239968,2021-01-30,1663,761,2424
1126,UEIC,0.12357087909172901,0.04160941701262094,773281600,2020-12-31,1143,1282,2425
1127,WY,0.101076095311299,0.04656530882651059,28107888640,2020-12-31,1321,1106,2427
1128,PAM,0.05660377358490566,0.0647253374502338,1332423936,2020-12-31,1818,609,2427
1129,EW,0.3023800771916927,0.02446715189005226,53488873472,2020-12-31,343,2085,2428
1130,NOK,0.08635339885339885,0.05054259645805806,23541786624,2020-12-31,1461,967,2428
1131,MFD,0.053274308471928954,0.06772144220570478,81115200,2020-11-30,1870,561,2431
1132,HVT,0.07341543391586243,0.054100169839798255,724388096,2020-12-31,1582,850,2432
1133,WDFC,0.42867849113165124,0.019547356571228126,3833654272,2020-08-31,167,2267,2434
1134,FRG,0.1095990075948307,0.04441753556974237,1501875584,2020-12-26,1256,1180,2436
1135,PFL,0.06058054911380624,0.0611305168450172,398306752,2020-07-31,1748,691,2439
1136,SSRM,0.05117448589375072,0.06987103433088883,3435550464,2020-12-31,1911,528,2439
1137,PFE,0.14451831982650382,0.038160771067103104,204160647168,2020-12-31,997,1443,2440
1138,GIII,0.08553067273360294,0.05033116225641298,1487096704,2021-01-31,1468,972,2440
1139,BCEI,0.05728571919928458,0.06330739136358136,1002600576,2020-12-31,1804,638,2442
1140,EZPW,0.04935430320800276,0.07276960100102743,298565536,2020-09-30,1950,493,2443
1141,HNP,0.045398196892215824,0.0790681765377634,5415837696,2020-12-31,2019,426,2445
1142,CWCO,0.07232021043991571,0.05418340910744739,190531440,2020-12-31,1598,848,2446
1143,PFN,0.05976508912167763,0.061533281159259746,771459584,2020-07-31,1763,683,2446
1144,AMED,0.3497464906561832,0.021670870088673837,9299082240,2020-12-31,252,2195,2447
1145,FOCS,0.22482748806121972,0.02963208157854928,3123754496,2020-12-31,582,1865,2447
1146,CNSL,0.06574159285120997,0.05745704493038794,519241888,2020-12-31,1680,770,2450
1147,HIX,0.055084232624471416,0.0649420892876308,584617920,2020-04-30,1846,606,2452
1148,AON,0.14608885527838014,0.03766422100827626,53558206464,2020-12-31,986,1468,2454
1149,HEI,0.34212464645768287,0.021831117502024804,16711832576,2020-10-31,265,2191,2456
1150,PCN,0.06355043388690208,0.05822880556180806,725681024,2020-07-31,1711,746,2457
1151,TRP,0.06353585112205802,0.058291136458657966,45652168704,2020-12-31,1712,745,2457
1152,AVGO,0.4548373287671233,0.017932245294499174,198063226880,2020-11-01,137,2323,2460
1153,HALO,0.3244477831481927,0.02253030864175395,6129026560,2020-12-31,301,2159,2460
1154,MEDP,0.2686798109741778,0.026182586302765043,6217545216,2020-12-31,438,2022,2460
1155,DQ,0.15102462475982217,0.03651006420856518,4814532608,2020-12-31,955,1507,2462
1156,GTS,0.05478931824799301,0.06466192900255588,615908992,2020-12-31,1851,611,2462
1157,BG,0.0722176759410802,0.0537232629486633,11197841408,2020-12-31,1601,862,2463
1158,EXLS,0.1817788717402874,0.03300831767325728,3106777600,2020-12-31,764,1702,2466
1159,ACP,0.06462355746836713,0.05752198096021198,203258288,2020-10-31,1698,768,2466
1160,GPK,0.09442007548709579,0.046992090622728556,5158265856,2020-12-31,1376,1091,2467
1161,CODI,0.13086088208667757,0.03926442853079895,1619255040,2020-12-31,1089,1382,2471
1162,GCP,0.13453314326443336,0.03876452148754291,1860057216,2020-12-31,1065,1407,2472
1163,BBU,0.06189608021877849,0.05866403917387342,3274146048,2020-12-31,1735,741,2476
1164,RVLV,0.5214859094790777,0.01660448288822033,3718006528,2020-12-31,106,2376,2482
1165,JBHT,0.1506451989382429,0.036280057382804806,17918054400,2020-12-31,957,1525,2482
1166,DHY,0.052795007148247475,0.06501825639910344,247381744,2020-10-31,1878,604,2482
1167,PKX,0.03541478413300759,0.09814337172138547,23447398400,2020-12-31,2211,271,2482
1168,AJRD,0.08874105685954563,0.04811435500860119,3821047808,2020-12-31,1439,1044,2483
1169,ECOM,0.24775074123300275,0.02674818351052002,753290496,2020-12-31,498,1986,2484
1170,LBTYB,0.0498572855875207,0.06842528769600867,14708059136,2020-12-31,1935,549,2484
1171,POWL,0.07420470363066929,0.0521980906396908,399048096,2020-09-30,1575,911,2486
1172,LBTYA,0.0498572855875207,0.06820108653003198,14815223808,2020-12-31,1935,552,2487
1173,LBTYK,0.0498572855875207,0.06799480511641466,14914447360,2020-12-31,1935,555,2490
1174,ADBE,0.4584009520718382,0.017217829049825804,240931127296,2020-11-27,136,2355,2491
1175,PPC,0.10009448088965389,0.045191676887862395,5865040384,2020-12-27,1329,1162,2491
1176,ZYXI,0.36234753402863706,0.01988728903678662,544410304,2020-12-31,239,2253,2492
1177,SCM,0.05856949729776761,0.06012420051749418,261696992,2020-12-31,1784,708,2492
1178,CIK,0.053107602726081234,0.06439921896472263,180451904,2020-12-31,1872,621,2493
1179,BCSF,0.058565886229927915,0.06003736590090094,1007171904,2020-12-31,1785,711,2496
1180,XPEL,0.7319338271014431,0.014610944048446105,1603739904,2020-12-31,50,2448,2498
1181,ETSY,0.6152620202171991,0.015304134921794598,27550531584,2020-12-31,78,2420,2498
1182,CMTL,0.13316135918875646,0.03846514166554937,672706496,2020-07-31,1078,1422,2500
1183,ST,0.18037697530082097,0.032299311032908624,9230113792,2020-12-31,771,1730,2501
1184,FFIV,0.20528322588138195,0.030142018192600494,12972561408,2020-09-30,667,1835,2502
1185,IBM,0.10955407509508129,0.04247391600499671,121287507968,2020-12-31,1257,1245,2502
1186,CRAI,0.08460369082189266,0.04856757953902991,585792896,2021-01-02,1475,1027,2502
1187,GLT,0.07427933691498553,0.05163677317915817,748122112,2020-12-31,1574,928,2502
1188,MLM,0.1304858014550575,0.03862448225050248,21553725440,2020-12-31,1093,1413,2506
1189,AER,0.05730872976687823,0.060396574138410195,7980419072,2020-12-31,1803,703,2506
1190,KEYS,0.23263473053892217,0.027444287449400053,27197902848,2020-10-31,556,1952,2508
1191,TTEK,0.22102055004637874,0.028280650606289582,7732498432,2020-09-27,594,1914,2508
1192,FSM,0.080054618744745,0.049191742811503084,1343977472,2020-12-31,1510,998,2508
1193,HLNE,0.2845519911234071,0.023419830679240607,4915017216,2020-03-31,390,2119,2509
1194,DCO,0.11375962138671389,0.04146081124467165,757673408,2020-12-31,1222,1288,2510
1195,HAE,0.23640065224102455,0.027153467108477367,5949188096,2020-03-28,543,1969,2512
1196,HLIO,0.22440165093394546,0.02795640551985682,2248086016,2021-01-02,586,1926,2512
1197,MNRO,0.12239692696019266,0.03974778043846683,2317855744,2020-03-28,1156,1360,2516
1198,VMC,0.15228147602954248,0.03534372187173826,22888519680,2020-12-31,948,1570,2518
1199,SYK,0.2403429971416905,0.026595300516394353,95330648064,2020-12-31,524,1995,2519
1200,ATR,0.167972863066321,0.033359106458334474,9585058816,2020-12-31,844,1676,2520
1201,TEF,0.07155591073953403,0.0521265382772522,24511105024,2020-12-31,1608,912,2520
1202,NCR,0.11505642719515552,0.041047565161191034,5163308032,2020-12-31,1215,1306,2521
1203,CRS,0.06399768633283755,0.05549201928323381,1980592384,2020-06-30,1704,817,2521
1204,CTXS,0.20158739900561876,0.030084493821310475,17502695424,2020-12-31,681,1841,2522
1205,ATC,0.22106806794574116,0.027821231325116123,4270928384,2020-12-31,593,1932,2525
1206,WB,0.12176567655179771,0.03973412099354283,11182693376,2020-12-31,1163,1362,2525
1207,ANET,0.20779298724705272,0.029475833472423357,24086435840,2020-12-31,657,1870,2527
1208,WM,0.1444114737883284,0.03610610311583865,56840478720,2020-12-31,998,1530,2528
1209,KALU,0.09435348446683459,0.04558719890197709,1755944832,2020-12-31,1377,1152,2529
1210,TTMI,0.09538178911872229,0.04528446395619197,1600382848,2020-12-28,1370,1160,2530
1211,GLOG,0.048737162306569395,0.06701302770282393,552118272,2020-12-31,1960,570,2530
1212,IIIN,0.11531039298672743,0.040565446773711954,617468544,2020-10-03,1214,1320,2534
1213,PRPL,0.18826421378161923,0.030689428352043312,2270201344,2020-12-31,728,1808,2536
1214,ACGLO,0.05120680953807818,0.06388168261600524,15650109440,2020-12-31,1908,631,2539
1215,WHD,0.14410920576893785,0.03591878344793402,2241565696,2020-12-31,1000,1542,2542
1216,ACGLP,0.05120680953807818,0.06378483468380046,15693323264,2020-12-31,1908,634,2542
1217,IDXX,0.45093543957381743,0.015742137603830194,43061460992,2020-12-31,142,2401,2543
1218,SSTK,0.22761218585722445,0.027049815605637205,3368191744,2020-12-31,568,1976,2544
1219,GRC,0.12784970302498216,0.038359584391352786,878313472,2020-12-31,1115,1430,2545
1220,JNPR,0.10991639744506647,0.04120659629794244,8311229440,2020-12-31,1252,1294,2546
1221,STM,0.14126433154517723,0.03609757519714839,35331715072,2020-12-31,1018,1532,2550
1222,TMX,0.19775070290534208,0.029612061183047506,6371474944,2020-12-31,690,1866,2556
1223,LULU,0.33927351132020733,0.018962163557047888,43127848960,2021-01-31,271,2286,2557
1224,EXP,0.12243782292076322,0.038794761155281715,5828981760,2020-03-31,1155,1403,2558
1225,ROG,0.17434397833450355,0.03165030615620919,3624941312,2020-12-31,808,1752,2560
1226,AUDC,0.14026348321592896,0.03604730154919966,1010054912,2020-12-31,1026,1534,2560
1227,VRTV,0.06267627702914447,0.054738242076713906,677876352,2020-12-31,1725,835,2560
1228,SGH,0.18188276834652997,0.030835611020357583,1333231744,2020-08-28,762,1800,2562
1229,FPAY,0.08929860714933253,0.04603464751573686,54081028,2020-12-31,1430,1132,2562
1230,WRK,0.07403193033381712,0.04994243366897552,13913697280,2020-09-30,1577,985,2562
1231,AJG,0.20941870670177207,0.028306979066521378,25871904768,2020-12-31,650,1913,2563
1232,COST,0.16225754310344828,0.033310515307732,160732774400,2020-08-30,884,1679,2563
1233,ACGL,0.05120680953807818,0.06276767628698116,16155237376,2020-12-31,1908,655,2563
1234,DIT,0.059679130385422476,0.05615055656825247,64581848,2020-09-30,1765,800,2565
1235,MASI,0.3076809070808456,0.020372232148131355,12941779968,2021-01-02,330,2238,2568
1236,HMC,0.0354803158459635,0.08574013852769947,51238662144,2020-03-31,2209,360,2569
1237,BMI,0.26235164507003605,0.02343869079949354,2780735744,2020-12-31,453,2117,2570
1238,DEO,0.20136007376671278,0.0289310271588842,102792994816,2020-06-30,682,1889,2571
1239,MANH,0.45936770036246477,0.014760524986900258,7735154176,2020-12-31,134,2439,2573
1240,IART,0.1881017560944719,0.030000457235095056,5916017664,2020-12-31,731,1844,2575
1241,ICHR,0.2399026738362203,0.025637614196401568,1676107392,2020-12-25,528,2050,2578
1242,TOL,0.06581581387492848,0.05252520961617474,7429302272,2020-10-31,1679,900,2579
1243,WING,0.6900856911492766,0.012511947499728922,4086850304,2020-12-26,58,2523,2581
1244,PGP,0.06547179967702706,0.05257846791980176,122680112,2020-06-30,1684,899,2583
1245,MSFT,0.23556597395203188,0.025859025859703396,1929676980224,2020-06-30,546,2038,2584
1246,MDT,0.21158943056782586,0.027560047864507706,164464541696,2020-04-24,638,1946,2584
1247,ENB,0.06300828810897387,0.05366987044421334,74410196992,2020-12-31,1719,865,2584
1248,MITK,0.20519152611820468,0.028210739317044143,651836608,2020-09-30,668,1917,2585
1249,FOXF,0.28214249572108047,0.021782327710169615,5590126592,2021-01-01,394,2193,2587
1250,JACK,0.09670741475530413,0.042867707668113285,2619045120,2020-09-27,1360,1228,2588
1251,ROAD,0.1519532468385254,0.03409837769376447,1560483840,2020-09-30,949,1640,2589
1252,RCM,0.30275615400799494,0.020002035042351093,6642067968,2020-12-31,341,2249,2590
1253,WWD,0.14059104737070838,0.035354985460057026,7736129024,2020-09-30,1023,1568,2591
1254,VRT,0.1760926803580832,0.030961871453787978,7531380736,2020-12-31,799,1794,2593
1255,ECL,0.25056164730037345,0.023682640309214808,62776958976,2020-12-31,487,2107,2594
1256,UGP,0.05437227263097834,0.05876723819193268,3849942272,2020-12-31,1856,739,2595
1257,HPS,0.05975759772189366,0.05477496116554055,583547264,2020-07-31,1764,834,2598
1258,SLRC,0.05529630267476842,0.05781215795538587,801264704,2020-12-31,1841,757,2598
1259,DSGX,0.4872264220765489,0.013509519597840546,5487105024,2021-01-31,119,2480,2599
1260,ESE,0.1826394153677316,0.03000680182632797,2895652608,2020-09-30,757,1843,2600
1261,SPXC,0.11034214618973562,0.04006103976691325,2723094784,2020-12-31,1250,1352,2602
1262,BHC,0.14915026833631484,0.03410304047713782,10883746816,2020-12-31,966,1637,2603
1263,CBRE,0.14000982839973014,0.03521452403902724,27045324800,2020-12-31,1028,1576,2604
1264,HUBG,0.1124953178974238,0.0394961514857589,2292960000,2020-12-31,1233,1372,2605
1265,CODA,0.15672848923823962,0.033163744834645,96229504,2020-10-31,915,1691,2606
1266,AKAM,0.13028505980787478,0.03640676747357494,16953661440,2020-12-31,1096,1511,2607
1267,CAI,0.0549965113974524,0.057723579941703726,757242752,2020-12-31,1847,760,2607
1268,INFO,0.3081196997758066,0.01913327187938123,43073576960,2020-11-30,328,2280,2608
1269,JLL,0.08880770846327152,0.04467729961859333,9369631744,2020-12-31,1437,1172,2609
1270,TAK,0.07220373258368014,0.0489208724664154,53832417280,2020-03-31,1602,1010,2612
1271,AWF,0.06002026126296366,0.05409492119007545,1029582528,2020-03-31,1761,851,2612
1272,MORN,0.25771555838370985,0.022754356966816273,10026173440,2020-12-31,464,2149,2613
1273,ANSS,0.3929960754073489,0.015398628284806547,31952590848,2020-12-31,203,2416,2619
1274,HPI,0.05888376118497488,0.05432360912649145,543486720,2020-07-31,1778,845,2623
1275,CNTY,0.051077160683415675,0.06007432397095612,329180896,2020-12-31,1913,710,2623
1276,SPNS,0.218951179956243,0.026198094547439075,1769435136,2020-12-31,603,2021,2624
1277,CANG,0.03044568609725033,0.09829473971997547,1253075840,2020-12-31,2354,270,2624
1278,FAMI,0.05655537226709084,0.05586358449361338,29790506,2020-09-30,1819,806,2625
1279,SLQT,0.21265499368120294,0.026686534262689816,5134387712,2020-06-30,636,1991,2627
1280,WH,0.2552147239263804,0.022634856349938722,6739366912,2020-12-31,477,2153,2630
1281,AY,0.1622873653345301,0.03175778827734869,4295956480,2020-12-31,883,1748,2631
1282,LOGI,0.34477984664936395,0.016626069826663432,18170658816,2020-03-31,261,2374,2635
1283,PSMT,0.11180953283391978,0.03909033038280682,2753229568,2020-08-31,1239,1396,2635
1284,KE,0.08662291325281919,0.04443576567456157,626423232,2020-06-30,1456,1179,2635
1285,ENBL,0.04386120996441281,0.06542412225277715,3005446912,2020-12-31,2039,596,2635
1286,MCD,0.14730599348210888,0.0338390968231758,172584992768,2020-12-31,977,1659,2636
1287,WEN,0.10307005063040602,0.04032582756964267,4726359040,2021-01-03,1302,1334,2636
1288,BDX,0.20324219695136705,0.02731010450124962,72038539264,2020-09-30,675,1962,2637
1289,SYY,0.17982335162351806,0.029677880680589637,41271914496,2020-06-27,775,1862,2637
1290,AMOT,0.13749201717844609,0.03495936359448342,519898080,2020-12-31,1049,1588,2637
1291,AQUA,0.168753597884602,0.030922435459492626,3295188736,2020-09-30,841,1797,2638
1292,TR,0.12850290512210857,0.036100550154551936,2069982336,2020-12-31,1109,1531,2640
1293,FN,0.13459371895978187,0.0351234602210211,3297346816,2020-06-26,1064,1580,2644
1294,WMB,0.068948800129279,0.04895180599244023,28668334080,2020-12-31,1636,1008,2644
1295,SKM,0.03446322496029955,0.0815943376746419,17705854976,2020-12-31,2246,400,2646
1296,CABO,0.1694696496129939,0.030605994995929836,10782410752,2020-12-31,837,1810,2647
1297,GB,0.2954292488727137,0.01898257395320216,2254170880,2020-03-31,365,2285,2650
1298,BELFB,0.06949097319108764,0.048593856890565675,229456800,2020-12-31,1626,1025,2651
1299,OCSL,0.061404747385888796,0.052256926466022105,1193989760,2020-09-30,1743,908,2651
1300,FTS,0.0587364378744766,0.05350983485862291,20437221376,2020-12-31,1781,871,2652
1301,EPAM,0.3371562099746771,0.016538263008553825,23767300096,2020-12-31,276,2378,2654
1302,HPF,0.05931281341544303,0.053095231933719185,455454368,2020-07-31,1770,885,2655
1303,ABT,0.23898261318643485,0.023354112092507245,214177972224,2020-12-31,535,2122,2657
1304,HBP,0.07019328585961343,0.04840672559958675,105284352,2020-12-31,1622,1035,2657
1305,KAMN,0.09770088691974733,0.04076789251151564,1474467840,2020-12-31,1348,1311,2659
1306,ADV,0.2179479099374478,0.025514405711065627,4104820480,2020-12-31,607,2054,2661
1307,XRX,0.06515580736543909,0.05025303167317446,4792992768,2020-12-31,1688,974,2662
1308,QRVO,0.24183509734912711,0.0227555188827057,21730639872,2020-03-28,517,2148,2665
1309,HEES,0.07646231521860107,0.04642997221834934,1338475648,2020-12-31,1557,1112,2669
1310,BKH,0.06328286714264067,0.05076469877813971,4255170304,2020-12-31,1716,956,2672
1311,DSKE,0.07605754166073209,0.04611627840652209,547542528,2020-12-31,1559,1125,2684
1312,RNR,0.050563546764097474,0.05764118423887903,8410672128,2020-12-31,1919,765,2684
1313,LHCG,0.20480941527910912,0.026244160515643072,6440181760,2020-12-31,670,2016,2686
1314,TMUS,0.10110225065201292,0.039542867340133875,160358481920,2020-12-31,1320,1368,2688
1315,BEKE,0.058774571947124064,0.052230662430940177,66249834496,2020-12-31,1779,909,2688
1316,GNOG,0.26437344168436605,0.02020273864935073,1273167104,2020-12-31,447,2244,2691
1317,HURN,0.13997645599688882,0.03381211851716894,1243200640,2020-12-31,1030,1661,2691
1318,PAE,0.11258296005242563,0.03775555096133698,804857408,2020-12-31,1232,1462,2694
1319,FVE,0.04742480535564274,0.05990034752411022,173915504,2020-12-31,1976,718,2694
1320,FLEX,0.11714898656122368,0.03681464194676613,9139838976,2020-03-31,1198,1497,2695
1321,EAD,0.05036110436162428,0.05717627650789075,519829600,2020-04-30,1922,776,2698
1322,TFX,0.2741533504160485,0.019075554329065367,19965517824,2020-12-31,418,2281,2699
1323,ERIE,0.18051888429200588,0.02784909968174594,11582213120,2020-12-31,770,1930,2700
1324,BELFA,0.06949097319108764,0.04726162250115961,239107072,2020-12-31,1626,1074,2700
1325,KMI,0.0688716643985563,0.04753606614373982,37433012224,2020-12-31,1637,1068,2705
1326,BLL,0.15381809338521402,0.0313653031687271,29480189952,2020-12-31,937,1771,2708
1327,OPCH,0.22807913525357343,0.022890568218840324,3388594688,2020-12-31,566,2143,2709
1328,ALV,0.10647590018879512,0.03836394398734752,8123260928,2020-12-31,1281,1429,2710
1329,JBL,0.095331635752608,0.04023868809392092,7951764992,2020-08-31,1372,1341,2713
1330,CASY,0.09279969678500864,0.04047748011283613,8113974784,2020-04-30,1388,1325,2713
1331,SYNA,0.24518768046198267,0.021177375700201766,4744438784,2020-06-27,507,2209,2716
1332,TNC,0.1310592459605027,0.034215658615244116,1509273472,2020-12-31,1087,1629,2716
1333,BKI,0.24428793710588814,0.02107399820443601,11741184000,2020-12-31,509,2213,2722
1334,MHK,0.08555591512150564,0.04229051574726533,14164250624,2020-12-31,1467,1255,2722
1335,NGVC,0.04824136159673957,0.05784250841436057,389698144,2020-09-30,1966,756,2722
1336,ATRI,0.15736761760216011,0.03052943873970423,1177128960,2020-12-31,910,1815,2725
1337,DHX,0.09574490177347676,0.0397931944963263,154395040,2020-12-31,1367,1359,2726
1338,AKU,0.08981694225154697,0.04116396218301517,228079808,2020-12-31,1428,1299,2727
1339,ALSK,0.0435120551262313,0.06177109025974308,177457840,2020-12-31,2049,678,2727
1340,MSP,0.29219525399260127,0.01716197982557972,3872002560,2020-12-31,372,2356,2728
1341,GPX,0.08652220204171103,0.041798343129613044,287474592,2020-12-31,1458,1274,2732
1342,SUM,0.08635511140636397,0.04185137174896654,3402592256,2021-01-02,1460,1272,2732
1343,BRY,0.041495694509537835,0.06329212785101583,449028160,2020-12-31,2093,639,2732
1344,PAG,0.06171407583533892,0.049327218457851145,6716672000,2020-12-31,1741,994,2735
1345,PTSI,0.06357610001334697,0.04857562709582246,347561088,2020-12-31,1710,1026,2736
1346,PSB,0.08865185097271262,0.04118785534019782,4343214592,2020-12-31,1441,1297,2738
1347,ALRM,0.3067079109700227,0.015639552977916298,4402316288,2020-12-31,334,2405,2739
1348,KSU,0.10923892464975388,0.03723784821608802,23843577856,2020-12-31,1259,1480,2739
1349,NSC,0.09454169837990649,0.03969962928277062,73951870976,2020-12-31,1375,1365,2740
1350,ENSG,0.09247893525003356,0.04021428450050856,5110766592,2020-12-31,1397,1343,2740
1351,SHLS,0.8294143149115383,0.0065338282229862816,5779561984,2020-12-31,41,2700,2741
1352,HAIN,0.17365400673191123,0.027925437246446826,4252046592,2020-06-30,813,1928,2741
1353,BOOT,0.14694278111772896,0.03140331431571672,1993783040,2020-03-28,978,1768,2746
1354,LPRO,0.3482021009870196,0.013277657058920214,4889523712,2020-12-31,255,2492,2747
1355,NHI,0.07244894092683112,0.04537312336948316,3357232128,2020-12-31,1593,1156,2749
1356,HIG,0.035030578865026314,0.07035883377731177,23863265280,2020-12-31,2226,523,2749
1357,IX,0.03536589171191213,0.06934599873469639,20306008064,2020-03-31,2215,536,2751
1358,CSTE,0.050268562934936825,0.05493701557277675,479078464,2020-12-31,1924,829,2753
1359,INNV,0.32771290904253747,0.01415377226886981,3742180096,2020-06-30,295,2459,2754
1360,SAM,0.28960764130426203,0.0166076314965577,15371025408,2020-12-26,379,2375,2754
1361,IPAR,0.14886571222226944,0.03109514808813703,2257164288,2020-12-31,970,1784,2754
1362,BSY,0.3255843786336074,0.01416632486004699,13384999936,2020-12-31,297,2458,2755
1363,SYNH,0.1696770643860876,0.028111171049482207,8337079296,2020-12-31,836,1922,2758
1364,NESR,0.09323340546723341,0.03947803258014947,1145517824,2020-12-31,1384,1374,2758
1365,FTI,0.05271457535480964,0.0533208339055503,3458979840,2020-12-31,1880,878,2758
1366,ENLC,0.051259111122806095,0.05407726114906562,2112106880,2020-12-31,1906,852,2758
1367,NEXA,0.05651782352044073,0.05120781189330519,1385298688,2020-12-31,1821,942,2763
1368,SGEN,0.2127007794547808,0.02319738715605654,25899563008,2020-12-31,635,2129,2764
1369,MAIN,0.06806210705376932,0.046482002552896313,2818645760,2020-12-31,1653,1111,2764
1370,FSTR,0.06233079618989901,0.04834770175196262,190830256,2020-12-31,1730,1038,2768
1371,LNN,0.16520567652581014,0.02856715675698376,1800679680,2020-08-31,869,1904,2773
1372,PAA,0.049993132811427005,0.05448702703404383,6498467840,2020-12-31,1932,841,2773
1373,CDNS,0.28764163703928564,0.016056812308473566,40562974720,2021-01-02,381,2394,2775
1374,AFL,0.028360430722833337,0.0855731839620867,35507662848,2020-12-31,2413,362,2775
1375,AEL,0.012527792871023182,0.21572302024964,2978494976,2020-12-31,2697,78,2775
1376,WHF,0.053602492352369004,0.05208108818333034,332434272,2020-12-31,1865,914,2779
1377,SRLP,0.07533666287215136,0.043014058829838796,619202944,2020-12-31,1562,1218,2780
1378,PTY,0.05640923143192116,0.05070845126319945,2065219456,2020-07-31,1822,960,2782
1379,MKL,0.039987930957846494,0.06256045803388172,16185933824,2020-12-31,2121,661,2782
1380,IP,0.06744350282485875,0.04614349569883049,21582354432,2020-12-31,1661,1123,2784
1381,MGA,0.09014852985753259,0.03973830995575788,26971809792,2020-12-31,1425,1361,2786
1382,GL,0.03909190694675805,0.06302898170192597,11525894144,2020-12-31,2136,650,2786
1383,HQI,0.19000828851793497,0.024956468305710796,267850304,2020-12-31,720,2070,2790
1384,TTGT,0.3354757023996141,0.012880839681294108,2042190720,2020-12-31,279,2513,2792
1385,MKTY,0.2649991254154277,0.017275117199412278,88691392,2020-12-31,445,2350,2795
1386,CF,0.0691187909767752,0.04506524099866123,9867211776,2020-12-31,1631,1164,2795
1387,CSGP,0.4257465971422767,0.008888134400087863,34976333824,2020-12-31,171,2625,2796
1388,SRCL,0.15409495911143659,0.029606958274282637,6216600576,2020-12-31,933,1867,2800
1389,SGRY,0.12205484743144071,0.034071865701759095,2734708480,2020-12-31,1162,1641,2803
1390,CCOI,0.17015209730156106,0.027113469628893865,3353325824,2020-12-31,833,1972,2805
1391,ASML,0.2864617535534984,0.01525339748911109,260758175744,2020-12-31,385,2422,2807
1392,WMS,0.21513977396963263,0.021940842101670927,7914170880,2020-03-31,623,2184,2807
1393,AVID,0.1627598899315851,0.027946369569587532,999485504,2020-12-31,881,1927,2808
1394,FSV,0.20897809911638565,0.022527815230100567,6825439744,2020-12-31,651,2160,2811
1395,OLED,0.29781337084217174,0.014478118387698502,11345333248,2020-12-31,361,2451,2812
1396,UNM,0.0170143267660375,0.12453540059510049,5629087744,2020-12-31,2636,176,2812
1397,GNW,0.012321473003234636,0.17562198919222619,1798231168,2020-12-31,2703,111,2814
1398,APD,0.12455381886708791,0.033287599955202876,62922321920,2020-09-30,1135,1680,2815
1399,MAN,0.0992219459372744,0.037274249547198324,5734734848,2020-12-31,1337,1479,2816
1400,CAE,0.0925922486954261,0.038461169811540304,9117024256,2020-03-31,1394,1423,2817
1401,TRI,0.19187950229207595,0.02365981489839907,44898467840,2020-12-31,710,2108,2818
1402,SMCI,0.07993707572610892,0.0411033209102065,2006827904,2020-06-30,1514,1304,2818
1403,SXC,0.048816464142726695,0.05379962790412404,522330496,2020-12-31,1959,859,2818
1404,EFX,0.17906435771517187,0.025828371404937354,22747416576,2020-12-31,781,2041,2822
1405,ABMD,0.2612591597896007,0.01673866914486324,14914922496,2020-03-31,456,2369,2825
1406,PHG,0.15403239271998664,0.028865908337937143,54650228736,2020-12-31,934,1891,2825
1407,QLI,0.1602829156985071,0.027785726976077667,166594992,2020-09-30,893,1933,2826
1408,USAC,0.06383583149840699,0.04611886140183284,1503442688,2020-12-31,1706,1124,2830
1409,IRM,0.09245212975130945,0.038231435929962254,10872931328,2020-12-31,1398,1439,2837
1410,KRO,0.06511507962091419,0.04569625470383673,1818646784,2020-12-31,1690,1147,2837
1411,PCAR,0.06833961180465226,0.04388597859744123,32408524800,2020-12-31,1644,1198,2842
1412,WST,0.23036850186444396,0.01905691583464937,21898090496,2020-12-31,561,2282,2843
1413,AL,0.04692420143652739,0.05387344846614831,5590458880,2020-12-31,1985,858,2843
1414,MHLD,0.022820097841922373,0.09305948303207624,314569952,2020-12-31,2536,307,2843
1415,JHX,0.1448204214900564,0.029920318127000595,14586444800,2020-03-31,995,1849,2844
1416,ICUI,0.1263221517074645,0.032619539658561784,4326847488,2020-12-31,1129,1716,2845
1417,OTTR,0.05586506504952173,0.04872835922638817,1922787072,2020-12-31,1829,1016,2845
1418,NPO,0.12251601248152406,0.03312815877437991,1791860736,2020-12-31,1152,1694,2846
1419,SPSC,0.2863749514696143,0.014080845439944565,3631704064,2020-12-31,386,2461,2847
1420,NWLI,0.00797712614468558,0.22124404211379972,900642112,2020-12-31,2772,75,2847
1421,JPC,0.051819236128549724,0.05100056115513371,987040256,2020-07-31,1899,951,2850
1422,SWX,0.048642236243893834,0.0530089464885225,3963990272,2020-12-31,1961,890,2851
1423,NEWT,0.061682261468728836,0.046228031220054026,617133760,2020-12-31,1742,1116,2858
1424,QUAD,0.058764869292684666,0.04714755961351153,205225456,2020-12-31,1780,1079,2859
1425,MRCY,0.1875010834371828,0.023286159652051962,4281389056,2020-07-03,735,2127,2862
1426,RYAAY,0.07913300437288112,0.040247631014585415,21486786560,2020-03-31,1524,1339,2863
1427,MMLP,0.06293381136674818,0.0457857899287442,95677520,2020-12-31,1720,1143,2863
1428,REI,0.0466800186790265,0.05350433020076145,218199520,2020-12-31,1993,873,2866
1429,CLS,0.06308619334555934,0.04565600606306907,1110611968,2020-12-31,1718,1149,2867
1430,EL,0.22956730769230768,0.018323300969819246,109596745728,2020-06-30,563,2305,2868
1431,FTV,0.19005637519491425,0.02275276127654448,23989659648,2020-12-31,719,2150,2869
1432,QMCO,0.14673242095951095,0.028840011003062382,472004448,2020-03-31,980,1893,2873
1433,UTL,0.049531737773152965,0.051792240149423484,725384896,2020-12-31,1948,926,2874
1434,LYB,0.07792625410890382,0.04028105225117231,34776563712,2020-12-31,1540,1338,2878
1435,NVEE,0.17474276839448652,0.024782052953658602,1463101952,2021-01-02,807,2072,2879
1436,TIXT,0.2175839552238806,0.019496771354724645,7698215424,2020-12-31,612,2268,2880
1437,GHC,0.05271161784005895,0.049183643997770685,3096971776,2020-12-31,1881,999,2880
1438,LFC,0.017066879161064415,0.10334262617392143,152818597888,2020-12-31,2633,249,2882
1439,LAMR,0.12855358031149197,0.031299331890378736,9623977984,2020-12-31,1108,1775,2883
1440,CSTM,0.07485822306238185,0.04066502280297315,2084049280,2020-12-31,1566,1318,2884
1441,BLBD,0.14762530688508918,0.028436292472441834,724440640,2020-10-03,976,1909,2885
1442,DLA,0.06053125675383618,0.045986807150833836,195778704,2020-10-03,1751,1134,2885
1443,HIL,0.06839035006868173,0.04248005073878426,171702848,2020-12-31,1643,1244,2887
1444,BBSI,0.056768586384145565,0.04722479081953516,539965248,2020-12-31,1815,1076,2891
1445,PSA,0.127622273554431,0.0313351992165389,45074845696,2020-12-31,1121,1773,2894
1446,WRLD,0.06509190313651754,0.04366634512319335,888759232,2020-03-31,1692,1203,2895
1447,TITN,0.057365278939870194,0.04683616511886688,599684288,2021-01-31,1801,1094,2895
1448,FWRD,0.13816405588557487,0.029867569981886978,2433487616,2020-12-31,1044,1852,2896
1449,GTES,0.1053243882576492,0.03466574261717604,4918324224,2021-01-02,1289,1608,2897
1450,BZH,0.05338431564770388,0.04843613361791092,665501440,2020-09-30,1869,1032,2901
1451,TRN,0.031851788694137566,0.06569682086999003,3177405696,2020-12-31,2312,590,2902
1452,TRMB,0.20294755093194625,0.020741613699005935,20207978496,2021-01-01,676,2227,2903
1453,MFC,0.009418977486606504,0.13454605258260066,41725440000,2020-12-31,2745,158,2903
1454,FLOW,0.13329691341163616,0.030269120767886903,2786108160,2020-12-31,1075,1832,2907
1455,DIOD,0.10831394550483552,0.03400574890147522,3529378816,2020-12-31,1265,1645,2910
1456,BFS,0.06040688579816016,0.04547990770524942,958979392,2020-12-31,1756,1154,2910
1457,TROX,0.055823442136498515,0.04713622567411205,2948746752,2020-12-31,1831,1080,2911
1458,CIGI,0.12917732431875117,0.030712674750665196,4106773504,2020-12-31,1105,1807,2912
1459,CMBM,0.2626021163440978,0.014068922426664137,1632095488,2020-12-31,452,2462,2914
1460,TRNS,0.16399885125228617,0.025881797368646084,370428544,2020-03-28,877,2037,2914
1461,MAV,0.03744912441500504,0.058307275216971446,287743968,2020-03-31,2171,744,2915
1462,HRI,0.06814585256494791,0.04191169102317582,2899398144,2020-12-31,1649,1267,2916
1463,ULBI,0.07127853767097597,0.04081222060344644,131635552,2020-12-31,1609,1310,2919
1464,MOV,0.059449817627693934,0.045427742449200705,664043392,2021-01-31,1766,1155,2921
1465,HNGR,0.1097752618761314,0.0335584942968807,915552000,2020-12-31,1253,1670,2923
1466,MGI,0.025326694133407476,0.07771176651818973,509280032,2020-12-31,2485,439,2924
1467,PRAH,0.17353865673949675,0.023608102758426928,10108880896,2020-12-31,815,2111,2926
1468,PUBM,0.29656228695238007,0.010910129331143374,2800210944,2020-12-31,363,2564,2927
1469,MAX,0.33802841272862555,0.008076853401400415,2152070912,2020-12-31,274,2655,2929
1470,LITE,0.11866919975904731,0.03197596847924346,6903839744,2020-06-27,1189,1740,2929
1471,XYL,0.18410198725159355,0.02231289156952492,19440216064,2020-12-31,754,2176,2930
1472,PPD,0.15510290685338426,0.02645535999087949,13432078336,2020-12-31,929,2004,2933
1473,LMNX,0.14504873347641245,0.027562774756892987,1558676736,2020-12-31,992,1944,2936
1474,ID,0.1801671416184089,0.022486708671493483,266604080,2020-12-31,774,2163,2937
1475,FFC,0.05240990418281199,0.047993338512082,1042862848,2020-11-30,1885,1052,2937
1476,ACIW,0.13704283529513092,0.02880930201676836,4709148672,2020-12-31,1051,1894,2945
1477,ANAT,0.01963386810317838,0.0863158825136769,2972917760,2020-12-31,2592,355,2947
1478,PLBY,0.23855080667987547,0.01545648717533005,895782336,2020-12-31,536,2413,2949
1479,JRO,0.05052311756304213,0.0484719729056998,388384704,2020-07-31,1920,1029,2949
1480,GOOGL,0.1555963191943897,0.02610927012579633,1535701811200,2020-12-31,924,2026,2950
1481,FSLR,0.0632534230754196,0.042781444431239046,8463020544,2020-12-31,1717,1233,2950
1482,GOOG,0.1555963191943897,0.02610854621728125,1535745589248,2020-12-31,924,2027,2951
1483,FT,0.04772541978322984,0.05006471779968919,191253760,2020-08-31,1970,982,2952
1484,ATH,0.012261544533613998,0.10399301469726047,9675351040,2020-12-31,2706,246,2952
1485,EIX,0.03969259585720582,0.05492462188496787,22649913344,2020-12-31,2125,830,2955
1486,VLGEA,0.03703111307050038,0.056946718326248084,356689120,2020-07-25,2176,781,2957
1487,JFR,0.05024423366425099,0.048411775191331115,553816960,2020-07-31,1925,1034,2959
1488,RMNI,0.09919067774098146,0.0344712524279328,767146304,2020-12-31,1338,1622,2960
1489,GTEC,0.09272325590926145,0.03535307468009561,118103624,2020-12-31,1391,1569,2960
1490,ILPT,0.05774560657324439,0.04494314006457609,1552207232,2020-12-31,1796,1166,2962
1491,ESEA,0.05493658138281808,0.04637144669740104,78414376,2020-12-31,1849,1114,2963
1492,AWR,0.07922381497237763,0.03821406692969746,2845992192,2020-12-31,1523,1441,2964
1493,DFH,0.12502635457227815,0.030227157810693385,2211264000,2020-12-31,1132,1833,2965
1494,PCM,0.04543356188227459,0.05090322250678246,135614976,2020-06-30,2016,952,2968
1495,NAPA,0.13776891765194588,0.02807964510632911,2115458048,2020-07-31,1046,1924,2970
1496,WLFC,0.0452268498012038,0.051018568827751014,261372800,2020-12-31,2023,949,2972
1497,EXPO,0.2245815180004586,0.016168406093686877,5229085696,2021-01-01,584,2390,2974
1498,EFT,0.044425186673215086,0.051186147948971895,569253632,2020-05-31,2032,943,2975
1499,OGE,0.04900338473110192,0.04870370968808153,6510743552,2020-12-31,1956,1020,2976
1500,FORM,0.18493164630270179,0.020714619384479466,3954019328,2020-12-26,749,2229,2978
1501,SCSC,0.07420226604350089,0.038820034426410466,757954624,2020-06-30,1576,1402,2978
1502,CALX,0.2162916750907393,0.01711324580185633,2605335552,2020-12-31,621,2358,2979
1503,ARD,0.10037668956348327,0.03390254564920145,6159828480,2020-12-31,1327,1653,2980
1504,SCS,0.0649010477299185,0.04155699595292257,1642049664,2021-02-26,1696,1284,2980
1505,VAR,0.1607136050013342,0.02428130202626037,16274754560,2020-10-02,891,2090,2981
1506,ITGR,0.15290908674159365,0.025902452299619124,3055417344,2020-12-31,945,2036,2981
1507,ACHC,0.08623545011454889,0.036300909891670535,5269020160,2020-12-31,1463,1520,2983
1508,FLNG,0.03324490885127014,0.060369523048068426,492475808,2020-12-31,2277,706,2983
1509,ATO,0.05563308068446899,0.04563271482160245,12704600064,2020-09-30,1835,1150,2985
1510,PSHG,0.03105070871134875,0.06316245638836869,28869906,2020-12-31,2339,646,2985
1511,CLB,0.11712298538883265,0.031066208760836385,1259591168,2020-12-31,1200,1786,2986
1512,HYB,0.04050162657641628,0.05324840063013616,215694944,2020-12-31,2110,879,2989
1513,NSL,0.04266724628317082,0.05180523946111422,218152944,2020-07-31,2066,924,2990
1514,NHTC,0.024661776090242195,0.07278143897064199,80052904,2020-12-31,2500,492,2992
1515,AMRX,0.0868018413956468,0.03600316021038501,884624960,2020-12-31,1454,1539,2993
1516,WHLRP,0.0418380090437939,0.052228344809129294,11830403,2020-12-31,2083,910,2993
1517,NMRK,0.06358644559014617,0.04148191405442347,1901628288,2020-12-31,1709,1287,2996
1518,BXG,0.05915068339764669,0.04290746710322289,790078912,2020-12-31,1772,1227,2999
1519,CMP,0.07990672808963203,0.03703031767675407,2181188352,2020-12-31,1515,1485,3000
1520,ARTNA,0.04569051814376861,0.049895052580707866,374728000,2020-12-31,2013,987,3000
1521,EVV,0.04017734715006469,0.0532128795057999,1463452288,2020-03-31,2119,881,3000
1522,CE,0.09567257559958289,0.034172471577003004,17392277504,2020-12-31,1368,1633,3001
1523,NI,0.04900512979947148,0.04805328915725233,9682860032,2020-12-31,1955,1049,3004
1524,DLB,0.16417582712050116,0.02319034393994293,10315751424,2020-09-25,875,2130,3005
1525,IGIC,0.04654762492859142,0.04895150428233749,342248160,2020-12-31,1998,1009,3007
1526,OSG,0.03297301030222285,0.05969293260963184,209751568,2020-12-31,2285,722,3007
1527,FOR,0.05194805194805195,0.04642124134236155,1213630848,2020-09-30,1895,1113,3008
1528,VMW,0.12138152432611944,0.02994147646056072,64561881088,2021-01-29,1164,1846,3010
1529,WHLRD,0.0418380090437939,0.051529519293471285,16762660,2020-12-31,2083,929,3012
1530,PAGP,0.03650637038308095,0.0553338140988255,1837384448,2020-12-31,2191,822,3013
1531,MLAB,0.23973463404088582,0.013424194548629718,1236812032,2020-03-31,529,2486,3015
1532,ETG,0.053509995892908974,0.045505922084010095,1510743936,2020-10-31,1866,1153,3019
1533,NHS,0.05012020313934624,0.047009262557271655,252366896,2020-10-31,1930,1090,3020
1534,SLF,0.011187836133058893,0.09371283326786227,29967923200,2020-12-31,2717,303,3020
1535,ETN,0.1449557665773882,0.026080195385174414,55950082048,2020-12-31,993,2028,3021
1536,ENPH,0.278233526991513,0.009147230111431601,20522455040,2020-12-31,403,2621,3024
1537,SITE,0.17634915953995872,0.020800094843609278,8045660672,2021-01-03,798,2226,3024
1538,AMK,0.24425593296012638,0.012778042319400482,1619465344,2020-12-31,510,2515,3025
1539,LE,0.09220850490787517,0.03447949019947106,822616256,2021-01-29,1404,1621,3025
1540,GASS,0.029855576904716043,0.06304279342693678,108275024,2020-12-31,2376,649,3025
1541,NFLX,0.20004948349475457,0.017544404579983647,245944025088,2020-12-31,687,2342,3029
1542,KMT,0.08189842610802929,0.03601155096783097,3495020800,2020-06-30,1494,1537,3031
1543,LSCC,0.2867189489229516,0.00816301888822619,6841992704,2021-01-02,382,2650,3032
1544,BRKR,0.1581011229279306,0.023330082853977547,10398874624,2020-12-31,908,2124,3032
1545,ELF,0.2164818093139203,0.01540453068842683,1427061888,2020-03-31,620,2415,3035
1546,FE,0.05184014680395555,0.045929645285484946,18915123200,2020-12-31,1898,1137,3035
1547,PNW,0.04312734853212593,0.05016673016815493,9218995200,2020-12-31,2055,980,3035
1548,CMD,0.1651018276164801,0.02239396910215197,3540619008,2020-07-31,872,2170,3042
1549,NVDA,0.23827789834956847,0.013047401128062677,352792510464,2021-01-31,539,2504,3043
1550,PAAS,0.08146918042395233,0.035835012152271105,7022574080,2020-12-31,1496,1547,3043
1551,RUSHB,0.06769540987602345,0.03921612084115289,2792430336,2020-12-31,1657,1386,3043
1552,PDCE,0.04771232047570479,0.047463484992809196,3461623296,2020-12-31,1971,1072,3043
1553,PEG,0.04749068421469912,0.047528416524536654,30936946688,2020-12-31,1974,1069,3043
1554,FLC,0.05017181969935629,0.046189660853118895,248514944,2020-11-30,1926,1119,3045
1555,EMD,0.038201468106225475,0.05300962341377979,818856064,2020-12-31,2156,889,3045
1556,RUSHA,0.06769540987602345,0.039151666007923455,2798842880,2020-12-31,1657,1391,3048
1557,ORN,0.05065972762370777,0.04601326254773526,179108336,2020-12-31,1916,1133,3049
1558,PFO,0.050171578335879465,0.04615348724205963,171917920,2020-11-30,1927,1122,3049
1559,SSL,0.030528769785651548,0.06079385313457202,9082391552,2020-06-30,2351,699,3050
1560,DSP,0.2766135898641522,0.008194588426470636,2566056192,2020-12-31,408,2644,3052
1561,MX,0.11625422443172713,0.02994600227134992,1196450816,2020-12-31,1207,1845,3052
1562,JD,0.04727862339134466,0.04733367068443091,125466943488,2020-12-31,1979,1073,3052
1563,IFF,0.1833216046784926,0.01849663654076054,34908258304,2020-12-31,755,2300,3055
1564,GM,0.040686425973902506,0.05105000570746579,86685138944,2020-12-31,2107,948,3055
1565,ACH,0.03505535742261338,0.05481855487301877,9492687872,2020-12-31,2225,832,3057
1566,NTCO,0.055536200129370494,0.04299253414690352,11872394240,2020-12-31,1837,1221,3058
1567,DIN,0.09949272952386295,0.032456934534614665,1602921472,2020-12-31,1334,1726,3060
1568,HLIT,0.12214556033262107,0.028638530824032914,805767488,2020-12-31,1160,1901,3061
1569,LEA,0.08226926756228424,0.03525277597253676,10763816960,2020-12-31,1488,1575,3063
1570,SALM,0.069246232271965,0.03832065197349821,67113000,2020-12-31,1630,1433,3063
1571,BIP,0.04678619287463611,0.04725580640032216,16122876928,2020-12-31,1988,1075,3063
1572,RAVE,0.11905474125037392,0.029138341892172175,25566958,2020-06-28,1184,1881,3065
1573,DOW,0.06928853651516341,0.038218118551499,47053508608,2020-12-31,1629,1440,3069
1574,GTY,0.06212389336766528,0.04028702991879941,1301619072,2020-12-31,1732,1337,3069
1575,ERC,0.04069350478757056,0.05057236026553696,353901824,2020-10-31,2106,964,3070
1576,OGS,0.04994347064154965,0.04591830365579469,4127963904,2020-12-31,1933,1138,3071
1577,GBDC,0.048415606919147154,0.04656088707806327,2572458752,2020-09-30,1965,1107,3072
1578,WTRE,0.03469865349309578,0.05441312094443777,693658560,2020-12-31,2238,844,3082
1579,FCX,0.06372053642148963,0.03945183272799334,49698402304,2020-12-31,1708,1375,3083
1580,GNSS,0.13961819358417307,0.025584047250080406,243898704,2020-09-30,1035,2052,3087
1581,EIG,0.046534158384899056,0.04704223641417938,1140140672,2020-12-31,2000,1088,3088
1582,GLNG,0.03205412694931277,0.05665542569275722,1150819328,2020-12-31,2306,785,3091
1583,PSXP,0.06099025757373549,0.04016112605810383,7309163008,2020-12-31,1745,1348,3093
1584,AIRT,0.05609596173872797,0.04190420836266013,67694656,2020-03-31,1825,1268,3093
1585,CHH,0.16717051536082664,0.02017454807017747,6079610880,2020-12-31,850,2245,3095
1586,SAIA,0.12319957315002807,0.027539914900605,6205383680,2020-12-31,1148,1948,3096
1587,WHLR,0.0418380090437939,0.04876475224250599,37662152,2020-12-31,2083,1013,3096
1588,AMD,0.21719815960653657,0.013464717498514052,100521132032,2020-12-26,614,2483,3097
1589,AMP,0.01741407444194341,0.07519870787310232,28075872256,2020-12-31,2628,469,3097
1590,PZZA,0.13056815422123513,0.026396486828872242,3152424960,2020-12-27,1092,2006,3098
1591,WCN,0.13873317850370104,0.025344800852297653,30060951552,2020-12-31,1043,2057,3100
1592,CYH,0.06382978723404255,0.03909397370304765,1575728640,2020-12-31,1707,1395,3102
1593,NSSC,0.16680495739328566,0.01989098889987016,635444480,2020-06-30,854,2252,3106
1594,QLYS,0.15104476772260797,0.022659625690272488,4083874048,2020-12-31,954,2152,3106
1595,ORI,0.039249741354818304,0.050189043661303924,7076541440,2020-12-31,2133,976,3109
1596,IRS,0.035251421673208765,0.05287809215458657,380959136,2020-06-30,2219,892,3111
1597,NOVT,0.22757730585019303,0.01197987800887518,4805514752,2020-12-31,570,2542,3112
1598,USAK,0.046596580231133305,0.046162540832318334,161285760,2020-12-31,1997,1121,3118
1599,HCAP,0.043482610593788835,0.04747475433344484,52162940,2020-12-31,2050,1071,3121
1600,HQY,0.2227772811949176,0.012203710091145185,5755596288,2021-01-31,590,2532,3122
1601,TECH,0.24593284732496928,0.009318109445734898,15857845248,2020-06-30,505,2618,3123
1602,UBA,0.04661685936157221,0.04603998281692708,665065984,2020-10-31,1995,1131,3126
1603,AFT,0.04569985417299282,0.04619294702716881,235621008,2020-12-31,2012,1118,3130
1604,UBP,0.04661685936157221,0.04596629954412519,666631680,2020-10-31,1995,1136,3131
1605,SMTC,0.18664950579179526,0.01615805814598628,4601341952,2021-01-31,741,2391,3132
1606,CTRN,0.09253972265943636,0.03199647145228718,947286784,2021-01-30,1395,1738,3133
1607,IOSP,0.1072432721917258,0.029730855363167188,2547070720,2020-12-31,1276,1858,3134
1608,ACM,0.0923392558340715,0.03219723181365092,9790351360,2020-09-30,1401,1733,3134
1609,GRA,0.09022199188045261,0.032727040587034864,4150200832,2020-12-31,1424,1711,3135
1610,HUDI,0.06673401682229937,0.03774996137166655,72843752,2020-09-30,1672,1463,3135
1611,JPS,0.039248097640389355,0.049141026004912845,1982876544,2020-07-31,2134,1001,3135
1612,CCEP,0.12356687898089172,0.0265556058544485,24144414720,2020-12-31,1144,1997,3141
1613,TPR,0.10155977591296869,0.03036777228641833,12483262464,2020-06-27,1315,1826,3141
1614,CTRE,0.07020650037062104,0.036296519464631555,2310356736,2020-12-31,1621,1522,3143
1615,CMS,0.04990221862566593,0.043479926901828926,17498695680,2020-12-31,1934,1209,3143
1616,BBCP,0.07784046236395989,0.0347370769652878,412791296,2020-10-31,1541,1603,3144
1617,JHI,0.03838841644139589,0.049418397809791875,159921840,2020-10-31,2153,992,3145
1618,COOP,0.04731172360248447,0.04484105302037898,2828467968,2020-12-31,1977,1169,3146
1619,EVRG,0.0463314249850135,0.0457507079361889,13769395200,2020-12-31,2002,1146,3148
1620,DELL,0.0869788712422008,0.0330717923774818,71599177728,2021-01-29,1453,1696,3149
1621,QRHC,0.17855212665329703,0.016777565666998298,74942544,2020-12-31,783,2367,3150
1622,MPW,0.05775342034046648,0.03983928161801304,12545399808,2020-12-31,1794,1357,3151
1623,PHD,0.04116673780266207,0.047801388085867216,285963104,2020-11-30,2098,1058,3156
1624,CARS,0.17218437130153855,0.017653519597714207,922233152,2020-12-31,824,2334,3158
1625,CAT,0.08903937347320018,0.03253267238817302,125828898816,2020-12-31,1434,1724,3158
1626,OCN,0.0467516536390642,0.044850988233553664,242301344,2020-12-31,1991,1168,3159
1627,COG,0.06827227729394307,0.03637596364010526,6941919232,2020-12-31,1646,1515,3161
1628,TPCO,0.07682050431218565,0.03454797050162929,674441344,2020-12-27,1550,1615,3165
1629,EXPI,0.2704551681622029,0.00522570750381898,6045157376,2020-12-31,432,2734,3166
1630,PFD,0.05015273622071256,0.04262865990037031,206180144,2020-11-30,1928,1239,3167
1631,TDS,0.039082058414464535,0.04845953398100343,2656652544,2020-12-31,2137,1031,3168
1632,FCPT,0.06738417015803361,0.03641937771866949,2144774144,2020-12-31,1662,1509,3171
1633,VIAV,0.14050091631032377,0.022790764193031637,3742022912,2020-06-27,1025,2147,3172
1634,CYBE,0.09296521361691573,0.031051175651255564,190878784,2020-12-31,1385,1787,3172
1635,RACE,0.2028030322245823,0.01319350618931507,51646251008,2020-12-31,677,2497,3174
1636,TTWO,0.15836098336828058,0.01944374469921281,21195055104,2020-03-31,906,2269,3175
1637,AT,0.04919155933132365,0.042926185518412485,268119360,2020-12-31,1952,1224,3176
1638,AZN,0.1282225656877898,0.025278483502008908,131813122048,2020-12-31,1114,2063,3177
1639,VICI,0.05401338493616067,0.040712129345816105,15407132672,2020-12-31,1862,1315,3177
1640,DTE,0.050909369571881066,0.04204973047001319,26242260992,2020-12-31,1915,1262,3177
1641,ALTO,0.050502387367993305,0.04222492320075394,383404000,2020-12-31,1921,1257,3178
1642,EPM,0.05200028775095651,0.04124948576961931,104825584,2020-06-30,1894,1291,3185
1643,EGAN,0.13059655433881748,0.024213862272022203,300301856,2020-06-30,1091,2095,3186
1644,MTRX,0.06182402699891626,0.038010177748291026,362129632,2020-06-30,1738,1450,3188
1645,SMLP,0.034430746803289426,0.05123906003314011,128311888,2020-12-31,2248,940,3188
1646,LMRK,0.04296291462650114,0.046042275435376354,306377792,2020-12-31,2060,1130,3190
1647,INOV,0.19370546595144542,0.013303082787878003,4652073472,2020-12-31,705,2490,3195
1648,RYI,0.05775101064268625,0.03890148259552115,603017280,2020-12-31,1795,1401,3196
1649,ORGO,0.2217632043981936,0.009539045871470272,2923177472,2020-12-31,592,2608,3200
1650,PTC,0.18757177938343325,0.013925875382979971,16662287360,2020-09-30,734,2466,3200
1651,ED,0.040037682524729154,0.04712665384615714,25759856640,2020-12-31,2120,1081,3201
1652,LILA,0.06291265798905867,0.03699201084373712,3224244224,2020-12-31,1721,1488,3209
1653,LILAK,0.06291265798905867,0.03688347818212253,3261384448,2020-12-31,1721,1491,3212
1654,AFG,0.020336172457978443,0.06383451403467576,10074768384,2020-12-31,2581,633,3214
1655,NVMI,0.1484983151306876,0.020285415748475085,2731968512,2020-12-31,973,2242,3215
1656,PCF,0.0453885857708977,0.04401167199123608,49661872,2020-08-31,2020,1195,3215
1657,CLH,0.08352437854039597,0.032141584733466885,4837443584,2020-12-31,1481,1735,3216
1658,ECHO,0.1392812281256892,0.02212128932904213,843476800,2020-12-31,1039,2179,3218
1659,ADP,0.09644055271430582,0.02981869837084099,81068957696,2020-06-30,1362,1857,3219
1660,CPK,0.055691511399476264,0.03919566585777834,2032994176,2020-12-31,1834,1388,3222
1661,ATTO,0.05450050749242131,0.03953502113921437,331801504,2020-12-31,1853,1369,3222
1662,WEA,0.036938154693286714,0.04811071503144718,164425328,2020-12-31,2178,1045,3223
1663,AVAV,0.15967873203299585,0.01777672994775571,2792886272,2020-04-30,896,2329,3225
1664,HYT,0.03671508440900727,0.04829624500950075,1443343360,2020-12-31,2186,1040,3226
1665,PFG,0.005954656006537287,0.07888197819929615,16939182080,2020-12-31,2799,428,3227
1666,TSI,0.044837261093959434,0.043640110510584,270733440,2020-12-31,2025,1204,3229
1667,AIF,0.03621563340108342,0.0484269999770202,220720640,2020-12-31,2197,1033,3230
1668,VTSI,0.10053723459134851,0.028493699131928167,52486424,2020-12-31,1323,1908,3231
1669,VEEV,0.21691280747505579,0.009396084636445293,40222150656,2021-01-31,618,2614,3232
1670,NGG,0.05262895257738818,0.04011997745863885,43393454080,2020-03-31,1883,1351,3234
1671,ARKO,0.04623817886337363,0.042847044225018414,1270409856,2020-12-31,2004,1230,3234
1672,DY,0.08794663084403694,0.031016854132091605,2979233280,2021-01-30,1447,1789,3236
1673,SJI,0.044059326221162286,0.04380073723879568,2487457280,2020-12-31,2037,1199,3236
1674,USCR,0.06671076254370216,0.035489129806215436,1130641536,2020-12-31,1673,1564,3237
1675,CEQP,0.04668197751722471,0.042419269000437215,1704576512,2020-12-31,1992,1248,3240
1676,ASC,0.02645002049566139,0.05657405379372439,135761584,2020-12-31,2456,786,3242
1677,BVS,0.13477172266699639,0.022009621750475213,781347904,2020-12-31,1063,2181,3244
1678,OEC,0.06779408954813666,0.03492334714653067,1146700544,2020-12-31,1655,1592,3247
1679,INSE,0.10392291810048176,0.027504480789573717,215001456,2020-12-31,1301,1949,3250
1680,COLM,0.1099876004575893,0.026514680781742305,7153102336,2020-12-31,1251,2000,3251
1681,TACO,0.049789780771375865,0.0406836579262093,377129920,2020-12-29,1939,1317,3256
1682,SR,0.043826204635063565,0.04315969976300343,3934776064,2020-09-30,2040,1216,3256
1683,NTP,0.04891384315713015,0.04114699664843439,456995040,2020-12-31,1957,1301,3258
1684,SO,0.0444306762629006,0.04285568884413925,66281144320,2020-12-31,2030,1229,3259
1685,FTNT,0.17144451419404338,0.014889070887851671,32249806848,2020-12-31,827,2434,3261
1686,COO,0.14834089986343335,0.01890077224557969,18974781440,2020-10-31,974,2288,3262
1687,SNPS,0.1652344001804938,0.016042455834723038,39898869760,2020-10-31,868,2395,3263
1688,EYE,0.11670764987601194,0.025305796397399195,3854184448,2021-01-02,1203,2060,3263
1689,KODK,0.03850509626274066,0.04626085181619451,620962688,2020-12-31,2149,1115,3264
1690,KIRK,0.05914181788978085,0.036843664738310584,442439552,2021-01-30,1773,1494,3267
1691,ASTE,0.091005291005291,0.029869239416170753,1715429760,2020-12-31,1417,1851,3268
1692,KWR,0.13918397239358996,0.020644937325138606,4376721920,2020-12-31,1040,2230,3270
1693,ES,0.04859375686391445,0.040869473489016796,29587402752,2020-12-31,1962,1308,3270
1694,SBRA,0.04556578816336957,0.0421233403554719,3780316928,2020-12-31,2014,1259,3273
1695,DE,0.08081597839220982,0.031307759084463024,118166503424,2020-11-01,1502,1774,3276
1696,EXC,0.03615649651680401,0.047198949282550515,43788152832,2020-12-31,2198,1078,3276
1697,WEYS,0.048577775433290546,0.04071548424407046,211689920,2020-12-31,1963,1314,3277
1698,FCT,0.03664130359139494,0.04702312167530298,317256864,2020-05-31,2188,1089,3277
1699,ZM,0.22218874735804794,0.007140133609884523,94766817280,2021-01-31,591,2688,3279
1700,AHCO,0.15894520318169378,0.01648369340343893,4352336384,2020-12-31,899,2381,3280
1701,AEE,0.04540207772220085,0.04203381142796267,20568166400,2020-12-31,2018,1263,3281
1702,MPWR,0.20111557938096566,0.009802054620638304,17193185280,2020-12-31,684,2599,3283
1703,IDA,0.04442923944765262,0.04230697132208526,5022756352,2020-12-31,2031,1252,3283
1704,ALX,0.0766685175611593,0.032291132763457214,1466251904,2020-12-31,1553,1731,3284
1705,WYY,0.10291478897555605,0.026946931540399753,81132200,2020-12-31,1306,1979,3285
1706,MGEE,0.056842025548389005,0.03757424507585456,2610636032,2020-12-31,1814,1471,3285
1707,JQC,0.03513466477475376,0.04768976614845474,903155840,2020-07-31,2223,1062,3285
1708,ARLP,0.03322238561126626,0.04899646716220392,733915136,2020-12-31,2280,1005,3285
1709,IT,0.11947475098029292,0.023646886365173946,16696500224,2020-12-31,1179,2109,3288
1710,WLTW,0.07481958090600817,0.03255911687982345,30950699008,2020-12-31,1567,1721,3288
1711,MT,0.041012001510450015,0.04430310899954023,30134304768,2020-12-31,2102,1186,3288
1712,GLOB,0.1881270463305799,0.011011714812826427,8818896896,2020-12-31,730,2559,3289
1713,SMSI,0.17786263377380293,0.013072646929461237,288178432,2020-12-31,788,2501,3289
1714,TXT,0.060690852952527984,0.03585091242603486,13247881216,2021-01-02,1746,1544,3290
1715,CEE,0.046077829128366034,0.0416119190457412,159906880,2020-10-31,2009,1281,3290
1716,BCO,0.07805538724738924,0.03164847818509418,3964864000,2020-12-31,1538,1753,3291
1717,ORA,0.0618473990048853,0.03566262699861595,4278243584,2020-12-31,1737,1554,3291
1718,TYL,0.19766292165655258,0.009615519683777843,18023397376,2020-12-31,691,2604,3295
1719,PERI,0.14895815604561258,0.017847767946167367,614071424,2020-12-31,969,2327,3296
1720,ZBH,0.13359068926423948,0.020818441799860515,35305562112,2020-12-31,1073,2225,3298
1721,VRNT,0.08538389259834,0.0303263099114179,3039336448,2021-01-31,1470,1829,3299
1722,NGD,0.03812679260211651,0.045803779697008294,1221667200,2020-12-31,2159,1141,3300
1723,HRB,0.08003593426913981,0.03101283350461212,4143884288,2020-04-30,1511,1790,3301
1724,YUMC,0.09382620972917469,0.02803950608834262,25161359360,2020-12-31,1380,1925,3305
1725,THG,0.0387910480974028,0.04517839761305996,4902636032,2020-12-31,2144,1163,3307
1726,MSD,0.038475066966097565,0.04530497127435429,182868704,2020-12-31,2150,1158,3308
1727,WEC,0.05005973715651135,0.039170625968900724,29130422272,2020-12-31,1931,1389,3320
1728,FOE,0.06259116730264191,0.03479848320411733,1405243776,2020-12-31,1726,1596,3322
1729,DLTH,0.05614577729962345,0.036694087224344134,538443584,2021-01-31,1824,1501,3325
1730,AMT,0.1178775381897926,0.022956887675625523,106825465856,2020-12-31,1192,2141,3333
1731,ITT,0.10113463333169606,0.02611210106847623,7861032960,2020-12-31,1318,2025,3343
1732,ESLT,0.06573008738400653,0.03372707585693878,6333010944,2020-12-31,1681,1665,3346
1733,CGNX,0.16406763895945453,0.013762050576893746,15107219456,2020-12-31,876,2471,3347
1734,TCS,0.06641049864198835,0.03351506910463638,827508096,2020-03-28,1676,1671,3347
1735,CTVA,0.08356334529395529,0.029517671202407177,34906271744,2020-12-31,1480,1868,3348
1736,GSBD,0.04546489034160074,0.040327790252673495,2084811520,2020-12-31,2015,1333,3348
1737,OLO,0.22329975859485557,0.004032451595037318,3995122432,2020-12-31,588,2764,3352
1738,GPN,0.14903218667240795,0.01639357319812858,62942695424,2020-12-31,967,2385,3352
1739,WOOF,0.09208596390536318,0.02750072820730808,6568630784,2021-01-30,1405,1950,3355
1740,PRLB,0.1314351863038192,0.019412632526579935,3159671808,2020-12-31,1084,2272,3356
1741,CFX,0.10918677677967242,0.02417552118982976,5871289344,2020-12-31,1260,2096,3356
1742,GTIM,0.03777431990127166,0.04407312613087635,61782264,2020-09-29,2165,1191,3356
1743,GTLS,0.12400318979266348,0.02087209177870291,5228811776,2020-12-31,1138,2219,3357
1744,PRTH,0.10786295781512302,0.024447015105166472,480226272,2020-12-31,1271,2086,3357
1745,CAMT,0.14661965989216094,0.01653015329969478,1417081344,2020-12-31,981,2379,3360
1746,MOD,0.056867619639527654,0.035813386003599575,783146368,2020-03-31,1812,1549,3361
1747,NVST,0.10404850381380794,0.025048223008435094,6792112640,2020-12-31,1300,2065,3365
1748,CASA,0.11624825361160322,0.022535392712384028,836652224,2020-12-31,1208,2158,3366
1749,CNP,0.040905427189682965,0.04194540982528354,12818742272,2020-12-31,2103,1264,3367
1750,PSN,0.08907746675346415,0.027751260984589243,4278689792,2020-12-31,1433,1936,3369
1751,NNN,0.05432971134346426,0.036405053125681645,7943239680,2020-12-31,1857,1512,3369
1752,CSIQ,0.04761764862180358,0.03908648337124213,2560638464,2020-12-31,1972,1397,3369
1753,LINC,0.04285934430018877,0.04092751874388387,172729600,2020-12-31,2062,1307,3369
1754,COE,0.03838258697503859,0.04319402165588343,494598912,2020-12-31,2154,1215,3369
1755,CTLT,0.13038498250079542,0.019185928452416155,18599004160,2020-06-30,1094,2276,3370
1756,LTC,0.05771109185418064,0.03526854604197298,1699579776,2020-12-31,1797,1574,3371
1757,CLFD,0.1277646613949216,0.01986724636782886,428035936,2020-09-30,1117,2255,3372
1758,WPM,0.09009087693705506,0.027560906193850366,18829246464,2020-12-31,1427,1945,3372
1759,VALU,0.08855506195931728,0.027836266261156678,302544416,2020-04-30,1444,1931,3375
1760,AXL,0.04984268484530677,0.03814557131466136,1087840512,2020-12-31,1938,1445,3383
1761,PAYA,0.17153197687248975,0.011057801138716792,1457110400,2020-12-31,826,2558,3384
1762,EEIQ,0.12666707534803667,0.01961898031057294,66723840,2020-09-30,1126,2262,3388
1763,DGII,0.12230784601617682,0.020449628263002707,622342272,2020-09-30,1157,2235,3392
1764,BRKS,0.16732142523611776,0.011407175199194477,7102862848,2020-09-30,848,2547,3395
1765,KN,0.10536317567567567,0.02352565555809161,1971588608,2020-12-31,1287,2113,3400
1766,CCRN,0.09561451826502748,0.02604924480657849,478659520,2020-12-31,1369,2031,3400
1767,NKE,0.15383475727196405,0.013946786606237167,214006939648,2020-05-31,936,2465,3401
1768,RGEN,0.19124267327330957,0.00697491251946206,11288365056,2020-12-31,714,2694,3408
1769,WWW,0.11734766011593384,0.021050815308729126,3171740160,2021-01-02,1195,2214,3409
1770,BDL,0.031824641959112276,0.04678220698621148,45555512,2020-10-03,2314,1096,3410
1771,BLK,0.04236536243456659,0.04024224390481428,123381686272,2020-12-31,2071,1340,3411
1772,ULTA,0.11356225680879103,0.021922096267750938,18110568448,2021-01-30,1225,2188,3413
1773,SRE,0.04151212987170912,0.04051486335107012,40647360512,2020-12-31,2092,1323,3415
1774,ODC,0.05636739546788335,0.03490735926349476,261536176,2020-07-31,1823,1593,3416
1775,MCHP,0.15689608269858543,0.012898465317047234,43547746304,2020-03-31,912,2512,3424
1776,WBA,0.055412490505215184,0.03493633801669674,46832865280,2020-08-31,1838,1589,3427
1777,NWN,0.03502699442541612,0.043711870103748676,1662545664,2020-12-31,2227,1201,3428
1778,RGCO,0.045167014992574084,0.0387579834975415,183779392,2020-09-30,2024,1408,3432
1779,HGBL,0.10061802498777289,0.02358139614369667,105361480,2020-12-31,1322,2112,3434
1780,ISSC,0.097918594918983,0.024345463184387444,111727512,2020-09-30,1347,2087,3434
1781,IQV,0.14484978540772533,0.014725576340878259,39822336000,2020-12-31,994,2443,3437
1782,BECN,0.09287391575214453,0.02552849356090776,3839617280,2020-09-30,1387,2053,3440
1783,TA,0.01705169194497074,0.05562534722842548,405009856,2020-12-31,2634,811,3445
1784,NARI,0.2040571806313006,0.0036558865997182908,5504278528,2020-12-31,672,2774,3446
1785,FTF,0.03877836735704096,0.04114546468462783,275468640,2020-12-31,2145,1302,3447
1786,SNN,0.10975918884664132,0.021633504746846194,16882249728,2020-12-31,1254,2196,3450
1787,DBD,0.07848324514991181,0.02820437821189769,1072607680,2020-12-31,1532,1918,3450
1788,ATNI,0.04676101362113087,0.0377843254316363,768056576,2020-12-31,1990,1460,3450
1789,SLP,0.16085565788113512,0.010814114125706974,1247793792,2020-08-31,889,2568,3457
1790,BPY,0.030323231287284414,0.0467362099222194,16521441280,2020-12-31,2359,1098,3457
1791,RGLD,0.08136117663609803,0.027321600519087587,7256735232,2020-06-30,1498,1960,3458
1792,IPGP,0.11993839111281959,0.019051007912323427,12779005952,2020-12-31,1176,2283,3459
1793,BPYPP,0.030323231287284414,0.04665536246473042,16652992512,2020-12-31,2359,1100,3459
1794,POWI,0.13946830023070927,0.015011499847742965,4891881472,2020-12-31,1038,2425,3463
1795,INFU,0.12215441247699312,0.01828827149095039,439932064,2020-12-31,1159,2306,3465
1796,MRVI,0.15729899404185405,0.011096781016217305,8929143808,2020-12-31,911,2556,3467
1797,FREE,0.08808740340888084,0.026131585965821442,508769504,2020-12-31,1446,2023,3469
1798,TGH,0.03841147186445897,0.04051742468354134,1411117056,2020-12-31,2152,1322,3474
1799,CORE,0.05818740399385561,0.03320322996533232,1871132160,2020-12-31,1788,1687,3475
1800,R,0.039481656638988075,0.04016448348416291,4153837312,2020-12-31,2128,1347,3475
1801,EVF,0.03785122707359151,0.04071676966398944,252948880,2020-06-30,2164,1313,3477
1802,NICE,0.13407847347658974,0.015566344357741778,14636354560,2020-12-31,1070,2409,3479
1803,LUNA,0.10725487241998001,0.021222100755889442,338466112,2020-12-31,1275,2205,3480
1804,LIN,0.09424997130724205,0.02400584322008627,148903690240,2020-12-31,1379,2101,3480
1805,PMF,0.032030670878246625,0.044605735010548715,376663200,2020-12-31,2307,1175,3482
1806,HIMX,0.11239146673910302,0.020005167650529787,2675747840,2020-12-31,1235,2248,3483
1807,HDSN,0.0722608440223245,0.0290465139381547,88863192,2020-12-31,1600,1885,3485
1808,SWI,0.13686484399041798,0.01489276748328567,5611794944,2020-12-31,1053,2433,3486
1809,VER,0.05013891952200253,0.03552652249365208,9245940736,2020-12-31,1929,1560,3489
1810,PQG,0.06670140851014938,0.03052890968595786,2259262464,2020-12-31,1674,1816,3490
1811,ALTM,0.03540264287201345,0.041672839957158744,888196096,2020-12-31,2212,1278,3490
1812,APPS,0.20757266300078556,0.001687131095224621,7751265280,2020-03-31,660,2831,3491
1813,CIF,0.03452969543706201,0.04246338883513478,49515416,2020-11-30,2245,1246,3491
1814,VRRM,0.14367409316754876,0.01330757484864244,2289276160,2020-12-31,1003,2489,3492
1815,INSI,0.04057034269406436,0.039224996468895254,214628416,2020-03-31,2108,1384,3492
1816,HPE,0.05210754444374647,0.03462586741492135,20545157120,2020-10-31,1892,1609,3501
1817,DSEY,0.1273317112733171,0.016429624524481785,4499318272,2020-12-31,1122,2383,3505
1818,XRAY,0.12849691797060217,0.01601760800351306,14062880768,2020-12-31,1110,2397,3507
1819,CATM,0.07896261007322156,0.026913701896971193,1756760320,2020-12-31,1527,1981,3508
1820,SLB,0.0820289280760848,0.026243763641197727,37417705472,2020-12-31,1492,2017,3509
1821,LGL,0.060130885602583714,0.03174110100659892,59513424,2020-12-31,1760,1749,3509
1822,ONTF,0.1545980224929046,0.010322196999489356,2034806272,2020-12-31,932,2580,3512
1823,FND,0.11802772107749064,0.017928972895674966,11370060800,2020-12-31,1191,2324,3515
1824,ARNC,0.04467871485943775,0.03695305558223188,2852922368,2020-12-31,2028,1489,3517
1825,ABB,0.09260535643954312,0.02329945503947609,63925501952,2020-12-31,1393,2126,3519
1826,SQM,0.09429281993783327,0.02295614810585884,14091567104,2020-12-31,1378,2142,3520
1827,IDT,0.06757546088717303,0.029679735533191667,578561984,2020-07-31,1659,1861,3520
1828,DSM,0.03644135418463454,0.04032826367214482,396360448,2020-11-30,2193,1332,3525
1829,WOR,0.08049669915121031,0.02620890356033308,3455927040,2020-05-31,1507,2019,3526
1830,NERV,0.10564169619166429,0.020101747717959466,114066672,2020-12-31,1285,2246,3531
1831,MUA,0.04040824938062921,0.03853567240971757,554134208,2020-04-30,2113,1418,3531
1832,NYT,0.10196925336276728,0.02085733638641618,8161760256,2020-12-27,1312,2222,3534
1833,PRMW,0.08505253470358157,0.025281893523129224,2666038528,2021-01-02,1472,2062,3534
1834,CNEY,0.08240774831260154,0.025670713993561474,71920000,2020-09-30,1486,2048,3534
1835,BAM,0.032982502948941186,0.04233087984905433,68513996800,2020-12-31,2284,1251,3535
1836,MTOR,0.0662613981762918,0.029713765605778736,2072333440,2020-09-30,1677,1859,3536
1837,DSU,0.03231650088913818,0.042588253780489166,518566752,2020-12-31,2294,1242,3536
1838,SWN,0.04959016393442623,0.034931912171809895,2778762752,2020-12-31,1946,1591,3537
1839,CRK,0.03817159432995581,0.03930574028491291,1217833600,2020-12-31,2158,1380,3538
1840,ABST,0.10789614287610536,0.019315875964971276,716992576,2020-06-30,1268,2273,3541
1841,MHI,0.039420636735217694,0.038615999030083115,286462944,2020-04-30,2131,1414,3545
1842,GLW,0.05858987090367428,0.03143525777296102,34420088832,2020-12-31,1783,1765,3548
1843,TMDI,0.10511358413598608,0.019579543610166814,196914912,2020-12-31,1290,2264,3554
1844,MU,0.07233871539679913,0.02735921045289259,106871332864,2020-09-03,1597,1957,3554
1845,AWK,0.054057433418080274,0.03309440449096734,27524915200,2020-12-31,1861,1695,3556
1846,OIIM,0.07335732975600685,0.027097347448851707,207506688,2020-12-31,1583,1974,3557
1847,CVGW,0.0911741558910009,0.022840990570790008,1358475008,2020-10-31,1413,2146,3559
1848,CNMD,0.12772262853202185,0.014727904382504696,3880940032,2020-12-31,1118,2442,3560
1849,KAR,0.06068863929294789,0.030509753766855646,2023351296,2020-12-31,1747,1817,3564
1850,ATEN,0.08843947932771433,0.023405725717617464,733136128,2020-12-31,1445,2120,3565
1851,HSTM,0.09224320866089905,0.02246382470192436,696955584,2020-12-31,1403,2164,3567
1852,PAI,0.03593223533419871,0.039603821994730275,139981344,2020-12-31,2201,1366,3567
1853,PDT,0.0337170748435883,0.04115813000891695,733763136,2020-10-31,2268,1300,3568
1854,BTZ,0.031328715792723436,0.04263554583877922,1359184640,2020-12-31,2330,1238,3568
1855,EXR,0.07068191273188704,0.027427873227469736,18499745792,2020-12-31,1617,1953,3570
1856,NTR,0.05692486067995661,0.031541286934827106,31181213696,2020-12-31,1811,1761,3572
1857,AGFS,0.08002966839732317,0.025293168978533776,112747728,2020-12-31,1512,2061,3573
1858,BHE,0.05407563222538888,0.03270025664372745,1119485312,2020-12-31,1860,1713,3573
1859,FLL,0.07253677211364094,0.026776765560587903,323394240,2020-12-31,1591,1984,3575
1860,VNDA,0.060555737110869534,0.030375281060839747,891843904,2020-12-31,1750,1825,3575
1861,BNL,0.04442225895913343,0.03590261097037711,2707004416,2020-12-31,2033,1543,3576
1862,ILMN,0.14194542253521128,0.010939864956260802,58851680256,2021-01-03,1015,2562,3577
1863,NWE,0.03869298159468096,0.03834826154337165,3368082176,2020-12-31,2147,1431,3578
1864,SEB,0.039945139722269846,0.037809454514970475,4455479808,2020-12-31,2122,1457,3579
1865,NEOG,0.12780168905746656,0.014027955875595908,4831239680,2020-05-31,1116,2464,3580
1866,RXT,0.10559117876191047,0.01860546767972364,5375034368,2020-12-31,1286,2295,3581
1867,DVD,0.03678367917428234,0.03905648438100224,76717992,2020-12-31,2183,1398,3581
1868,BLW,0.03209152641291646,0.04164797013102576,605185792,2020-12-31,2304,1280,3584
1869,W,0.14480486391391484,0.009937032327302553,33965950976,2020-12-31,996,2594,3590
1870,PW,0.1059795277167278,0.018244050197549027,164631584,2020-12-31,1283,2308,3591
1871,WSC,0.06846362228293246,0.027480814221779774,6730042880,2020-12-31,1641,1951,3592
1872,HMN,0.014690999932109039,0.051755431841208906,1734360064,2020-12-31,2670,927,3597
1873,KEP,0.01978224379356265,0.048860102778923935,13659231232,2020-12-31,2588,1011,3599
1874,USX,0.0410303806269449,0.03672788433872682,579911808,2020-12-31,2101,1499,3600
1875,PNI,0.03012935114102429,0.0427047918353804,125202376,2020-12-31,2364,1237,3601
1876,PESI,0.06704881361348566,0.02777314478371198,92699160,2020-12-31,1667,1935,3602
1877,ATRS,0.10132279855965241,0.01880565564096374,689460032,2020-12-31,1316,2289,3605
1878,ALB,0.07283827222068776,0.026232808747616482,17194897408,2020-12-31,1589,2018,3607
1879,OHI,0.05235513730788687,0.032552958459797304,8712460288,2020-12-31,1886,1722,3608
1880,PML,0.034920080692350426,0.03939556696460893,927091264,2020-12-31,2232,1376,3608
1881,PMX,0.031156615122092245,0.04175722539297153,413109088,2020-12-31,2333,1276,3609
1882,HSC,0.06503675942731131,0.028198233994884782,1402924672,2020-12-31,1693,1919,3612
1883,YALA,0.1811426265618683,0.001223144426676277,3288800512,2020-12-31,769,2845,3614
1884,HTD,0.032281088179253695,0.04058226783602462,838998976,2020-10-31,2296,1319,3615
1885,DUK,0.03771330015142359,0.03804515310058558,75029430272,2020-12-31,2168,1449,3617
1886,RAND,0.03539539624589984,0.038789380380039255,45601120,2020-12-31,2213,1404,3617
1887,CULP,0.051079790096878366,0.032819260732589874,184995248,2020-05-03,1912,1707,3619
1888,AEP,0.036735162031070044,0.0382698910388305,42658299904,2020-12-31,2185,1436,3621
1889,CNO,0.01391452288019261,0.05121674287880779,3372316416,2020-12-31,2681,941,3622
1890,SBAC,0.11149060859736382,0.01621100734955313,30118582272,2020-12-31,1241,2387,3628
1891,SHLX,0.08738828202581926,0.02199086903932097,5549321728,2020-12-31,1451,2182,3633
1892,DD,0.07051816061312896,0.02624478052114034,40549064704,2020-12-31,1620,2015,3635
1893,GO,0.07305162223926098,0.025647814713507928,3609963520,2021-01-02,1587,2049,3636
1894,ELS,0.076869278582444,0.024277131799020777,11867729920,2020-12-31,1549,2091,3640
1895,CAPL,0.05269671205070757,0.03159533329736981,735775232,2020-12-31,1882,1759,3641
1896,NATI,0.10718228883007017,0.016815045534169196,5802088448,2020-12-31,1278,2365,3643
1897,HIW,0.04799995423984206,0.03332515445619925,4477012992,2020-12-31,1967,1677,3644
1898,AVA,0.035326840448652294,0.03838118798649543,3297209856,2020-12-31,2216,1428,3644
1899,EVOL,0.07737249328912048,0.024078207590708996,34690704,2020-12-31,1545,2100,3645
1900,DGICA,0.03518067280237042,0.03841571414378,456327264,2020-12-31,2220,1425,3645
1901,PZC,0.03150371784565916,0.04051881766135297,239700512,2020-12-31,2324,1321,3645
1902,PCYG,0.11173816528178239,0.015619709203323201,105428408,2020-06-30,1240,2407,3647
1903,ETR,0.03239698031400889,0.039867093252718054,20336017408,2020-12-31,2292,1355,3647
1904,FCO,0.04281061756509849,0.034998572557145856,73821816,2020-10-31,2063,1586,3649
1905,IDCC,0.07983121532490761,0.023110427009107787,2196867584,2020-12-31,1516,2134,3650
1906,ISNS,0.04954367666232073,0.032975766824881646,24996782,2020-12-31,1947,1703,3650
1907,YORW,0.057612726795949205,0.029851795237715115,634489344,2020-12-31,1799,1853,3652
1908,IR,0.12348100292262729,0.012962511133097526,21181134848,2020-12-31,1146,2507,3653
1909,SIG,0.03984854903622114,0.036090032315413,3197226496,2021-01-30,2123,1533,3656
1910,DGICB,0.03518067280237042,0.038259567224985,463176384,2020-12-31,2220,1437,3657
1911,PSO,0.07334963325183375,0.0246825626626585,8348463616,2020-12-31,1584,2074,3658
1912,FAM,0.026731450067771646,0.043357408547026514,100557056,2020-12-31,2449,1211,3660
1913,APTV,0.09575599952713086,0.01851680636333048,38522044416,2020-12-31,1366,2298,3664
1914,NMCO,0.038815579842492016,0.03626732932821336,759184128,2020-10-31,2142,1526,3668
1915,MTW,0.04680851063829787,0.03324576519674203,715976832,2020-12-31,1986,1683,3669
1916,ABCM,0.13259833134684149,0.01009994986648166,4433662464,2020-06-30,1082,2588,3670
1917,ADSK,0.13503224464322863,0.00948093774756319,65343991808,2021-01-31,1062,2611,3673
1918,MTDR,0.04408895898968429,0.03409921165924697,2739306752,2020-12-31,2035,1639,3674
1919,CBB,0.0490497484628284,0.0325401579294198,784501504,2020-12-31,1954,1723,3677
1920,GDDY,0.10638001808947332,0.01594453805831384,14539881472,2020-12-31,1282,2398,3680
1921,VITL,0.11099499522382698,0.014771566112753473,923979264,2020-12-27,1244,2438,3682
1922,GMED,0.09800563223444218,0.017596432396355492,6680844288,2020-12-31,1346,2337,3683
1923,PYN,0.028157261507412868,0.04205177904239028,57108160,2020-12-31,2422,1261,3683
1924,LPTH,0.07529480781125472,0.02330295354697369,81000376,2020-06-30,1563,2125,3688
1925,USM,0.03578049684835002,0.037080731359841426,3117859584,2020-12-31,2205,1483,3688
1926,AGO,0.024427480916030534,0.04423539811073121,3365830656,2020-12-31,2504,1189,3693
1927,OLP,0.04328244863813387,0.03400315457050934,485807520,2020-12-31,2052,1646,3698
1928,AA,0.031818181818181815,0.03921764940793772,5843026432,2020-12-31,2315,1385,3700
1929,BGR,0.037986385097823025,0.03600939401034168,255572624,2020-12-31,2163,1538,3701
1930,BKR,0.05188041464269618,0.03067602347129389,20933304320,2020-12-31,1896,1809,3705
1931,NZF,0.036889494487234,0.03624312602618178,2325178624,2020-10-31,2179,1527,3706
1932,CELH,0.16086485304677442,0.0020445350401901304,3886222336,2020-12-31,888,2821,3709
1933,POSH,0.13891939706606982,0.0077372839695427275,3039427072,2020-12-31,1042,2668,3710
1934,XEL,0.03926682065419864,0.03511144914421515,36282396672,2020-12-31,2132,1581,3713
1935,TTD,0.15079676296419456,0.004260138110936094,32813215744,2020-12-31,956,2760,3716
1936,WPC,0.052297669279941596,0.030290918016779227,12460473344,2020-12-31,1887,1830,3717
1937,EHTH,0.06018804885206673,0.027333291404140526,1910195456,2020-12-31,1759,1959,3718
1938,HRMY,0.12692885378447652,0.009925574993128879,1611178624,2020-12-31,1124,2595,3719
1939,GSKY,0.04299289588608373,0.033836167566801016,1134438784,2020-12-31,2059,1660,3719
1940,BH,0.02690435387917177,0.041764974606471446,415309376,2020-12-31,2444,1275,3719
1941,MTRN,0.056045680253733236,0.028764731570316285,1369992576,2020-12-31,1828,1896,3724
1942,SOHU,0.030632396917244537,0.03935272493381798,742889024,2020-12-31,2347,1377,3724
1943,OSTK,0.10477976938171145,0.014861628732093046,3083064064,2020-12-31,1292,2436,3728
1944,VFL,0.03596450269338517,0.036193546439507875,60409392,2020-03-31,2200,1528,3728
1945,MMT,0.03311726740895617,0.03800051238490056,393063552,2020-10-31,2282,1452,3734
1946,ON,0.08568209750102417,0.01944307443151217,17960587264,2020-12-31,1466,2270,3736
1947,SPG,0.053629547140947045,0.02926612788411576,38040387584,2020-12-31,1864,1878,3742
1948,WLK,0.04654552521620834,0.03178260236684952,11461138432,2020-12-31,1999,1745,3744
1949,GENC,0.041380753763585534,0.033972220542157365,190026672,2020-09-30,2096,1649,3745
1950,GIM,0.033374684860305245,0.03747040053497501,727060480,2020-12-31,2274,1472,3746
1951,EPAC,0.09895985806947682,0.01563123310532068,1586579968,2020-08-31,1341,2406,3747
1952,OPK,0.09694765999296238,0.016134388316013243,2800746240,2020-12-31,1356,2392,3748
1953,LEO,0.029451943349812004,0.03979560349079378,543091520,2020-09-30,2390,1358,3748
1954,PNF,0.027410549855301235,0.04085981135169714,96608104,2020-12-31,2439,1309,3748
1955,UHAL,0.04300497326588978,0.033149591567296056,12050365440,2020-03-31,2057,1692,3749
1956,DMF,0.028763288428441593,0.04019843964079223,184267104,2020-09-30,2404,1346,3750
1957,DCUE,0.03964879037588684,0.03428310847052585,60400812032,2020-12-31,2126,1626,3752
1958,ISRG,0.11585972200738072,0.011372143909590916,92865167360,2020-12-31,1209,2548,3757
1959,CYAN,0.03866632394521353,0.03455390320299916,20547126,2020-03-31,2148,1612,3760
1960,SCD,0.03212012793044943,0.037790457859701455,234936416,2020-11-30,2302,1459,3761
1961,HUN,0.04789053591790194,0.03098329530223998,6219415040,2020-12-31,1969,1793,3762
1962,COMM,0.08625128733264675,0.018470701761838088,3559464960,2020-12-31,1462,2301,3763
1963,CUB,0.07305822168835605,0.022184189866609333,2376069632,2020-09-30,1586,2177,3763
1964,CWT,0.040399565012477226,0.03393561007507765,2895010048,2020-12-31,2114,1650,3764
1965,FIS,0.10915766433665183,0.012939526508661117,93125869568,2020-12-31,1261,2510,3771
1966,DAVA,0.14071103256066889,0.004523403503292697,5058761216,2020-06-30,1019,2755,3774
1967,RBBN,0.07293047389230647,0.021913793115656027,1186560512,2020-12-31,1588,2189,3777
1968,D,0.03964879037588684,0.033928493815239553,61498032128,2020-12-31,2126,1651,3777
1969,FAX,0.03410591309051606,0.03629927343260078,1037846272,2020-10-31,2256,1521,3777
1970,SJW,0.04113751023650491,0.03323957319227289,1895699840,2020-12-31,2099,1684,3783
1971,MYD,0.03391244872211195,0.03628614865239546,684089088,2020-04-30,2262,1524,3786
1972,NMI,0.036486969805944354,0.03479695613481208,106145192,2020-10-31,2192,1598,3790
1973,ADM,0.046111423173160394,0.031086665461342203,32694648832,2020-12-31,2008,1785,3793
1974,CXE,0.03538273817305318,0.03516617458268778,165172656,2020-11-30,2214,1579,3793
1975,CMU,0.03482630678064529,0.03551207839930723,128596864,2020-11-30,2234,1562,3796
1976,LNT,0.040353942399819646,0.033269025014250594,13509520384,2020-12-31,2117,1681,3798
1977,PGNY,0.13908593473211825,0.004340900909975298,4062181120,2020-12-31,1041,2759,3800
1978,AVT,0.04622922753336207,0.030908726185252738,4302440448,2020-06-27,2005,1798,3803
1979,KNSL,0.0650281773873714,0.023622147004865895,3865506048,2020-12-31,1694,2110,3804
1980,BGT,0.028990567257324303,0.038779164170817615,283529568,2020-12-31,2400,1405,3805
1981,VOD,0.040372583938611296,0.03319306051238252,52233953280,2020-03-31,2116,1690,3806
1982,PTR,0.016394993124212012,0.045270985386803124,112395517952,2020-12-31,2647,1161,3808
1983,PCK,0.027555324611810733,0.03947896005718953,294467168,2020-12-31,2436,1373,3809
1984,PMM,0.0316392883845938,0.03686586250261606,407135360,2020-10-31,2321,1493,3814
1985,NEN,0.049703116827275726,0.029375499048385923,208020960,2020-12-31,1942,1874,3816
1986,LRN,0.06438334811884085,0.023385527409269618,1369554176,2020-06-30,1701,2121,3822
1987,CVGI,0.05685964756140975,0.02635844077072528,323180192,2020-12-31,1813,2009,3822
1988,AMZN,0.10300481309882596,0.01262208697537199,1698121777152,2020-12-31,1304,2519,3823
1989,MVT,0.03463744200291084,0.03505119211060593,329909760,2020-04-30,2239,1584,3823
1990,BFK,0.034617283685874495,0.03505132408001319,680725888,2020-04-30,2240,1583,3823
1991,PBI,0.043790429800937516,0.031163212372617616,1444938368,2020-12-31,2042,1782,3824
1992,KRMD,0.1134504717991447,0.009766637355371798,152996064,2020-12-31,1226,2600,3826
1993,MATW,0.06501061811058845,0.023142127959237698,1304680832,2020-09-30,1695,2131,3826
1994,SEDG,0.11223807391811168,0.010084026271594191,13614963712,2020-12-31,1237,2590,3827
1995,ASH,0.056548491063580425,0.026368765971219985,5387265536,2020-09-30,1820,2007,3827
1996,PNM,0.034271070605182155,0.03517118834039567,4235951872,2020-12-31,2252,1578,3830
1997,BSD,0.033798162937302485,0.03550286595937159,107868592,2020-04-30,2267,1563,3830
1998,ITRI,0.090789273363927,0.015519232013464388,4133147648,2020-12-31,1420,2411,3831
1999,SCVL,0.05217367679697721,0.027676787344421645,877650432,2021-01-30,1891,1940,3831
2000,PEO,0.03666029010234183,0.034020787343350484,357105632,2020-12-31,2187,1644,3831
2001,CWST,0.08478661489317527,0.017107811765438245,3352499712,2020-12-31,1474,2359,3833
2002,MNR,0.04323754534576741,0.031234232722722848,1764495872,2020-09-30,2054,1780,3834
2003,EVA,0.05837408219262075,0.02563718332216544,1916706176,2020-12-31,1786,2051,3837
2004,MVF,0.034409528617666045,0.03498373733065171,606874304,2020-08-31,2250,1587,3837
2005,BXP,0.04263454444175048,0.031337329720382015,16347190272,2020-12-31,2067,1772,3839
2006,CWEN,0.04157018414378653,0.03170068109947608,5600488960,2020-12-31,2089,1750,3839
2007,MYJ,0.03157508199600772,0.036356864235569726,357999744,2020-07-31,2323,1516,3839
2008,MHD,0.03293287084692552,0.035742804055477764,232896976,2020-04-30,2288,1552,3840
2009,LSI,0.052876485661229475,0.027243419993048745,6746320896,2020-12-31,1876,1965,3841
2010,PMO,0.030557292703783313,0.03684227294672312,462528608,2020-04-30,2348,1495,3843
2011,OFC,0.04234494082394543,0.03125562237882089,3023838208,2020-12-31,2072,1779,3851
2012,CPSH,0.12668807428822523,0.005561659093772158,162613824,2020-12-26,1125,2727,3852
2013,MTN,0.08094295124327189,0.017244644873147006,12264269824,2020-07-31,1501,2353,3854
2014,SILC,0.05904982445656234,0.024586016884376338,312824224,2020-12-31,1774,2080,3854
2015,RP,0.10297422627564376,0.011232066382741669,8978991104,2020-12-31,1305,2551,3856
2016,KMX,0.05061453751643204,0.027696122320023314,21478330368,2021-02-28,1917,1939,3856
2017,BMBL,0.13025845723979643,0.004141746546949512,6944862208,2020-12-31,1097,2761,3858
2018,VTRS,0.0648317058339593,0.022507822122000823,16168836096,2020-12-31,1697,2161,3858
2019,AMRK,0.04382203182126029,0.030508958529544328,393478400,2020-06-30,2041,1818,3859
2020,GSHD,0.12515786236364945,0.005013990887921557,3739870720,2020-12-31,1131,2738,3869
2021,XPO,0.058088557650153444,0.024496830805988582,13422451712,2020-12-31,1793,2083,3876
2022,IHC,0.028880827410308046,0.037428796581600976,607535104,2020-12-31,2402,1474,3876
2023,BRX,0.0436830254191208,0.030137007403416485,6066361856,2020-12-31,2043,1837,3880
2024,KRA,0.046219123809019866,0.029276341166542312,1174974976,2020-12-31,2006,1876,3882
2025,AMSWA,0.10788440956118445,0.00940500130102518,675418112,2020-04-30,1270,2613,3883
2026,MYTE,0.11248779066316261,0.00811327475137688,2282588160,2020-06-30,1234,2652,3886
2027,SKT,0.04701817018884812,0.028543829717898078,1669811456,2020-12-31,1983,1906,3889
2028,MHF,0.034212826356605046,0.03411245008810575,168736624,2020-10-31,2254,1636,3890
2029,NXN,0.034761791757641006,0.03385729895055394,55653288,2020-03-31,2236,1655,3891
2030,MET,0.010593208885428999,0.044887327653393136,54761984000,2020-12-31,2726,1167,3893
2031,NXR,0.03510746768356815,0.03340658470264047,223272672,2020-03-31,2224,1674,3898
2032,SHOO,0.08676580218839254,0.014706000524855841,3153930752,2020-12-31,1455,2445,3900
2033,BLE,0.03216882129078936,0.03474587891784941,370331776,2020-08-31,2298,1602,3900
2034,ECOL,0.06284025192185375,0.022128454390425933,1340303744,2020-12-31,1724,2178,3902
2035,STOR,0.04362751667942564,0.029822631545653486,9093832704,2020-12-31,2047,1856,3903
2036,MERC,0.03843996063874216,0.031609657749661055,1039398592,2020-12-31,2151,1757,3908
2037,RAVN,0.09064768503201448,0.01332241854632828,1377388800,2021-01-31,1421,2488,3909
2038,VCF,0.034319094296004264,0.03384008711354306,70573288,2020-03-31,2251,1658,3909
2039,TSEM,0.05150195410180339,0.026339966493032586,3248311808,2020-12-31,1902,2010,3912
2040,ALGN,0.10788539105113933,0.008192821309693961,46892589056,2020-12-31,1269,2645,3914
2041,DSWL,0.02767319552892574,0.037041725807929256,59204544,2020-03-31,2432,1484,3916
2042,MFM,0.028319173288880967,0.03666741942467655,282546944,2020-10-31,2415,1502,3917
2043,MMX,0.055285135201133054,0.024628874195884665,796463616,2020-12-31,1842,2078,3920
2044,RVI,0.02644748791763455,0.037734833967043094,420822656,2020-12-31,2457,1464,3921
2045,MMD,0.03531474484302597,0.03281481957920603,619474816,2020-05-31,2217,1708,3925
2046,IGT,0.07069317322702623,0.01800848817160679,3405438208,2020-12-31,1616,2315,3931
2047,CUBE,0.054156172343232355,0.024650506802712725,7926583296,2020-12-31,1859,2077,3936
2048,MUJ,0.030967796881875415,0.03480523333583848,449806880,2020-07-31,2341,1595,3936
2049,PACK,0.10304158907510863,0.008484344442304618,1505244800,2020-12-31,1303,2636,3939
2050,BV,0.07648290300069784,0.01641385842242472,1912642176,2020-09-30,1556,2384,3940
2051,NXC,0.03409378590229389,0.03325039505819262,100524104,2020-03-31,2258,1682,3940
2052,NMZ,0.030362870193897815,0.035094575652736604,1230090112,2020-10-31,2358,1582,3940
2053,SAND,0.05814034251216889,0.02274369369922433,1472126080,2020-12-31,1791,2151,3942
2054,COR,0.06550019004376866,0.019680330410035342,5200766976,2020-12-31,1683,2261,3944
2055,NXP,0.036417247799100216,0.0316582964845235,300860352,2020-03-31,2194,1751,3945
2056,JYNT,0.10831247284503417,0.007484718813784414,726790912,2020-12-31,1266,2680,3946
2057,NBH,0.03460540475485843,0.032828318972446265,300525024,2020-10-31,2241,1706,3947
2058,KLIC,0.07563395903003008,0.016188769964926675,3366435584,2020-10-03,1561,2388,3949
2059,NXGN,0.0833463304739624,0.013827662139351025,1257063168,2020-03-31,1482,2469,3951
2060,KTF,0.03106484668193081,0.03451128687972684,465320576,2020-11-30,2337,1618,3955
2061,ALGM,0.09487259150442415,0.010270204979325091,5190491648,2020-03-27,1373,2583,3956
2062,NXQ,0.03525907030219137,0.03198805933195385,293563328,2020-03-31,2218,1739,3957
2063,NSA,0.0422068269917543,0.02911513968849287,2953557248,2020-12-31,2075,1883,3958
2064,GATX,0.03401011595171065,0.03304819286073496,3324595456,2020-12-31,2259,1699,3958
2065,NUV,0.034592979161815064,0.032611256004469694,2313101056,2020-10-31,2242,1717,3959
2066,KSM,0.031350859897756655,0.03418684665384702,133551608,2020-11-30,2329,1631,3960
2067,PCQ,0.029220785512071013,0.035475988966120524,340482240,2020-12-31,2397,1565,3962
2068,FDP,0.033227402550384165,0.03319597626057837,1357653376,2021-01-01,2279,1688,3967
2069,PCTI,0.04680575072965085,0.026898884174647187,122793576,2020-12-31,1987,1982,3969
2070,BTA,0.027829729866035373,0.035957704632385276,174016512,2020-04-30,2428,1541,3969
2071,SGFY,0.10972785176606832,0.005895605332282389,5914417152,2020-12-31,1255,2715,3970
2072,RGA,0.010044521663589967,0.04277775115639962,8778712064,2020-12-31,2736,1234,3970
2073,MCR,0.028706593798809257,0.035437413714207264,377563808,2020-11-30,2405,1566,3971
2074,NAD,0.03242795255361953,0.033213269846387256,3234006528,2020-10-31,2291,1686,3977
2075,CXH,0.03207699875960604,0.03349671111142459,90555784,2020-11-30,2305,1672,3977
2076,FMN,0.03212482622908235,0.03331977891223727,168773024,2020-11-30,2300,1678,3978
2077,FIVE,0.08116065881464743,0.013438248271739514,11352694784,2021-01-30,1500,2484,3984
2078,PROS,0.022006976452359314,0.03823803695650558,553166784,2020-12-31,2547,1438,3985
2079,OMCL,0.0968605604411984,0.00870683182692308,5713132544,2020-12-31,1357,2631,3988
2080,AIR,0.042154911931608814,0.028280231575464727,1444214272,2020-05-31,2076,1915,3991
2081,UHT,0.057318977732270106,0.02182848567121798,962476160,2020-12-31,1802,2192,3994
2082,IRMD,0.10030514521887643,0.00775075350798919,295954048,2020-12-31,1328,2667,3995
2083,BBDC,0.03215632190029231,0.0330583120062502,670143232,2020-12-31,2299,1698,3997
2084,BKN,0.03269038769010573,0.03277983089709903,305620416,2020-04-30,2289,1709,3998
2085,FFG,0.007500274482078732,0.04300847173220068,1365228160,2020-12-31,2779,1219,3998
2086,TRV,0.035897127025236404,0.03093852241123053,38134059008,2020-12-31,2204,1796,4000
2087,FMY,0.031358628179235855,0.03339933278539312,56936104,2020-10-31,2327,1675,4002
2088,FDX,0.046513212819245905,0.026499012360648937,76041707520,2020-05-31,2001,2002,4003
2089,NUAN,0.09369175137967212,0.009007463305168528,12993035264,2020-09-30,1381,2623,4004
2090,MGP,0.040430571814102687,0.0287678893834062,10370501632,2020-12-31,2112,1895,4007
2091,IIVI,0.06931034232027398,0.016499597691728565,7988941824,2020-06-30,1628,2380,4008
2092,FORR,0.059184773817868117,0.020408860669450045,799778240,2020-12-31,1771,2237,4008
2093,MEN,0.0309718546160474,0.0334364247856313,357958912,2020-04-30,2340,1673,4013
2094,POR,0.030537883169462116,0.0337721767761979,4373085696,2020-12-31,2350,1663,4013
2095,EVG,0.02985246822468532,0.03410246059072543,238169584,2020-10-31,2377,1638,4015
2096,UTZ,0.09192782398411428,0.009430760882589468,3454982912,2021-01-03,1406,2612,4018
2097,PRT,0.026223157434769866,0.035542174689624596,65998924,2020-12-31,2462,1558,4020
2098,EDU,0.0723876421617291,0.014936320149411743,25031419904,2020-05-31,1595,2428,4023
2099,NBW,0.03105301732396541,0.033231196761322364,75225672,2020-10-31,2338,1685,4023
2100,SIGI,0.03658587591851464,0.03010756410248888,4532382208,2020-12-31,2189,1840,4029
2101,NMY,0.031894139496279277,0.03259634470873396,333321568,2020-05-31,2311,1718,4029
2102,MQY,0.03022593554718163,0.033570054796008,488847488,2020-04-30,2362,1669,4031
2103,BBF,0.02978085365413716,0.033905628355539785,147551216,2020-07-31,2379,1652,4031
2104,FNKO,0.06697218476733403,0.01677925561677225,1136648576,2020-12-31,1669,2366,4035
2105,CXDO,0.0863872317347176,0.010530491202553761,119026000,2020-12-31,1459,2577,4036
2106,GRWG,0.11143009049915743,0.0028809086811003035,3157992960,2020-12-31,1242,2796,4038
2107,FISV,0.07436131386861314,0.013859031105641203,82852839424,2020-12-31,1571,2467,4038
2108,ICL,0.04129353233830846,0.027662558739810394,8205782016,2020-12-31,2097,1941,4038
2109,NXPI,0.09850746268656717,0.006596497012464032,57683517440,2020-12-31,1343,2699,4042
2110,ELY,0.07670159511200335,0.01326763610189244,5133881344,2020-12-31,1552,2494,4046
2111,WTRG,0.04147560350564067,0.02742550479519494,11163156480,2020-12-31,2094,1954,4048
2112,GLUU,0.08603841637309176,0.010181687885089153,2198585856,2020-12-31,1464,2585,4049
2113,MYF,0.02833844446993848,0.03402962303479741,192958320,2020-07-31,2414,1643,4057
2114,BHK,0.02680652364990279,0.034595661544977376,844623680,2020-12-31,2447,1610,4057
2115,MQT,0.02998616472061055,0.033193163276697746,316037600,2020-04-30,2369,1689,4058
2116,ENV,0.09124115454905497,0.008184170339217606,4064494080,2020-12-31,1412,2647,4059
2117,DRVN,0.06041064953435804,0.018276039001658275,4258910464,2020-12-26,1755,2307,4062
2118,MMU,0.03136605137291826,0.03200255790290473,572889984,2020-05-31,2326,1737,4063
2119,NWS,0.05442574981711778,0.021101266781742175,15337273344,2020-06-30,1854,2211,4065
2120,NWSA,0.05442574981711778,0.021076685193843498,15357834240,2020-06-30,1854,2212,4066
2121,RADA,0.09164528276735429,0.008065372619569794,692864576,2020-12-31,1411,2656,4067
2122,AVNW,0.06994198967868309,0.014719003423703218,452233792,2020-07-03,1623,2444,4067
2123,CCI,0.06447854732444158,0.016651371402317434,75736457216,2020-12-31,1699,2372,4071
2124,LYTS,0.05106088601276741,0.022558890504012427,227347024,2020-06-30,1914,2157,4071
2125,CDR,0.023479874339261245,0.03584782574931414,201911184,2020-12-31,2526,1545,4071
2126,HMY,0.011335814317892469,0.03985861734174743,2950057728,2020-06-30,2716,1356,4072
2127,NVG,0.02718195339296206,0.03415333555628324,3620871424,2020-10-31,2440,1634,4074
2128,TY,0.03129707065679935,0.03177624241066476,1755719808,2020-12-31,2332,1746,4078
2129,JMM,0.028002371407227566,0.03387477740419051,69075160,2020-06-30,2424,1654,4078
2130,DXCM,0.09102513448621706,0.007822076304236402,36825366528,2020-12-31,1416,2664,4080
2131,CRNC,0.08223988091328999,0.009815165571591193,3495967232,2020-09-30,1489,2598,4087
2132,EAT,0.04753673292999136,0.02349844203449436,3108561408,2020-06-24,1973,2114,4087
2133,EXEL,0.06514906401663971,0.015884709130493054,7213209600,2020-12-31,1689,2399,4088
2134,GOODM,0.03688259271099744,0.02810313289200722,645034368,2020-12-31,2180,1923,4103
2135,JEF,0.021916802064653948,0.03564637376823376,7699600896,2020-11-30,2550,1555,4105
2136,OCDX,0.07209805335255948,0.013042474701725244,4403082240,2021-01-03,1604,2505,4109
2137,PCG,0.025622899762314563,0.03415329162551969,22843666432,2020-12-31,2477,1635,4112
2138,EIM,0.0304226854803647,0.031608192510938216,963453376,2020-09-30,2357,1758,4115
2139,APPF,0.10043932845507582,0.0029229340491269437,4908561920,2020-12-31,1325,2794,4119
2140,O,0.044073856502098906,0.02448401984842771,24348530688,2020-12-31,2036,2084,4120
2141,EVN,0.03086156049333869,0.031286070206544926,548597376,2020-11-30,2344,1776,4120
2142,EEFT,0.06176095964400303,0.01645628889830801,7849248256,2020-12-31,1739,2382,4121
2143,IHG,0.06808510638297872,0.013783709775373892,13143067648,2020-12-31,1652,2470,4122
2144,ESP,0.039148773943437805,0.02663042911589464,42674528,2020-06-30,2135,1994,4129
2145,VMM,0.029989999705419365,0.031540757324310637,152843920,2020-03-31,2368,1762,4130
2146,AVD,0.05133968128946961,0.020718841611711048,618046016,2020-12-31,1905,2228,4133
2147,MZA,0.030442819096182096,0.031255783900892155,69112912,2020-07-31,2355,1778,4133
2148,AFB,0.029929714601030884,0.031520477890400134,410764608,2020-10-31,2371,1763,4134
2149,AMRC,0.0520551622368066,0.02025708014710981,2520498432,2020-12-31,1893,2243,4136
2150,CIR,0.0528835043025103,0.019551153786555392,691928064,2020-12-31,1875,2266,4141
2151,OPINI,0.02945798693492938,0.031632667979187755,1271570944,2020-12-31,2388,1755,4143
2152,NMM,0.019546154744931567,0.035816618158450615,298832576,2020-12-31,2595,1548,4143
2153,MHN,0.028852316305498817,0.031902062982611015,442541376,2020-08-31,2403,1742,4145
2154,FNV,0.06735638550403544,0.013491018951422696,25720012800,2020-12-31,1664,2482,4146
2155,GDS,0.017314034631053816,0.03630533085619596,14656021504,2020-12-31,2630,1519,4149
2156,SGMS,0.07344632768361582,0.010728855349796817,4230542080,2020-12-31,1580,2570,4150
2157,NMT,0.030544961127314973,0.03080525179719596,134806336,2020-05-31,2349,1801,4150
2158,LAUR,0.032194808459578915,0.029834576955675856,2849384192,2020-12-31,2297,1855,4152
2159,CHY,0.03345647089103589,0.029133864613207015,1170541312,2020-10-31,2272,1882,4154
2160,WEX,0.07098056187864386,0.011781636013492093,9691528192,2020-12-31,1612,2544,4156
2161,MIY,0.029408762287046884,0.03142791031663414,449134592,2020-07-31,2392,1766,4158
2162,LDL,0.04963914939600942,0.020938150701897428,575326080,2020-12-31,1945,2217,4162
2163,STAY,0.04151377387805312,0.02483333669975559,3522810112,2020-12-31,2091,2071,4162
2164,BYM,0.027461305442508722,0.032446784400542016,406392960,2020-08-31,2438,1727,4165
2165,OPI,0.02945798693492938,0.03103372404979135,1339869184,2020-12-31,2388,1788,4176
2166,MFT,0.024190829905579986,0.03357450324444483,123293528,2020-07-31,2510,1668,4178
2167,UPST,0.09576552905482892,0.0021428738258948417,9371268096,2020-12-31,1365,2814,4179
2168,PETQ,0.07088427121015554,0.010866015798406415,1049719104,2020-12-31,1614,2565,4179
2169,ROIC,0.03386132870409708,0.028277674547231336,1931810688,2020-12-31,2263,1916,4179
2170,FR,0.04705653673379841,0.02152157842928282,6059977216,2020-12-31,1982,2199,4181
2171,NEE,0.040744904907441135,0.024589958194280448,152875417600,2020-12-31,2104,2079,4183
2172,MUE,0.023785866108354287,0.03366554371936305,301778624,2020-07-31,2516,1667,4183
2173,NOM,0.031436687944814246,0.029693190965490644,34778304,2020-05-31,2325,1860,4185
2174,WRB,0.036996353760769936,0.02630002171596295,14121563136,2020-12-31,2177,2011,4188
2175,NEA,0.027493202077033665,0.03163704978113417,4467613184,2020-10-31,2437,1754,4191
2176,TSE,0.04695578127851104,0.021192189015035633,2475151616,2020-12-31,1984,2208,4192
2177,CHI,0.03296888116822718,0.02849710047441659,1085843456,2020-10-31,2286,1907,4193
2178,MOS,0.031794689003742646,0.029245384056774577,11948623872,2020-12-31,2316,1879,4195
2179,BFY,0.02857413288993812,0.031006265723149958,77125816,2020-08-31,2409,1791,4200
2180,BKTI,0.049677040516735174,0.01980625147103168,61183680,2020-12-31,1944,2257,4201
2181,SAFE,0.042631810858818835,0.023055965938750294,3672645632,2020-12-31,2068,2138,4206
2182,PAYC,0.07747564668144669,0.007584498966432665,22944481280,2020-12-31,1542,2671,4213
2183,RICK,0.0546533904506623,0.01708161323946476,631433728,2020-09-30,1852,2362,4214
2184,GOOD,0.03688259271099744,0.025978206048530246,752487296,2020-12-31,2180,2034,4214
2185,PTNR,0.028495102404274265,0.030756716728691003,858269440,2020-12-31,2410,1805,4215
2186,RCS,0.037097288225849394,0.025776152083207545,332278720,2020-06-30,2174,2045,4219
2187,EQIX,0.05770579283980099,0.014969792756620914,61381865472,2020-12-31,1798,2427,4225
2188,TYHT,-0.07872039197639479,1.3519565063264265,18442890,2020-06-30,4212,14,4226
2189,NVGS,0.02345814103642413,0.03301292921128548,508631776,2020-12-31,2527,1701,4228
2190,JHS,0.024145971904837565,0.03257540070530871,177727120,2020-10-31,2511,1719,4230
2191,INOD,0.06422897064623359,0.01221192131186372,185929808,2020-12-31,1702,2531,4233
2192,NKG,0.029333368931583694,0.030109603611431793,139358736,2020-05-31,2394,1839,4233
2193,MCFE,0.06732223903177005,0.010757086763925429,10374231040,2020-12-26,1665,2569,4234
2194,WSR,0.031114477394577282,0.02860151954678891,404821984,2020-12-31,2334,1902,4236
2195,DTF,0.026418066300260244,0.03128186646072427,102257744,2020-10-31,2459,1777,4236
2196,IIIV,0.07909675647217708,0.005973766626113628,1042806528,2020-09-30,1525,2712,4237
2197,SBUX,0.0673140438494259,0.010597356530209288,133246812160,2020-09-27,1666,2574,4240
2198,PFX,0.02433763762180472,0.03201383127153446,92048456,2020-09-30,2508,1736,4244
2199,BROG,0.051703307791815166,0.017412511894133655,1099167616,2020-12-31,1901,2345,4246
2200,MFL,0.027587221144244667,0.030574604730875227,544568384,2020-08-31,2435,1813,4248
2201,BKT,0.02516696509357665,0.031594675955859346,389800288,2020-12-31,2491,1760,4251
2202,ADS,0.031111948220951337,0.02815465543647792,5457018880,2020-12-31,2335,1920,4255
2203,AAT,0.03417712874461624,0.026512346669438684,2004696576,2020-12-31,2255,2001,4256
2204,NPV,0.030015105608640607,0.028877488089635812,291094176,2020-05-31,2366,1890,4256
2205,CEV,0.02844002001607672,0.02994081499768059,95732648,2020-11-30,2412,1847,4259
2206,JP,-0.039844406719445224,0.10961761730069833,74845744,2020-12-31,4038,221,4259
2207,RHE,0.022480939221105035,0.03256697727527717,8677451,2020-12-31,2540,1720,4260
2208,BYD,0.0497851781727966,0.017939931280993828,7179908608,2020-12-31,1940,2322,4262
2209,AG,0.05700352493652324,0.014314011088301812,3848855808,2020-12-31,1810,2453,4263
2210,SRC,0.03493210385299482,0.025857597064090857,5038995968,2020-12-31,2230,2039,4269
2211,VICR,0.07896304176839387,0.004831449412636066,3716009472,2020-12-31,1526,2747,4273
2212,MPA,0.02575736906494815,0.030904539531965917,198537456,2020-07-31,2474,1799,4273
2213,ENX,0.028277529820980474,0.029643528184192105,224848096,2020-09-30,2417,1863,4280
2214,ERF,0.03337420926677219,0.02636702549522357,1211796480,2020-12-31,2275,2008,4283
2215,NIM,0.0295735170540772,0.028750990862867195,133602336,2020-03-31,2386,1897,4283
2216,NBO,0.028213201824355733,0.029641778288265152,63115040,2020-10-31,2419,1864,4283
2217,VC,0.05350877192982456,0.015338523404184854,3299914752,2020-12-31,1867,2418,4285
2218,MYI,0.02595564606533172,0.030455564628515105,973195072,2020-07-31,2467,1820,4287
2219,NRO,0.03109140897728636,0.027390405683790878,215819136,2020-10-31,2336,1956,4292
2220,SKX,0.04239326142927422,0.020840274567180055,6809894400,2020-12-31,2070,2224,4294
2221,RNP,0.025385748530419635,0.03060536139652509,1180990208,2020-12-31,2483,1811,4294
2222,DAN,0.03709914064137498,0.023216071991468423,3747028736,2020-12-31,2173,2128,4301
2223,PCRX,0.053215874685065036,0.014888651717063845,2993683968,2020-12-31,1871,2435,4306
2224,INTG,0.04666895669929963,0.01804598555447451,81323808,2020-06-30,1994,2314,4308
2225,XP,0.027730216564290946,0.02927554120924292,21808891904,2020-12-31,2431,1877,4308
2226,KELYB,0.02526747097655361,0.03038015858377094,758880192,2021-01-03,2487,1823,4310
2227,DBX,0.061887254901960786,0.010406948791835676,10873164800,2020-12-31,1736,2579,4315
2228,EGP,0.04744671120596515,0.017577680633019798,5902934528,2020-12-31,1975,2340,4315
2229,MHE,0.028052705865090073,0.028849596801501946,32957178,2020-08-31,2423,1892,4315
2230,TPIC,0.05808949841028804,0.012488460406310572,1991892224,2020-12-31,1792,2525,4317
2231,STAA,0.08310797301989835,0.0014935750772354563,5399200256,2021-01-01,1485,2835,4320
2232,TEN,0.03605283605283605,0.023351440179620438,881147392,2020-12-31,2199,2123,4322
2233,CHCT,0.042337379976620744,0.01987394888845098,1177533440,2020-12-31,2073,2254,4327
2234,MSEX,0.03891501643351446,0.02193490711494586,1393075072,2020-12-31,2140,2187,4327
2235,MYN,0.025775614655290283,0.02985169581996566,537584896,2020-07-31,2473,1854,4327
2236,EVM,0.027781437685152555,0.028732814042574748,293183136,2020-09-30,2429,1899,4328
2237,LSEA,0.02690193335446289,0.029047871659552287,453988416,2020-12-31,2445,1884,4329
2238,PYPL,0.06215775158658205,0.009655585408197031,312435671040,2020-12-31,1731,2603,4334
2239,RE,0.02181871490096204,0.031199711613813207,10188685312,2020-12-31,2553,1781,4334
2240,VECO,0.04729648380061383,0.017160007636536388,1058273600,2020-12-31,1978,2357,4335
2241,PLNT,0.06782420254235048,0.007253035749295274,7422108160,2020-12-31,1654,2686,4340
2242,EQR,0.03765861435719973,0.02237215526502212,26716211200,2020-12-31,2170,2171,4341
2243,MMSI,0.05714873607320306,0.012105890101753308,3424978176,2020-12-31,1807,2537,4344
2244,EVY,0.027592239259663382,0.028368671213966308,77516264,2020-11-30,2434,1911,4345
2245,MUI,0.022556507012926368,0.030747534988351578,577111872,2020-04-30,2539,1806,4345
2246,HAL,0.04199417758369724,0.019419129348821465,18722969600,2020-12-31,2078,2271,4349
2247,CLPR,0.028689592901233737,0.02756971334460275,142480576,2020-12-31,2406,1943,4349
2248,AGR,0.025536674019074838,0.02937212096042576,15901721600,2020-12-31,2479,1875,4354
2249,SFUN,0.017991920353680073,0.032194388779135316,109863680,2020-12-31,2621,1734,4355
2250,CIO,0.029260296796159744,0.02731413158301816,471726464,2020-12-31,2395,1961,4356
2251,QADA,0.06330230865483841,0.008232346767721072,1493644032,2021-01-31,1714,2643,4357
2252,PNTG,0.04978204454093661,0.015332699107124504,1242697728,2020-12-31,1941,2419,4360
2253,WTI,0.03257489369174719,0.024681009094185122,490952224,2020-12-31,2290,2075,4365
2254,BTT,0.026082788277198954,0.028694696514975387,1814109056,2020-07-31,2465,1900,4365
2255,QADB,0.06330230865483841,0.0081081403041691,1517272448,2021-01-31,1714,2653,4367
2256,KEX,0.029934706481920658,0.026549948900249785,3731947776,2020-12-31,2370,1998,4368
2257,ZI,0.07320644216691069,0.0031103526701824445,18492116992,2020-12-31,1585,2787,4372
2258,BIO,0.034997669858656356,0.022851357828278098,17917057024,2020-12-31,2228,2145,4373
2259,DNLI,0.057221058970042836,0.010653320623425949,6322623488,2020-12-31,1805,2572,4377
2260,BSE,0.025097797808023625,0.029016566474283294,96425768,2020-08-31,2494,1886,4380
2261,SLG,0.025627673701197395,0.028562644284752095,5007127552,2020-12-31,2476,1905,4381
2262,BNY,0.02183047118683987,0.030283106551936022,199831936,2020-07-31,2552,1831,4383
2263,ALE,0.02581198517631447,0.028324947330444144,3622578432,2020-12-31,2472,1912,4384
2264,AVB,0.03716863897550094,0.021029184937654797,25957967872,2020-12-31,2172,2215,4387
2265,ONTO,0.05606501771027196,0.010918179042909601,3437987072,2020-12-26,1827,2563,4390
2266,KTCC,0.03046799700139221,0.025845981991513008,88552328,2020-06-27,2352,2040,4392
2267,ERH,0.026422945121703963,0.027775646131387877,125213312,2020-08-31,2458,1934,4392
2268,BKNG,0.06704427233845799,0.005563502566644327,100358873088,2020-12-31,1668,2726,4394
2269,HCCI,0.04189917042228932,0.018118963071875577,680190720,2021-01-02,2082,2313,4395
2270,FLR,0.03397872558859502,0.023060182828949553,3203087872,2020-12-31,2260,2137,4397
2271,MP,0.06511238690494925,0.006082769414314779,6213155840,2020-12-31,1691,2707,4398
2272,MDLY,0.052781202042818685,0.01258465278439102,25952996,2020-12-31,1879,2520,4399
2273,MCA,0.02329838558391664,0.029459896169075343,511612768,2020-07-31,2529,1871,4400
2274,BEPC,0.019745139825164182,0.030604688481234175,8137656832,2020-12-31,2589,1812,4401
2275,CMG,0.06242023122236535,0.0075424272632550835,43159093248,2020-12-31,1728,2675,4403
2276,MUC,0.02116855622802814,0.030166451624171708,617085184,2020-07-31,2569,1834,4403
2277,LGND,0.05715745051086499,0.00966919025512572,2549006592,2020-12-31,1806,2602,4408
2278,PKOH,0.03211894223130178,0.023827749491928393,429390848,2020-12-31,2303,2105,4408
2279,KIM,0.030884140514644623,0.025044008839262135,8408755200,2020-12-31,2343,2066,4409
2280,STAR,0.02785445080063257,0.02677322236654626,1336250880,2020-12-31,2427,1985,4412
2281,AIRTP,0.05609596173872797,0.010098372142410644,614272064,2020-03-31,1825,2589,4414
2282,TEX,0.043252393182348824,0.01709774292958629,3111205376,2020-12-31,2053,2361,4414
2283,CMLS,0.035447544473039674,0.021312976629220357,191627776,2020-12-31,2210,2204,4414
2284,ADC,0.03333589502100756,0.022988863182748145,4315971072,2020-12-31,2276,2140,4416
2285,ESS,0.038048674594883945,0.019775990195516232,18414891008,2020-12-31,2160,2258,4418
2286,RDNT,0.034425217815867125,0.022411435870998277,1117054848,2020-12-31,2249,2169,4418
2287,BEP,0.019262220606941667,0.03048466397719926,11911424000,2020-12-31,2599,1819,4418
2288,SGA,0.030188496975112604,0.025466237921159623,125588192,2020-12-31,2363,2056,4419
2289,ETH,0.035534095100750444,0.020914914707184522,698553536,2020-06-30,2207,2218,4425
2290,RTX,0.04857120519135296,0.01406354435371027,118689988608,2020-12-31,1964,2463,4427
2291,IMXI,0.05574041092915164,0.009695658713200155,572126464,2020-12-31,1833,2601,4434
2292,ALOT,0.038020377547193396,0.019194808322679544,105693024,2021-01-31,2162,2275,4437
2293,BLKB,0.05121431974065284,0.012199061799745375,3482009344,2020-12-31,1907,2533,4440
2294,GNL,0.029245032925524262,0.02570271889233518,1671099520,2020-12-31,2396,2046,4442
2295,DXPE,0.04393089481347836,0.015564625806446465,588445632,2020-12-31,2038,2410,4448
2296,LNTH,0.0521750407479346,0.010949465338758001,1418354944,2020-12-31,1890,2561,4451
2297,SNR,0.02957402140478897,0.025020182351655755,560160896,2020-12-31,2385,2068,4453
2298,LANDM,0.026641063828178747,0.026441616397019578,409649056,2020-12-31,2452,2005,4457
2299,ARAY,0.04154132598295809,0.016763342987329056,484000160,2020-06-30,2090,2368,4458
2300,COHU,0.057466218386620124,0.007849970233884064,2398141440,2020-12-26,1800,2663,4463
2301,HY,0.037766534152511744,0.018531412151629668,1463829504,2020-12-31,2167,2297,4464
2302,KELYA,0.02526747097655361,0.026971991817154505,943552064,2021-01-03,2487,1978,4465
2303,MAA,0.03589814942479898,0.01957680932364532,16800815104,2020-12-31,2203,2265,4468
2304,DCP,0.02405122598781821,0.027413513341731144,4569334784,2020-12-31,2513,1955,4468
2305,SUP,0.02968022389080858,0.024272971152552666,142802800,2020-12-31,2382,2092,4474
2306,EVK,0.02112352905186303,0.028568396091495876,37915392,2020-12-31,2571,1903,4474
2307,JDD,0.021660947979451756,0.02790095144790038,192751296,2020-12-31,2556,1929,4485
2308,FRT,0.03457033004222799,0.020033191005981683,8191818752,2020-12-31,2244,2247,4491
2309,AQN,0.02968374265444885,0.023479398038889522,9802745856,2020-12-31,2381,2115,4496
2310,FEO,0.022956852784247413,0.027194120040733127,71768608,2020-12-31,2533,1967,4500
2311,KTOS,0.052859763214940805,0.008831117755766688,3471779584,2020-12-27,1877,2628,4505
2312,IIPR,0.04165952299168148,0.015268225401973489,4521831424,2020-12-31,2088,2421,4509
2313,GIGM,-0.1612684217355877,0.3242530035616737,36140692,2020-12-31,4463,46,4509
2314,CTOS,0.055843773097686254,0.007471934599945017,2404481280,2020-12-31,1830,2682,4512
2315,PFGC,0.04611714044633245,0.012953283898750828,7778979328,2020-06-27,2007,2508,4515
2316,DOC,0.029743682952857873,0.023087524229837984,3849664512,2020-12-31,2380,2135,4515
2317,ETM,0.04180192015397893,0.014912101439164648,714169472,2020-12-31,2086,2432,4518
2318,MNP,0.02348626808954958,0.026663068392983286,150256672,2020-11-30,2525,1993,4518
2319,BRID,0.02965567807287922,0.023083370974483954,133883240,2020-10-30,2383,2136,4519
2320,NHC,0.02704705667643994,0.024675641397529736,1151140608,2020-12-31,2443,2076,4519
2321,RRR,0.036878120057891844,0.017584639836789966,4137664768,2020-12-31,2182,2339,4521
2322,NEP,0.026179635761589402,0.025324674742289704,5590256640,2020-12-31,2463,2058,4521
2323,ZIXI,0.051352834946976504,0.009231166555402627,432173568,2020-12-31,1904,2619,4523
2324,SATS,0.023161531382233643,0.026682729639680016,2253925888,2020-12-31,2531,1992,4523
2325,LXP,0.03131911896147564,0.021776212800635825,3169678336,2020-12-31,2331,2194,4525
2326,ICE,0.034801191412089066,0.018766984198323025,65932963840,2020-12-31,2235,2291,4526
2327,EPRT,0.0313578722156727,0.021481661087014485,2647096064,2020-12-31,2328,2200,4528
2328,HE,0.021411442619760496,0.027189044328510294,4631328768,2020-12-31,2562,1968,4530
2329,WNC,0.04271230300264984,0.013847499949204768,973843904,2020-12-31,2065,2468,4533
2330,SBLK,0.021841517581522026,0.026819997948256964,1465770368,2020-12-31,2551,1983,4534
2331,JTA,0.02157466311056274,0.02691663415177094,150974800,2020-12-31,2558,1980,4538
2332,BZM,0.024730605638015202,0.02569858121610459,32234622,2020-08-31,2498,2047,4545
2333,BHV,0.024417996274396874,0.025814513689384984,26839356,2020-08-31,2506,2042,4548
2334,PODD,0.06108409441347409,0.0026659161920364037,18973636608,2020-12-31,1744,2805,4549
2335,LAND,0.026641063828178747,0.02394317694364463,520905440,2020-12-31,2452,2102,4554
2336,MYC,0.02131012543639216,0.02671140220662342,314661184,2020-07-31,2566,1988,4554
2337,REG,0.029919047699525102,0.021939357971135234,9911220224,2020-12-31,2373,2186,4559
2338,CLPS,0.04417979518801975,0.01225482830919546,100635152,2020-06-30,2034,2529,4563
2339,TSLA,0.058928355684426725,0.002986489488297687,649840361472,2020-12-31,1777,2789,4566
2340,QNST,0.05488139251030408,0.005893888322957405,1074457472,2020-06-30,1850,2716,4566
2341,CUZ,0.026803159545263543,0.023425621871451252,5337259520,2020-12-31,2448,2118,4566
2342,MAR,0.05225467159001902,0.007499495684448835,48338853888,2020-12-31,1888,2679,4567
2343,STAG,0.03339480282991706,0.018609479065838368,5553552384,2020-12-31,2273,2294,4567
2344,KRC,0.02902002613215601,0.022430195969827826,7771121664,2020-12-31,2399,2168,4567
2345,MFV,0.028240348529687962,0.02261194236169114,46253312,2020-10-31,2418,2155,4573
2346,MIN,0.02359475144120705,0.025319966792937874,426626080,2020-10-31,2519,2059,4578
2347,CLAR,0.04476400247542871,0.011209081553551577,547685376,2020-12-31,2027,2552,4579
2348,JTD,0.024139655411470052,0.02502772049759136,220885568,2020-12-31,2512,2067,4579
2349,MPAA,0.02603453643974585,0.02345216447354728,420191392,2020-03-31,2466,2116,4582
2350,BFZ,0.018551003304882154,0.02712212564122894,452887552,2020-07-31,2614,1970,4584
2351,RYAM,0.021776845675018405,0.02599194647716311,613573056,2020-12-31,2554,2032,4586
2352,PCYO,0.04712152889409562,0.009553584508428838,323194624,2020-08-31,1981,2606,4587
2353,AHH,0.023980458426495287,0.024688384823987466,766104320,2020-12-31,2514,2073,4587
2354,EVI,0.05185696431569326,0.007001076775681591,339363776,2020-06-30,1897,2693,4590
2355,FPI,0.02081023930843681,0.02626184201001866,353116864,2020-12-31,2577,2014,4591
2356,ICCH,0.018859070088362358,0.02670028520473804,55217380,2020-12-31,2607,1989,4596
2357,SP,0.03572008442929047,0.016071225990494202,748606144,2020-12-31,2206,2393,4599
2358,RUHN,-0.22163900527412272,0.560165842717109,280200448,2020-03-31,4572,28,4600
2359,LEVI,0.04225703772839238,0.012313252466315493,10263507968,2020-11-29,2074,2528,4602
2360,TIGO,0.02816266756787203,0.021940558775775852,4040422656,2020-12-31,2420,2185,4605
2361,DNB,0.05522506444576641,0.004057331380850874,10001635328,2020-12-31,1844,2763,4607
2362,VSTO,0.03944127696442745,0.013496019613736475,1846515712,2020-03-31,2129,2481,4610
2363,AMPH,0.03347395180122545,0.01757564852236266,848574528,2020-12-31,2270,2341,4611
2364,CRESY,0.018485630255523113,0.02657060781584177,562362432,2020-06-30,2615,1996,4611
2365,DAR,0.0433196874257224,0.010840412470182536,12084668416,2021-01-02,2051,2566,4617
2366,AEF,0.021396005872358452,0.025470188553100435,435450432,2020-12-31,2565,2055,4620
2367,FANG,0.025519744802551973,0.022884422278940237,13519801344,2020-12-31,2480,2144,4624
2368,PPT,0.02223714338689012,0.02456263600989288,482441920,2020-07-31,2545,2082,4627
2369,AVK,0.022659217652917556,0.024130112147372488,631811136,2020-10-31,2538,2098,4636
2370,DIS,0.04533518782748408,0.009389118721024029,341069201408,2020-10-03,2022,2615,4637
2371,COLD,0.03470585739685821,0.01564740837367328,9950791680,2020-12-31,2237,2404,4641
2372,PDM,0.025863621396538812,0.022359519370464924,2196498432,2020-12-31,2471,2172,4643
2373,DNP,0.02514384757177047,0.022620619794846288,3077564928,2020-10-31,2492,2154,4646
2374,ATCX,0.040740607066806225,0.01185971113240237,155435920,2020-12-31,2105,2543,4648
2375,NUVA,0.0405409443991674,0.011979901315362423,3443964928,2020-12-31,2109,2541,4650
2376,SGMA,0.025298071508667152,0.02243025897625935,23586606,2020-04-30,2486,2167,4653
2377,EVT,0.026381993991214114,0.021600720580437337,1959712640,2020-10-31,2460,2197,4657
2378,IMMR,0.047176280205161965,0.007513711475017049,279656832,2020-12-31,1980,2678,4658
2379,BDN,0.025137040787791085,0.022457623971090804,2170833408,2020-12-31,2493,2165,4658
2380,PLD,0.03200300943860477,0.01721851431580354,81009475584,2020-12-31,2308,2354,4662
2381,AIZ,0.021410575907370052,0.02387643683234384,8893873152,2020-12-31,2563,2104,4667
2382,TRNO,0.034216105932711925,0.015113220123999863,4129330944,2020-12-31,2253,2423,4676
2383,CPT,0.03295939575819187,0.016177636305906434,10972663808,2020-12-31,2287,2389,4676
2384,WDC,0.0397665874216555,0.011161440494267873,22323654656,2020-07-03,2124,2554,4678
2385,ZTR,0.019460869061810066,0.024326572834393916,445042240,2020-11-30,2596,2088,4684
2386,UMH,0.02652301477862046,0.020523103544759898,820730176,2020-12-31,2454,2233,4687
2387,RPAI,0.025452854420976268,0.02120207368433909,2334147584,2020-12-31,2481,2207,4688
2388,RYN,0.030459431676070254,0.017616220733338593,4813445120,2020-12-31,2353,2336,4689
2389,AENZ,0.020155828173117334,0.023754210129381424,415849056,2020-12-31,2583,2106,4689
2390,GMRE,0.027761810643901465,0.019730380275192732,832272576,2020-12-31,2430,2260,4690
2391,FLMN,0.029410572476185212,0.01836638048343351,394370976,2020-12-31,2391,2304,4695
2392,SITC,0.026110105442075014,0.02056877112454892,2920585984,2020-12-31,2464,2232,4696
2393,DRI,0.034589559296387365,0.014147613661139058,18723633152,2020-05-31,2243,2460,4703
2394,GLRE,0.021971211639915042,0.022574766731463553,310633216,2020-12-31,2548,2156,4704
2395,CVA,0.028159790438768827,0.01862735851122859,1832865024,2020-12-31,2421,2293,4714
2396,RIG,0.012410905647211284,0.026066379129450437,2018535040,2020-12-31,2700,2030,4730
2397,DRE,0.032282834953738196,0.014698309602927942,16113052672,2020-12-31,2295,2446,4741
2398,WELL,0.026823377367120708,0.018516203739346246,31349637120,2020-12-31,2446,2299,4745
2399,AWP,0.022663096781809226,0.021008880575178288,515864320,2020-10-31,2537,2216,4753
2400,DEA,0.02462061284723153,0.01985414554357129,1737845376,2020-12-31,2501,2256,4757
2401,VTR,0.0270688093559246,0.01800683852984313,20508833792,2020-12-31,2442,2316,4758
2402,JJSF,0.04049788240772125,0.008144558665146242,2966321664,2020-09-26,2111,2651,4762
2403,CB,0.0246999419460233,0.01960349012013072,72258437120,2020-12-31,2499,2263,4762
2404,BOE,0.021089806315813763,0.021889222095610575,761481984,2020-12-31,2572,2190,4762
2405,SSTI,0.04466610667786644,0.005216987433314784,392770560,2020-12-31,2029,2736,4765
2406,VNOM,0.023865973748040562,0.01993683248401916,2354100480,2020-12-31,2515,2250,4765
2407,CME,0.02948660396691553,0.016352857627916922,73473630208,2020-12-31,2387,2386,4773
2408,AP,0.013380334617464016,0.024285896085759533,134950240,2020-12-31,2685,2089,4774
2409,DDF,0.019200396137484442,0.02233042158757919,80526072,2020-11-30,2601,2175,4776
2410,HTA,0.026241598475694707,0.017983183237287072,6105200640,2020-12-31,2461,2317,4778
2411,PUK,0.004696937645944963,0.02730695752839424,56369549312,2020-12-31,2817,1963,4780
2412,SQFT,0.0205183404128741,0.021315176549074888,36787268,2020-12-31,2579,2203,4782
2413,STKL,0.03883983763853787,0.008265682255420534,1531168512,2021-01-02,2141,2642,4783
2414,PCTY,0.04205230613303674,0.0060654872165148786,10261348352,2020-06-30,2077,2709,4786
2415,INVH,0.0271045342334247,0.017398143417870857,18374830080,2020-12-31,2441,2347,4788
2416,SLAB,0.04243966210351439,0.005673068911374714,6504880128,2021-01-02,2069,2723,4792
2417,OZON,-0.36740970116015187,0.5608336677636866,12603054080,2020-12-31,4769,27,4796
2418,TOT,0.02145577677333567,0.020435676523278067,117837365248,2020-12-31,2561,2236,4797
2419,CHUY,0.030897190748387884,0.014214592025650138,898324800,2020-12-27,2342,2456,4798
2420,MSTR,0.03943400971737797,0.007580744364729425,6816371200,2020-12-31,2130,2672,4802
2421,JRS,0.01785752557319532,0.0221136060042415,285457888,2020-12-31,2623,2180,4803
2422,TRQ,0.014083009405469504,0.023118351438988556,3794862336,2020-12-31,2676,2133,4809
2423,AMH,0.025903896585464135,0.017514880153316082,10833135616,2020-12-31,2469,2344,4813
2424,NTCT,0.03818806002699786,0.00797256728460563,2037228416,2020-03-31,2157,2661,4818
2425,FC,0.03591476332596224,0.009212851580861863,413796000,2020-08-31,2202,2620,4822
2426,PGRE,0.01634481013495213,0.022342199916889658,2268332288,2020-12-31,2648,2174,4822
2427,ARE,0.025091110771145834,0.01771519528350641,23019098112,2020-12-31,2495,2331,4826
2428,IRT,0.0257298389954691,0.017105112338832777,1604021632,2020-12-31,2475,2360,4835
2429,CTO,0.019602928480273386,0.02030725670229756,314911488,2020-12-31,2594,2241,4835
2430,LITB,0.0338285493651114,0.010656238535214182,326385920,2020-12-31,2265,2571,4836
2431,CHGG,0.04196102762558758,0.004362249414917789,12583872512,2020-12-31,2080,2758,4838
2432,GWRS,0.028644958721579593,0.014915249902968521,384899552,2020-12-31,2408,2431,4839
2433,TTCF,0.04306691094036258,0.003230684899400534,1561778176,2020-12-31,2056,2784,4840
2434,WRI,0.024318135833538552,0.017707202854647663,3423910400,2020-12-31,2509,2332,4841
2435,MGF,0.018402670724256522,0.020852951769009833,143379728,2020-11-30,2618,2223,4841
2436,NPTN,0.034457996436891875,0.009925409427086295,609384000,2020-12-31,2247,2596,4843
2437,EPR,0.021638568792279274,0.018929192976309017,3572348160,2020-12-31,2557,2287,4844
2438,LNC,0.0022833410880766514,0.026515231876467198,12035766272,2020-12-31,2846,1999,4845
2439,CHDN,0.03770240490562422,0.007478551347489525,8548328448,2020-12-31,2169,2681,4850
2440,SNP,0.008953573046191729,0.024081175172168644,75877154816,2020-12-31,2755,2099,4854
2441,OR,0.02036790483549094,0.01915506584288281,2019543424,2020-12-31,2580,2278,4858
2442,CNA,0.015793528505392913,0.021444922979296985,12506112000,2020-12-31,2657,2202,4859
2443,CASS,0.022463073270982844,0.017801887337337195,657065408,2020-12-31,2541,2328,4869
2444,OVV,0.02147239263803681,0.018229622563039484,6195625472,2020-12-31,2560,2309,4869
2445,EPSN,0.021248051479972916,0.01846831220578117,91385896,2020-12-31,2568,2302,4870
2446,ALCO,0.018118290581814238,0.0199042967317203,218865632,2020-09-30,2620,2251,4871
2447,SUI,0.02867549870306978,0.01355828035123788,17058156544,2020-12-31,2407,2477,4884
2448,TDC,0.03212121212121212,0.010129847860785916,4371062784,2020-12-31,2301,2587,4888
2449,HNRG,0.012981745497346391,0.021473553571337425,63061956,2020-12-31,2690,2201,4891
2450,DHC,0.015389598943274248,0.020579365687897706,1129390208,2020-12-31,2661,2231,4892
2451,WIA,0.013195073780452838,0.021218433672415677,300857664,2020-11-30,2687,2206,4893
2452,BDJ,0.01898127217521554,0.018716623181950446,1802369024,2020-12-31,2605,2292,4897
2453,BGY,0.018395695823390453,0.019147867471783358,650445120,2020-12-31,2619,2279,4898
2454,CPE,0.019888760224051474,0.01796376811969153,1625071744,2020-12-31,2586,2319,4905
2455,VNO,0.019319281207599282,0.01814046115315428,8725787648,2020-12-31,2598,2312,4910
2456,UE,0.022378921861533695,0.01667834136549025,2028043264,2020-12-31,2542,2371,4913
2457,WIW,0.014402686728948172,0.020310706927066484,750728960,2020-11-30,2673,2240,4913
2458,RFI,0.020121209062647694,0.017770028210202824,390083904,2020-12-31,2585,2330,4915
2459,VG,0.03709480684565642,0.004941050747188622,3081762816,2020-12-31,2175,2741,4916
2460,AFIN,0.016443142695647707,0.019263829487135623,1041570048,2020-12-31,2644,2274,4918
2461,BW,0.03194492201733632,0.009516842075212386,746977984,2020-12-31,2310,2609,4919
2462,HXL,0.029188794746016947,0.012489500839891176,4749742080,2020-12-31,2398,2524,4922
2463,RQI,0.01919419815901074,0.01795989858357311,1933099264,2020-12-31,2602,2320,4922
2464,SELF,0.019724583381679803,0.017587354363991264,46126064,2020-12-31,2590,2338,4928
2465,NVCR,0.04034507412965422,0.0022267217351993685,13527601152,2020-12-31,2118,2812,4930
2466,AFINP,0.016443142695647707,0.018551303835946976,1146843136,2020-12-31,2644,2296,4940
2467,HL,0.023492150654942257,0.015382142633538005,3244124160,2020-12-31,2524,2417,4941
2468,DEN,0.023723002063232718,0.014924665385198025,2311046400,2020-12-31,2518,2429,4947
2469,GLU,0.012574615287957542,0.01976921796205445,107471600,2020-12-31,2694,2259,4953
2470,AVIR,0.038029060748994904,0.002900892282687463,4675461632,2020-12-31,2161,2795,4956
2471,CCLP,0.02012439751698362,0.01663077704545841,91624992,2020-12-31,2584,2373,4957
2472,TCX,0.03157537608163615,0.0083931547132255,865734208,2020-12-31,2322,2638,4960
2473,ARES,0.022216833754788466,0.015427501728897914,8785076224,2020-12-31,2546,2414,4960
2474,CET,0.017460103627760144,0.017616725628103166,1027311680,2020-12-31,2625,2335,4960
2475,UFS,0.015030530765617662,0.018405145209877828,1884288512,2020-12-31,2666,2303,4969
2476,SCHN,0.022275632764575493,0.014984559185477565,1082379904,2020-08-31,2544,2426,4970
2477,CBRL,0.02760859825796573,0.012030307383530536,4154027776,2020-07-31,2433,2539,4972
2478,UTG,0.016789721201349007,0.017670038498158895,1883112320,2020-10-31,2639,2333,4972
2479,UTF,0.01622240067095016,0.017948463033293113,2725790720,2020-12-31,2651,2321,4972
2480,USFD,0.03170478170478171,0.007977697517432603,8750632960,2021-01-02,2318,2660,4978
2481,FUND,0.017261677953722666,0.01735072242890972,243028624,2020-12-31,2631,2348,4979
2482,TTP,0.01714250919922927,0.0172736086021821,47978200,2020-11-30,2632,2351,4983
2483,SHOP,0.0390779120725034,0.0011686647363394096,150074245120,2020-12-31,2138,2848,4986
2484,MCRI,0.026648727823801583,0.012138053120740335,1223603968,2020-12-31,2451,2536,4987
2485,IGR,0.014458267640969672,0.01796658199626937,925724608,2020-12-31,2672,2318,4990
2486,ADT,0.03043255765303961,0.00816488434587239,7850723840,2020-12-31,2356,2649,5005
2487,ALTR,0.036372957777083645,0.002139217486424206,4860072960,2020-12-31,2195,2815,5010
2488,IVC,0.025203439629578352,0.012554592092781966,287981248,2020-12-31,2489,2521,5010
2489,PLX,0.02962914370681361,0.008869612816460912,237328576,2020-12-31,2384,2627,5011
2490,ESBA,0.023540551153383577,0.013298228628465462,3132653312,2020-12-31,2520,2491,5011
2491,EQNR,0.016622091852874357,0.01669076731842472,61708771328,2020-12-31,2641,2370,5011
2492,CHW,0.019255009624230393,0.015509181646991619,645922752,2020-10-31,2600,2412,5012
2493,ESRT,0.023540551153383577,0.013217437925426057,3192876032,2020-12-31,2520,2495,5015
2494,CNHI,0.019671306916381234,0.015071177142316464,21162237952,2020-12-31,2591,2424,5015
2495,FSP,0.015943833805208845,0.016819903726995728,591377280,2020-12-31,2655,2364,5019
2496,OGCP,0.023540551153383577,0.013056678897157276,3222891520,2020-12-31,2520,2502,5022
2497,SPE,0.011801965781455105,0.018192053332741556,124879248,2020-12-31,2711,2311,5022
2498,FISK,0.023540551153383577,0.013056674187461296,3222893312,2020-12-31,2520,2503,5023
2499,CCJ,0.017452368730076512,0.015693579348166616,6807483904,2020-12-31,2627,2402,5029
2500,UVE,0.012750251122255798,0.01754342362519803,424085472,2020-12-31,2693,2343,5036
2501,VSTA,0.01872992002187436,0.014917114328178814,761216384,2020-12-31,2610,2430,5040
2502,UPS,0.029928680590932247,0.00758764006078386,152964530176,2020-12-31,2372,2670,5042
2503,HR,0.02194462534288477,0.013107126979244406,4334768128,2020-12-31,2549,2500,5049
2504,HPP,0.01610673523132703,0.016038508058886514,4230325504,2020-12-31,2653,2396,5049
2505,DLR,0.024947451078186838,0.011158347366470903,39711150080,2020-12-31,2497,2555,5052
2506,VOYA,0.003425236330039548,0.020869773697356726,8235042304,2020-12-31,2834,2220,5054
2507,ACC,0.01888310086700666,0.014539499615379686,5972355072,2020-12-31,2606,2449,5055
2508,VNET,0.011497984547852167,0.017404146107994383,4076748544,2020-12-31,2713,2346,5059
2509,MGU,0.015249106534325188,0.015860831027710628,284401920,2020-11-30,2664,2400,5064
2510,SOR,0.0153591872436139,0.01561324625491552,370172928,2020-12-31,2663,2408,5071
2511,HYFM,0.03409579636502652,0.002096951049045096,2067946496,2020-12-31,2257,2817,5074
2512,OUT,0.023347428530123965,0.011422650088430691,3204530176,2020-12-31,2528,2546,5074
2513,DEI,0.017048694085224345,0.014735266829843673,5721881088,2020-12-31,2635,2441,5076
2514,CRY,0.030114464369883805,0.005931730625373263,884500992,2020-12-31,2365,2713,5078
2515,HCI,0.021029810870832475,0.0130339906216568,662317056,2020-12-31,2573,2506,5079
2516,BTO,0.01641065302333866,0.014746038908409783,734196416,2020-12-31,2646,2440,5086
2517,PENN,0.02098989616799367,0.012857427682169301,16293322752,2020-12-31,2574,2514,5088
2518,IVAC,0.0214015677395929,0.012239618006652391,174649600,2021-01-02,2564,2530,5094
2519,MOR,0.02374117472939917,0.01029571247614871,2936740096,2020-12-31,2517,2582,5099
2520,SIF,0.01735920733140127,0.013639580403734041,82535336,2020-09-30,2629,2474,5103
2521,REXR,0.0211535239650642,0.012160526385909682,6950018560,2020-12-31,2570,2535,5105
2522,CSOD,0.029834768499084053,0.005452494158952982,2927506688,2020-12-31,2378,2730,5108
2523,RPT,0.015837546843427076,0.014290819250990888,947160384,2020-12-31,2656,2454,5110
2524,ALEX,0.015373197625106022,0.01449705837289144,1241405824,2020-12-31,2662,2450,5112
2525,ATI,0.019604303559823812,0.012519556423271537,2809914368,2020-12-31,2593,2522,5115
2526,CSQ,0.016938699345651488,0.013511669675911652,2818831616,2020-10-31,2637,2479,5116
2527,XEC,0.021271295856032393,0.011175270025973091,6344425984,2020-12-31,2567,2553,5120
2528,MELI,0.032324535378471374,0.0015638159384919333,79030009856,2020-12-31,2293,2833,5126
2529,ETO,0.016258224636570433,0.013572467736287076,440484896,2020-10-31,2650,2476,5126
2530,MAXR,0.024987751102400785,0.008706215180602,2761884160,2020-12-31,2496,2632,5128
2531,CLF,0.016827279466271314,0.013272904351492995,8895511552,2020-12-31,2638,2493,5131
2532,PIM,0.013345021018552079,0.014667534418844773,216472480,2020-09-30,2686,2447,5133
2533,SPOK,0.02089094250084741,0.010825003565502882,207639968,2020-12-31,2576,2567,5143
2534,SSNT,0.027962475193215652,0.005806229322366499,37402120,2020-12-31,2425,2720,5145
2535,GEL,0.013154141531188561,0.014184284023934913,1143662080,2020-12-31,2688,2457,5145
2536,YQ,-0.8614619688570478,4.144355055379053,1307547392,2020-12-31,5142,5,5147
2537,BNSO,0.022934617334009123,0.00906580078418676,40464284,2020-03-31,2535,2622,5157
2538,WRE,0.01625905897005598,0.012913810259959987,1907653376,2020-12-31,2649,2511,5160
2539,BRG,0.010696631945109355,0.014815939704196094,225868816,2020-12-31,2723,2437,5160
2540,CGO,0.015963243495644337,0.012943390782396064,143310768,2020-10-31,2654,2509,5163
2541,QTS,0.0190454862929002,0.010955926082715972,4108446720,2020-12-31,2604,2560,5164
2542,LINK,0.03168202764976959,0.0012137362101912177,95707248,2020-12-31,2319,2847,5166
2543,NWHM,0.011475118387665056,0.014319694315266907,108663384,2020-12-31,2714,2452,5166
2544,MG,0.021688881610046788,0.009382543914717425,327421920,2020-12-31,2555,2616,5171
2545,TREC,0.012564737479097973,0.01354500097442866,194962592,2020-12-31,2695,2478,5173
2546,GOGL,0.012516678816652763,0.013637381453665887,1394997120,2020-12-31,2698,2475,5173
2547,MOXC,0.03174805536830119,0.0009706686690523487,73023672,2020-09-30,2317,2859,5176
2548,GUT,0.014987618831616338,0.012769520139973076,385128352,2020-12-31,2667,2516,5183
2549,DIAX,0.013034310317349364,0.013200939564339568,600053824,2020-12-31,2689,2496,5185
2550,GVA,0.01884620236094976,0.010251057110934405,1800427392,2020-12-31,2608,2584,5192
2551,APG,0.025868440502586843,0.005656559366928736,4464506880,2020-12-31,2470,2724,5194
2552,Y,0.00988132612586321,0.014262489463134761,9231734784,2020-12-31,2739,2455,5194
2553,HOG,0.012556100052004335,0.013119396139977613,6446811136,2020-12-31,2696,2499,5195
2554,BCV,0.012069877035835279,0.013136251557126126,168016704,2020-10-31,2707,2498,5205
2555,GLV,0.01391922307626745,0.012394363099967356,102826408,2020-10-31,2680,2527,5207
2556,CNFR,0.010026191204051788,0.013713383570763026,36887392,2020-12-31,2737,2473,5210
2557,MGLN,0.020639640934366606,0.00828376219212727,2442324224,2020-12-31,2578,2640,5218
2558,IAF,0.013928073005561805,0.012003817206344006,139358512,2020-10-31,2679,2540,5219
2559,SB,0.009865082428704585,0.01336596339435363,236091520,2020-12-31,2740,2487,5227
2560,NL,0.008911962838796465,0.013754965412750179,355633856,2020-12-31,2756,2472,5228
2561,BTBT,0.029397524309663272,0.001365462826894902,819268032,2020-12-31,2393,2840,5233
2562,FTAI,0.015582156469493048,0.010539278490419308,2459112448,2020-12-31,2660,2576,5236
2563,CRC,0.012308715901530274,0.012081622175089471,2020502656,2020-12-31,2704,2538,5242
2564,XTNT,0.025592331343823476,0.003918486906142925,193357264,2020-12-31,2478,2768,5246
2565,EVOP,0.018414740713557264,0.008696014605160705,1328935936,2020-12-31,2617,2633,5250
2566,SMED,0.025331960025610334,0.003904309241886116,221750800,2020-06-30,2484,2770,5254
2567,MNRL,0.01397022496957428,0.010480580220469554,866209088,2020-12-31,2677,2578,5255
2568,DENN,0.02308375836009772,0.005459728510173898,1158455040,2020-12-30,2532,2729,5261
2569,SIC,0.019108964036500267,0.008004903943330241,187250016,2020-12-31,2603,2659,5262
2570,BCOV,0.02543811494447025,0.0032358323057452947,869358976,2020-12-31,2482,2783,5265
2571,ROST,0.02452465464009284,0.004009038029093755,45724663808,2021-01-30,2503,2765,5268
2572,AXTI,0.01859288656923491,0.008061048175557289,522297184,2020-12-31,2612,2657,5269
2573,GHM,0.015052719200887903,0.009552432022780746,142738096,2020-03-31,2665,2607,5272
2574,ECF,0.010448958977163218,0.011320624484570456,187913040,2020-09-30,2727,2550,5277
2575,TAST,0.00878307660582763,0.01265018074459894,319489216,2021-01-03,2759,2518,5277
2576,NOW,0.02650802613492523,0.0018475938370913919,103933001728,2020-12-31,2455,2826,5281
2577,KRG,0.012017358848225973,0.010562902701682255,1659308928,2020-12-31,2708,2575,5283
2578,MOGU,-1.2108426093299083,3.3077617707298477,213681968,2020-03-31,5278,7,5285
2579,SVVC,0.005763846153303976,0.013427687239947517,40600124,2020-12-31,2801,2485,5286
2580,CARA,0.022955823361653332,0.0037325747192560386,1455903872,2020-12-31,2534,2772,5306
2581,GGN,0.009049198392771336,0.011084276126431467,595141184,2020-12-31,2754,2557,5311
2582,YELL,0.010398716501277556,0.01003520409233375,484160896,2020-12-31,2729,2591,5320
2583,BXMX,0.010067881064396857,0.0101507532647327,1434318848,2020-12-31,2735,2586,5321
2584,ADX,0.009742035139488339,0.010315408168911785,2104275456,2020-12-31,2741,2581,5322
2585,GDV,0.009210793804842108,0.01063612606334359,2228251904,2020-12-31,2749,2573,5322
2586,OSMT,0.020918397892594146,0.004679360671299421,212085600,2020-12-31,2575,2751,5326
2587,TNL,0.016571315841388833,0.007422245363416629,5524329984,2020-12-31,2642,2684,5326
2588,BALY,0.018746669474678436,0.005825734882690979,1911515392,2020-12-31,2609,2719,5328
2589,OXBR,0.01651341715143554,0.007134744266847868,15022009,2020-12-31,2643,2689,5332
2590,PINE,0.010446787938749353,0.00960535432138399,135595280,2020-12-31,2728,2605,5333
2591,CTT,0.013406909350125552,0.008098364771803136,516913248,2020-12-31,2683,2654,5337
2592,AIG,0.005101375153302195,0.012170216996672614,40185278464,2020-12-31,2813,2534,5347
2593,TH,0.014611857572952905,0.007532058244071086,316362496,2020-12-31,2671,2677,5348
2594,TLC,-1.5217127664536592,3.9891616279116735,271941056,2020-12-31,5342,6,5348
2595,AIRC,0.013402337104325257,0.007766253999291594,6370640896,2020-12-31,2684,2666,5350
2596,MXF,0.01014709911477985,0.008917902227966772,216159216,2020-10-31,2734,2624,5358
2597,VVPR,0.021537318975120682,0.002809366248824135,165670256,2020-06-30,2559,2800,5359
2598,GES,0.010295188500559407,0.008717267721958055,1737596032,2021-01-30,2732,2630,5362
2599,COHR,0.019846652341371722,0.0035474477415546753,6496606720,2020-10-03,2587,2778,5365
2600,INTT,0.019378506689684938,0.0038961224678501346,116663784,2020-12-31,2597,2771,5368
2601,PEAK,0.012459935267949335,0.0076758562877760105,17454096384,2020-12-31,2699,2669,5368
2602,SAFM,0.014694638517933298,0.006470655858375759,3634495744,2020-10-31,2669,2701,5370
2603,PLIN,0.010594962276541739,0.00818970327923955,28988900,2020-06-30,2725,2646,5371
2604,UPLD,0.022322283962444914,0.0018063377358505611,1386003840,2020-12-31,2543,2830,5373
2605,EXK,0.020322464392598046,0.002964969052946913,895318656,2020-12-31,2582,2792,5374
2606,GCV,0.007414224052518065,0.009975351250708349,120080536,2020-12-31,2781,2593,5374
2607,SPXX,0.00927339423738601,0.008811547473055181,293807872,2020-12-31,2748,2629,5377
2608,CNDT,0.013739545997610514,0.006613434324838423,1427769472,2020-12-31,2682,2698,5380
2609,URBN,0.011387280860523858,0.007816215429676194,3848134144,2021-01-31,2715,2665,5380
2610,CVLG,0.008490496472827251,0.009373582623595222,343056000,2020-12-31,2763,2617,5380
2611,CHX,0.01614579143908333,0.0053834197329399106,4116848640,2020-12-31,2652,2731,5383
2612,GNK,0.006854190501064961,0.009508188958039251,455168640,2020-12-31,2785,2610,5395
2613,EEA,0.008052199919317507,0.008873668841866003,79461808,2020-12-31,2770,2626,5396
2614,EMF,0.008590345492745769,0.008281883796711659,311605536,2020-08-31,2761,2641,5402
2615,UAN,0.009686361962437088,0.007933881303867107,513764992,2020-12-31,2742,2662,5404
2616,ETB,0.008802527648628206,0.008181369009614723,425868800,2020-12-31,2758,2648,5406
2617,TECK,0.005316069266803516,0.009896595510001237,10542059520,2020-12-31,2809,2597,5406
2618,BNFT,0.014313620715330641,0.005223356343379482,470659360,2020-12-31,2675,2735,5410
2619,TWTR,0.017979184375335855,0.0029763561586511407,56820514816,2020-12-31,2622,2791,5413
2620,PTVCA,0.006818382838798966,0.008556305005027751,325924448,2020-12-31,2787,2634,5421
2621,PTVCB,0.006818382838798966,0.008554993955689505,326065280,2020-12-31,2787,2635,5422
2622,ETW,0.00819346003852908,0.00805279766580177,1143661696,2020-12-31,2767,2658,5425
2623,RDWR,0.01296438908059829,0.005004183212768521,1232938880,2020-12-31,2691,2739,5430
2624,INDT,0.012341605557985897,0.005478385021202091,450412832,2020-11-30,2702,2728,5430
2625,MRC,0.011049723756906077,0.006076796473132334,986603904,2020-12-31,2722,2708,5430
2626,HROW,0.015761636850201235,0.0036982289478218263,183182976,2020-12-31,2658,2773,5431
2627,VSAT,0.009657288297993739,0.007085155655431546,3352419072,2020-03-31,2743,2691,5434
2628,TS,0.009086107395083087,0.0074550059590323785,12802120704,2020-12-31,2752,2683,5435
2629,SVT,0.005654998364256671,0.008463213941165556,20467338,2020-12-31,2803,2637,5440
2630,PSTL,0.009518694208315456,0.0061820501333948895,236360496,2020-12-31,2744,2705,5449
2631,KFS,0.010327616180081366,0.005721807534738298,101745728,2020-12-31,2731,2722,5453
2632,GPM,0.00750693793388863,0.007534491362832401,359668960,2020-12-31,2777,2676,5453
2633,VWTR,0.012881876735803344,0.00409279402907661,168761040,2020-12-31,2692,2762,5454
2634,IRDM,0.011571904434847664,0.004905808569481396,5760067584,2020-12-31,2712,2746,5458
2635,EOI,0.007994239055179724,0.007221560568025859,687774976,2020-09-30,2771,2687,5458
2636,HCHC,0.0015271640239147388,0.009992992488433388,320059168,2020-12-31,2867,2592,5459
2637,ETY,0.007957566919481053,0.007025638998963507,1996595584,2020-10-31,2773,2692,5465
2638,HRTG,0.007899194336467675,0.006876786921434547,300066592,2020-12-31,2774,2695,5469
2639,RDFN,0.017458861303824322,0.001088792608103432,6963309056,2020-12-31,2626,2853,5479
2640,CRM,0.015640038498556306,0.0020025097342711165,213008875520,2021-01-31,2659,2822,5481
2641,TXRH,0.012288081544626017,0.003592671071453417,6933575168,2020-12-29,2705,2776,5481
2642,FFA,0.006841557333762705,0.006464793508881206,387066848,2020-12-31,2786,2702,5488
2643,MAC,0.005651087273079385,0.007259317894916776,2260833280,2020-12-31,2804,2685,5489
2644,CII,0.006670751818917439,0.0064549317617605545,885957696,2020-12-31,2790,2703,5493
2645,LGI,0.006289492056323897,0.0067103887999076985,256941568,2020-12-31,2796,2697,5493
2646,WPG,0.006055885006971908,0.006767475175609526,51043228,2020-12-31,2798,2696,5494
2647,CSR,0.006861263495979075,0.00598620112770118,896434624,2020-12-31,2784,2711,5495
2648,APOP,-2.8396915584415585,5.461522880518162,11415711,2020-12-31,5493,2,5495
2649,STFC,0.005403111739745403,0.007116166356208075,878829440,2020-12-31,2806,2690,5496
2650,CONE,0.009365723839093794,0.0046438587662776636,8378664960,2020-12-31,2746,2752,5498
2651,DVN,0.010286036353388756,0.003940381435555757,14835125248,2020-12-31,2733,2767,5500
2652,JEQ,0.005702580647793312,0.006097348490415722,122687768,2020-10-31,2802,2706,5508
2653,JRVR,0.006298625417165195,0.005877664098336253,1498895232,2020-12-31,2795,2717,5512
2654,SPRT,0.011901946874753684,0.002763401784930625,118892592,2020-12-31,2710,2803,5513
2655,NXRT,0.0074598874307166526,0.00529050978681436,1174431104,2020-12-31,2780,2733,5513
2656,STON,0.002926574165021237,0.007558262830065441,220506656,2020-12-31,2841,2673,5514
2657,GRF,0.00516249302951219,0.005897555968643485,34020572,2020-12-31,2812,2714,5526
2658,BOOM,0.010385763121201985,0.0028435422406475406,813792640,2020-12-31,2730,2798,5528
2659,GAB,0.005368798654013836,0.005796097971774109,1829786240,2020-12-31,2807,2721,5528
2660,AVNS,0.01105904404873477,0.0025499109014454698,2079006336,2020-12-31,2721,2808,5529
2661,CXP,0.004996279040536615,0.005845437221177098,2033234432,2020-12-31,2815,2718,5533
2662,GORO,0.009070960347743441,0.0032640668506641437,212151712,2020-12-31,2753,2781,5534
2663,EDAP,0.013962079643613843,0.0009723605933805928,266354240,2020-12-31,2678,2857,5535
2664,NAII,0.006358785743887277,0.004928475078819466,102297136,2020-06-30,2794,2743,5537
2665,VCEL,0.014355485889622533,0.0008945120359158801,2662862080,2020-12-31,2674,2864,5538
2666,MIME,0.011180950312919262,0.0020567284435565026,2602992640,2020-03-31,2718,2820,5538
2667,PXD,0.00805376904803291,0.003912955905597814,31899017216,2020-12-31,2769,2769,5538
2668,CLMT,0.007028112449799197,0.004407976386200623,471842400,2020-12-31,2783,2757,5540
2669,CD,0.003311843347979374,0.006341937605528512,5431557632,2020-12-31,2836,2704,5540
2670,CYCCP,-3.2181543116490166,0.8188380168106614,17930862,2020-12-31,5521,20,5541
2671,BKD,0.004640775526780847,0.005649309635767166,1231030016,2020-12-31,2818,2725,5543
2672,MCN,0.0053687601275735665,0.0049701135195170405,165480512,2020-12-31,2808,2740,5548
2673,PLMR,0.009197920084662841,0.0028433437608583246,1899257344,2020-12-31,2750,2799,5549
2674,PLYM,0.005929856945085372,0.00477188094948403,479389216,2020-12-31,2800,2749,5549
2675,CDAY,0.009299806940716674,0.0022353445698700043,13342753792,2020-12-31,2747,2811,5558
2676,ADNT,0.007115267330758284,0.003396610438983368,4080390400,2020-09-30,2782,2780,5562
2677,TGB,0.005045197611973398,0.004805162193905528,513395520,2020-12-31,2814,2748,5562
2678,CO,0.277897883775947,-0.12906801913814556,571289664,2020-03-31,405,5160,5565
2679,HLT,0.011972930765226444,0.0010442547081867084,34520555520,2020-12-31,2709,2856,5565
2680,ORPH,-3.7318492625640083,2.785518507955857,318008544,2020-12-31,5557,8,5565
2681,ZG,0.011102963486035266,0.0011395065339993176,35084226560,2020-12-31,2719,2849,5568
2682,SWZ,0.004342056613274925,0.004931998077220914,121553160,2020-12-31,2826,2742,5568
2683,CNX,0.0039028932750727716,0.005099003894454023,3039156224,2020-12-31,2831,2737,5568
2684,Z,0.011102963486035266,0.0011392614070099992,35091951616,2020-12-31,2719,2850,5569
2685,ETV,0.004918505202516896,0.004561636206178831,1459521024,2020-12-31,2816,2754,5570
2686,ANIK,0.008391530322388579,0.0026458436748730972,570318080,2020-12-31,2765,2806,5571
2687,MLND,-3.992895992895993,4.476289552669696,22089880,2020-12-31,5568,4,5572
2688,DXYN,0.0039029685214026144,0.004917346013577155,57459152,2020-12-26,2830,2745,5575
2689,VAC,0.007506824385805277,0.002796321854489742,7271216640,2020-12-31,2778,2801,5579
2690,BIF,0.004385229365407185,0.0044462293082129295,1287350144,2020-11-30,2824,2756,5580
2691,CALM,0.006181487283586327,0.003221433469622199,1931285504,2020-05-30,2797,2785,5582
2692,REVG,0.006801909307875895,0.0028689473545865274,1210391424,2020-10-31,2789,2797,5586
2693,KF,0.005225436552061082,0.003643371556082342,224568816,2020-06-30,2811,2775,5586
2694,SAIL,0.009180520637798145,0.0013309938693534457,4457335296,2020-12-31,2751,2843,5594
2695,CLM,0.00448714566975211,0.003262837335743228,1056344640,2020-12-31,2819,2782,5601
2696,FRPT,0.010604837904810245,0.0005147163548113163,7259464704,2020-12-31,2724,2878,5602
2697,USA,0.0036252121762903734,0.003423025244630543,1719368704,2020-12-31,2833,2779,5612
2698,ANDE,0.003929601758226554,0.003162456913230919,934345280,2020-12-31,2829,2786,5615
2699,CRF,0.004138557157296782,0.0029417225744227875,550349568,2020-12-31,2827,2793,5620
2700,BWEN,0.004456553879947619,0.0027866444136601678,97456616,2020-12-31,2820,2802,5622
2701,RLX,0.008880127397310231,0.0008206651879093426,14639762432,2020-12-31,2757,2866,5623
2702,MTSI,0.008260436396281982,0.0009712630123304687,4043260416,2020-10-02,2766,2858,5624
2703,AXS,0.002233564784530147,0.003561476248984668,4330904064,2020-12-31,2847,2777,5624
2704,GEG,0.004414147622506566,0.0026866210651169745,65123828,2020-06-30,2822,2804,5626
2705,SRI,0.0054049192124026955,0.0019130514175354056,828434880,2020-12-31,2805,2823,5628
2706,MEG,0.00876302787428055,0.0007432409155956064,1348003712,2020-12-31,2760,2869,5629
2707,SCKT,0.006609204546790978,0.001358985439284233,54212176,2020-12-31,2792,2841,5633
2708,GAM,0.0023877657485410846,0.0030278954198877687,1017052864,2020-12-31,2845,2788,5633
2709,HSKA,0.008487003464877562,0.0007077495038416254,1843317504,2020-12-31,2764,2870,5634
2710,EPAY,0.0077657293483857585,0.0009135594513246375,2073612032,2020-06-30,2775,2863,5638
2711,CTRM,0.006491646354406819,0.0012144693742980458,359142048,2020-12-31,2793,2846,5639
2712,BPYU,0.0021471250530356646,0.002977278362823069,688853760,2020-12-31,2851,2790,5641
2713,MIC,0.003787878787878788,0.0024067889367361856,2791422208,2020-12-31,2832,2810,5642
2714,AEO,0.004369577659312036,0.001852920397744489,5431118848,2021-01-30,2825,2825,5650
2715,AEG,0.0003974886380506774,0.003999379971593586,9974433792,2020-12-31,2886,2766,5652
2716,HFFG,0.0044442143193923,0.001655589284226411,375333888,2020-12-31,2821,2832,5653
2717,TLS,0.008085372825524732,0.00013339174712141238,2293623552,2020-12-31,2768,2893,5661
2718,TYG,0.0022196379214886467,0.002203494131380615,309552448,2020-11-30,2848,2813,5661
2719,CALT,-6.19089031054245,1.850093892257564,689829248,2020-12-31,5653,10,5663
2720,KINS,0.0017291841504452458,0.0026360351970262613,87323424,2020-12-31,2863,2807,5670
2721,AWX,0.0017519815759356853,0.0024643881503552626,15402749,2020-12-31,2862,2809,5671
2722,GLO,0.002183068052092221,0.0019072792230139823,415050272,2020-10-31,2849,2824,5673
2723,CHN,0.0018902968326079688,0.0021042739001103927,307033024,2020-10-31,2857,2816,5673
2724,TWN,0.0020713173345286518,0.002078234138818099,214356576,2020-08-31,2855,2819,5674
2725,GLQ,0.0021096549079304846,0.0018308798381122002,210502032,2020-10-31,2853,2828,5681
2726,CLNY,0.0017015995057503808,0.002083787702668891,3265590784,2020-12-31,2864,2818,5682
2727,NTST,0.002080303199820989,0.0018279354022006573,549834688,2020-12-31,2854,2829,5683
2728,AXON,0.005270880399866985,0.0006385320881636167,9530574848,2020-12-31,2810,2874,5684
2729,CKX,0.0025122512793225994,0.0012589084385338314,25563300,2020-12-31,2843,2844,5687
2730,RVT,0.0018025694736702154,0.0018374168262171838,1895678080,2020-12-31,2860,2827,5687
2731,ALJJ,0.0021669471403213537,0.0013710571241324198,63904708,2020-09-30,2850,2839,5689
2732,SLCA,0.0018864833348592245,0.001486456434114715,865668416,2020-12-31,2858,2836,5694
2733,HBIO,0.004400286715514495,0.0006926107843798956,260060528,2020-12-31,2823,2872,5695
2734,IHRT,0.003255765803143736,0.0009472133047146939,2549636352,2020-12-31,2839,2860,5699
2735,TJX,0.0033715724926732028,0.0007853804166634013,83754614784,2021-01-30,2835,2868,5703
2736,AIV,0.0014971049061766751,0.001390650834603762,929565824,2020-12-31,2869,2837,5706
2737,GGT,0.00127343526046895,0.0015323605709914407,253651568,2020-12-31,2873,2834,5707
2738,ANF,0.0015060629903636072,0.0013446390264999753,2403738368,2021-01-30,2868,2842,5710
2739,TTM,0.001163308403384511,0.001373141260294655,15158902784,2020-03-31,2874,2838,5712
2740,ELAN,0.0032558936571274693,0.0006245421533127926,14065800192,2020-12-31,2838,2875,5713
2741,CZR,0.0018549253148491653,0.001086853242328416,20063322112,2020-12-31,2859,2854,5713
2742,TEAM,0.004066987787198891,0.00024326981998680752,56363974656,2020-06-30,2828,2886,5714
2743,TCMD,0.0032985750488139253,0.00038210097510859886,1060133376,2020-12-31,2837,2881,5718
2744,APHA,0.0030858931914383467,0.000512594144396244,5148876288,2020-05-31,2840,2879,5719
2745,KSS,0.0012942191544434857,0.0011067223075566443,9890535424,2021-01-30,2872,2851,5723
2746,KRP,0.0014893603704691154,0.0010749445499976982,596985024,2020-12-31,2870,2855,5725
2747,PRTS,0.0027864625149949464,0.0003576217100148306,788716992,2021-01-02,2842,2884,5726
2748,CLVT,0.0024191474220942263,0.00020235411759030218,15955888128,2020-12-31,2844,2889,5733
2749,CWK,0.0019072100833367883,0.0005661940050228635,3743123712,2020-12-31,2856,2877,5733
2750,EVRI,0.002138207964281055,0.0003591316511250774,1268490368,2020-12-31,2852,2883,5735
2751,TRUE,0.00161766774511183,0.0006995533169579055,493461984,2020-12-31,2866,2871,5737
2752,ZEUS,0.0011233862350876849,0.0009387855340810212,322942048,2020-12-31,2876,2861,5737
2753,BBGI,0.0016637881021982714,0.0006489035710740687,87183760,2020-12-31,2865,2873,5738
2754,BVH,0.000897586339132988,0.0009256808178744134,387503648,2020-12-31,2877,2862,5739
2755,GRVY,0.9066242287380211,-3.3109607252677327,888625344,2020-12-31,37,5714,5751
2756,TBI,0.0008616418891391957,0.0005986928068268481,807415552,2020-12-27,2878,2876,5754
2757,IIN,0.0011569561991473735,0.0003941751875631216,223343760,2020-12-31,2875,2880,5755
2758,SONO,0.0017627192674575505,9.051347783332136e-05,4989565440,2020-10-03,2861,2897,5758
2759,ASLE,0.0006431300536918481,0.0003660287186262183,516361184,2020-12-31,2880,2882,5762
2760,OPRA,0.0005983727180959099,0.00022028598522366027,1205350144,2020-12-31,2881,2888,5769
2761,DJCO,0.0005295411766404945,0.0002338911708634539,438167200,2020-09-30,2884,2887,5771
2762,SVC,0.00031320023015212546,0.00030578873218849514,2050410496,2020-12-31,2888,2885,5773
2763,BFAM,0.0006700999403184002,0.00011365461056257884,10016397312,2020-12-31,2879,2895,5774
2764,PCOM,0.0005402485143165856,0.00014312402707233069,236739200,2020-12-31,2883,2892,5775
2765,ARGO,0.00023742021982319175,0.00016964223565353736,1875289344,2020-12-31,2889,2890,5779
2766,ORBC,0.0004706907823055132,9.485939045252882e-05,909146240,2020-12-31,2885,2896,5781
2767,BME,0.0001225771759382912,0.00012041516685827507,563417088,2020-12-31,2890,2894,5784
2768,CVLT,0.00011380607444913867,1.7780494043891354e-05,3165288192,2020-03-31,2891,2898,5789
2769,MSGM,7.440197708172612e-05,2.7088054584050074e-06,412509920,2020-12-31,2892,2899,5791
2770,AACQ,0.0,0.0,932793728,2020-12-31,2893,2900,5793
2771,ABCB,0.0,0.0,3627149824,2020-12-31,2893,2900,5793
2772,ABTX,0.0,0.0,812528448,2020-12-31,2893,2900,5793
2773,ACAC,0.0,0.0,268254816,2020-12-31,2893,2900,5793
2774,ACBI,0.0,0.0,498311328,2020-12-31,2893,2900,5793
2775,ACEV,0.0,0.0,287212480,2020-12-31,2893,2900,5793
2776,ACNB,0.0,0.0,253868528,2020-12-31,2893,2900,5793
2777,ADER,0.0,0.0,338593760,2020-12-31,2893,2900,5793
2778,AFBI,0.0,0.0,82142744,2020-12-31,2893,2900,5793
2779,AFCG,0.0,0.0,299284896,2020-12-31,2893,2900,5793
2780,AGBA,0.0,0.0,56583968,2020-12-31,2893,2900,5793
2781,AGC,0.0,0.0,1546875008,2020-12-31,2893,2900,5793
2782,AGNC,0.0,0.0,9060940800,2020-12-31,2893,2900,5793
2783,AGNCM,0.0,0.0,9111336960,2020-12-31,2893,2900,5793
2784,AGNCN,0.0,0.0,8792345600,2020-12-31,2893,2900,5793
2785,AHAC,0.0,0.0,143847440,2020-12-31,2893,2900,5793
2786,AKIC,0.0,0.0,289100288,2020-12-31,2893,2900,5793
2787,ALRS,0.0,0.0,543582272,2020-12-31,2893,2900,5793
2788,ALTA,0.0,0.0,799085184,2020-12-31,2893,2900,5793
2789,ALTU,0.0,0.0,381750016,2020-12-31,2893,2900,5793
2790,AMAL,0.0,0.0,531445920,2020-12-31,2893,2900,5793
2791,AMNB,0.0,0.0,356908576,2020-12-31,2893,2900,5793
2792,AMRB,0.0,0.0,98977008,2020-12-31,2893,2900,5793
2793,AMTB,0.0,0.0,694513216,2020-12-31,2893,2900,5793
2794,AMTBB,0.0,0.0,697571904,2020-12-31,2893,2900,5793
2795,ARBG,0.0,0.0,284912480,2020-12-31,2893,2900,5793
2796,AROW,0.0,0.0,520221504,2020-12-31,2893,2900,5793
2797,ASRV,0.0,0.0,64851560,2020-12-31,2893,2900,5793
2798,ATAX,0.0,0.0,347303328,2020-12-31,2893,2900,5793
2799,ATLC,0.0,0.0,467310336,2020-12-31,2893,2900,5793
2800,ATLO,0.0,0.0,233086256,2020-12-31,2893,2900,5793
2801,AUB,0.0,0.0,3074477056,2020-12-31,2893,2900,5793
2802,AUBN,0.0,0.0,135805856,2020-12-31,2893,2900,5793
2803,BANF,0.0,0.0,2334825472,2020-12-31,2893,2900,5793
2804,BANR,0.0,0.0,1902617984,2020-12-31,2893,2900,5793
2805,BCBP,0.0,0.0,234904240,2020-12-31,2893,2900,5793
2806,BCML,0.0,0.0,200462736,2020-12-31,2893,2900,5793
2807,BCOW,0.0,0.0,69139576,2020-12-31,2893,2900,5793
2808,BCYP,0.0,0.0,147478240,2020-12-31,2893,2900,5793
2809,BFC,0.0,0.0,558623168,2020-12-31,2893,2900,5793
2810,BFIN,0.0,0.0,151600512,2020-12-31,2893,2900,5793
2811,BFST,0.0,0.0,489102144,2020-12-31,2893,2900,5793
2812,BGCP,0.0,0.0,2103029632,2020-12-31,2893,2900,5793
2813,BIOT,0.0,0.0,281175008,2020-12-31,2893,2900,5793
2814,BKSC,0.0,0.0,115929872,2020-12-31,2893,2900,5793
2815,BLTS,0.0,0.0,283187520,2020-12-31,2893,2900,5793
2816,BMRC,0.0,0.0,529757952,2020-12-31,2893,2900,5793
2817,BMTC,0.0,0.0,919393984,2020-12-31,2893,2900,5793
2818,BOCH,0.0,0.0,219135504,2020-12-31,2893,2900,5793
2819,BOKF,0.0,0.0,6230867968,2020-12-31,2893,2900,5793
2820,BOKFL,0.0,0.0,5261950464,2020-12-31,2893,2900,5793
2821,BOTJ,0.0,0.0,62926424,2020-12-31,2893,2900,5793
2822,BPFH,0.0,0.0,1105813248,2020-12-31,2893,2900,5793
2823,BPOP,0.0,0.0,6035601408,2020-12-31,2893,2900,5793
2824,BPRN,0.0,0.0,184274432,2020-12-31,2893,2900,5793
2825,BRKL,0.0,0.0,1190091392,2020-12-31,2893,2900,5793
2826,BSBK,0.0,0.0,144109744,2020-12-31,2893,2900,5793
2827,BSRR,0.0,0.0,416272448,2020-12-31,2893,2900,5793
2828,BSVN,0.0,0.0,155016560,2020-12-31,2893,2900,5793
2829,BTNB,0.0,0.0,401033728,2020-12-31,2893,2900,5793
2830,BTWN,0.0,0.0,879846784,2020-12-31,2893,2900,5793
2831,BUSE,0.0,0.0,1397105024,2020-12-31,2893,2900,5793
2832,BWB,0.0,0.0,458769280,2020-12-31,2893,2900,5793
2833,BWFG,0.0,0.0,217700560,2020-12-31,2893,2900,5793
2834,BYFC,0.0,0.0,63330504,2020-12-31,2893,2900,5793
2835,CAC,0.0,0.0,713293632,2020-12-31,2893,2900,5793
2836,CACC,0.0,0.0,6095001600,2020-12-31,2893,2900,5793
2837,CALB,0.0,0.0,137900736,2020-12-31,2893,2900,5793
2838,CAPA,0.0,0.0,173221600,2020-12-31,2893,2900,5793
2839,CARE,0.0,0.0,379777536,2020-12-31,2893,2900,5793
2840,CARV,0.0,0.0,31299406,2020-03-31,2893,2900,5793
2841,CASH,0.0,0.0,1515361792,2020-09-30,2893,2900,5793
2842,CATC,0.0,0.0,584655936,2020-12-31,2893,2900,5793
2843,CATY,0.0,0.0,3294524160,2020-12-31,2893,2900,5793
2844,CBAN,0.0,0.0,145478320,2020-12-31,2893,2900,5793
2845,CBFV,0.0,0.0,117817144,2020-12-31,2893,2900,5793
2846,CBMB,0.0,0.0,50013288,2020-12-31,2893,2900,5793
2847,CBNK,0.0,0.0,269128000,2020-12-31,2893,2900,5793
2848,CBSH,0.0,0.0,9093447680,2020-12-31,2893,2900,5793
2849,CBTX,0.0,0.0,788004608,2020-12-31,2893,2900,5793
2850,CCB,0.0,0.0,326966944,2020-12-31,2893,2900,5793
2851,CCBG,0.0,0.0,436837376,2020-12-31,2893,2900,5793
2852,CCNE,0.0,0.0,414338272,2020-12-31,2893,2900,5793
2853,CENH,0.0,0.0,431249984,2020-12-18,2893,2900,5793
2854,CFB,0.0,0.0,739044288,2020-12-31,2893,2900,5793
2855,CFBK,0.0,0.0,131922312,2020-12-31,2893,2900,5793
2856,CFFI,0.0,0.0,153079344,2020-12-31,2893,2900,5793
2857,CFFN,0.0,0.0,1836429824,2020-09-30,2893,2900,5793
2858,CGRO,0.0,0.0,185371872,2020-12-31,2893,2900,5793
2859,CHCO,0.0,0.0,1291156864,2020-12-31,2893,2900,5793
2860,CHMG,0.0,0.0,205716416,2020-12-31,2893,2900,5793
2861,CIVB,0.0,0.0,365117184,2020-12-31,2893,2900,5793
2862,CIZN,0.0,0.0,109115480,2020-12-31,2893,2900,5793
2863,CLBK,0.0,0.0,1956566400,2020-12-31,2893,2900,5793
2864,CLDB,0.0,0.0,95349088,2020-12-31,2893,2900,5793
2865,CNBKA,0.0,0.0,637470016,2020-12-31,2893,2900,5793
2866,CNNB,0.0,0.0,39330408,2020-12-31,2893,2900,5793
2867,CNOB,0.0,0.0,1021291200,2020-12-31,2893,2900,5793
2868,COFS,0.0,0.0,181765152,2020-12-31,2893,2900,5793
2869,COLB,0.0,0.0,3172634368,2020-12-31,2893,2900,5793
2870,COVA,0.0,0.0,364535968,2020-12-31,2893,2900,5793
2871,COWN,0.0,0.0,996507008,2020-12-31,2893,2900,5793
2872,CPSS,0.0,0.0,89915432,2020-12-31,2893,2900,5793
2873,CSTR,0.0,0.0,401162720,2020-12-31,2893,2900,5793
2874,CTAQ,0.0,0.0,510702496,2020-12-31,2893,2900,5793
2875,CTBI,0.0,0.0,793083200,2020-12-31,2893,2900,5793
2876,CVBF,0.0,0.0,2999074816,2020-12-31,2893,2900,5793
2877,CVCY,0.0,0.0,240347088,2020-12-31,2893,2900,5793
2878,CVLY,0.0,0.0,173183824,2020-12-31,2893,2900,5793
2879,CWBC,0.0,0.0,111390088,2020-12-31,2893,2900,5793
2880,CZNC,0.0,0.0,373781024,2020-12-31,2893,2900,5793
2881,CZWI,0.0,0.0,149879120,2020-12-31,2893,2900,5793
2882,DGNS,0.0,0.0,376241792,2020-12-31,2893,2900,5793
2883,EAC,0.0,0.0,403649984,2020-12-31,2893,2900,5793
2884,EBC,0.0,0.0,3632443136,2020-12-31,2893,2900,5793
2885,EBMT,0.0,0.0,159358592,2020-12-31,2893,2900,5793
2886,EBSB,0.0,0.0,967106624,2020-12-31,2893,2900,5793
2887,EBTC,0.0,0.0,403698688,2020-12-31,2893,2900,5793
2888,EFSC,0.0,0.0,1565577984,2020-12-31,2893,2900,5793
2889,EGBN,0.0,0.0,1746646784,2020-12-31,2893,2900,5793
2890,EMCF,0.0,0.0,71867152,2020-12-31,2893,2900,5793
2891,ENVI,0.0,0.0,253575008,2020-12-31,2893,2900,5793
2892,EPHY,0.0,0.0,500902496,2020-12-31,2893,2900,5793
2893,EQBK,0.0,0.0,411730944,2020-12-31,2893,2900,5793
2894,ESBK,0.0,0.0,48538740,2020-12-31,2893,2900,5793
2895,ESQ,0.0,0.0,179559024,2020-12-31,2893,2900,5793
2896,ESSA,0.0,0.0,170102976,2020-09-30,2893,2900,5793
2897,ESXB,0.0,0.0,189586928,2020-12-31,2893,2900,5793
2898,EUCR,0.0,0.0,132437544,2020-12-31,2893,2900,5793
2899,EWBC,0.0,0.0,10529603584,2020-12-31,2893,2900,5793
2900,FBIZ,0.0,0.0,212201840,2020-12-31,2893,2900,5793
2901,FBMS,0.0,0.0,793650944,2020-12-31,2893,2900,5793
2902,FBNC,0.0,0.0,1236945280,2020-12-31,2893,2900,5793
2903,FCAP,0.0,0.0,158966256,2020-12-31,2893,2900,5793
2904,FCBC,0.0,0.0,520941696,2020-12-31,2893,2900,5793
2905,FCBP,0.0,0.0,290939424,2020-12-31,2893,2900,5793
2906,FCCO,0.0,0.0,143915680,2020-12-31,2893,2900,5793
2907,FCCY,0.0,0.0,185978368,2020-12-31,2893,2900,5793
2908,FCNCA,0.0,0.0,8298753536,2020-12-31,2893,2900,5793
2909,FDBC,0.0,0.0,292340864,2020-12-31,2893,2900,5793
2910,FFBC,0.0,0.0,2403202560,2020-12-31,2893,2900,5793
2911,FFBW,0.0,0.0,82126184,2020-12-31,2893,2900,5793
2912,FFIC,0.0,0.0,669539328,2020-12-31,2893,2900,5793
2913,FFIN,0.0,0.0,6652497920,2020-12-31,2893,2900,5793
2914,FFNW,0.0,0.0,135564768,2020-12-31,2893,2900,5793
2915,FFWM,0.0,0.0,1027400832,2020-12-31,2893,2900,5793
2916,FGBI,0.0,0.0,176024384,2020-12-31,2893,2900,5793
2917,FHB,0.0,0.0,3599722496,2020-12-31,2893,2900,5793
2918,FIBK,0.0,0.0,2923652352,2020-12-31,2893,2900,5793
2919,FIII,0.0,0.0,320551840,2020-12-31,2893,2900,5793
2920,FINM,0.0,0.0,503527488,2020-12-31,2893,2900,5793
2921,FISI,0.0,0.0,477177760,2020-12-31,2893,2900,5793
2922,FITB,0.0,0.0,27318382592,2020-12-31,2893,2900,5793
2923,FITBI,0.0,0.0,19908880384,2020-12-31,2893,2900,5793
2924,FLIC,0.0,0.0,520600224,2020-12-31,2893,2900,5793
2925,FMAO,0.0,0.0,283072800,2020-12-31,2893,2900,5793
2926,FMBH,0.0,0.0,796430720,2020-12-31,2893,2900,5793
2927,FMBI,0.0,0.0,2519233792,2020-12-31,2893,2900,5793
2928,FMNB,0.0,0.0,475230912,2020-12-31,2893,2900,5793
2929,FNCB,0.0,0.0,146134960,2020-12-31,2893,2900,5793
2930,FNLC,0.0,0.0,318108224,2020-12-31,2893,2900,5793
2931,FNWB,0.0,0.0,170351696,2020-12-31,2893,2900,5793
2932,FRAF,0.0,0.0,133092608,2020-12-31,2893,2900,5793
2933,FRBA,0.0,0.0,223569440,2020-12-31,2893,2900,5793
2934,FRBK,0.0,0.0,215455792,2020-12-31,2893,2900,5793
2935,FRHC,0.0,0.0,3131971072,2020-03-31,2893,2900,5793
2936,FRME,0.0,0.0,2541415168,2020-12-31,2893,2900,5793
2937,FRST,0.0,0.0,380018688,2020-12-31,2893,2900,5793
2938,FSBW,0.0,0.0,286365152,2020-12-31,2893,2900,5793
2939,FSEA,0.0,0.0,60126952,2020-12-31,2893,2900,5793
2940,FSFG,0.0,0.0,161922736,2020-09-30,2893,2900,5793
2941,FSSI,0.0,0.0,323438016,2020-12-31,2893,2900,5793
2942,FTIV,0.0,0.0,343446784,2020-12-31,2893,2900,5793
2943,FTOC,0.0,0.0,1043346688,2020-12-31,2893,2900,5793
2944,FULT,0.0,0.0,2800982784,2020-12-31,2893,2900,5793
2945,FUNC,0.0,0.0,120398920,2020-12-31,2893,2900,5793
2946,FUSB,0.0,0.0,59588808,2020-12-31,2893,2900,5793
2947,FUTU,0.0,0.0,21253062656,2020-12-31,2893,2900,5793
2948,FVCB,0.0,0.0,225194752,2020-12-31,2893,2900,5793
2949,FXNC,0.0,0.0,87680968,2020-12-31,2893,2900,5793
2950,GABC,0.0,0.0,1222546560,2020-12-31,2893,2900,5793
2951,GBCI,0.0,0.0,5588730368,2020-12-31,2893,2900,5793
2952,GBNY,0.0,0.0,25136610,2020-12-31,2893,2900,5793
2953,GCBC,0.0,0.0,211558240,2020-06-30,2893,2900,5793
2954,GFED,0.0,0.0,86531664,2020-12-31,2893,2900,5793
2955,GGAL,0.0,0.0,1740780544,2020-12-31,2893,2900,5793
2956,GHAC,0.0,0.0,255197248,2020-12-31,2893,2900,5793
2957,GLAQ,0.0,0.0,150206976,2020-12-31,2893,2900,5793
2958,GLBZ,0.0,0.0,33799788,2020-12-31,2893,2900,5793
2959,GNAC,0.0,0.0,287500000,2020-12-31,2893,2900,5793
2960,GNTY,0.0,0.0,459844864,2020-12-31,2893,2900,5793
2961,GSBC,0.0,0.0,768447808,2020-12-31,2893,2900,5793
2962,GWAC,0.0,0.0,222297312,2020-12-31,2893,2900,5793
2963,HAFC,0.0,0.0,616789312,2020-12-31,2893,2900,5793
2964,HBAN,0.0,0.0,16634286080,2020-12-31,2893,2900,5793
2965,HBANN,0.0,0.0,28362319872,2020-12-31,2893,2900,5793
2966,HBANO,0.0,0.0,13196022784,2020-12-31,2893,2900,5793
2967,HBCP,0.0,0.0,321728448,2020-12-31,2893,2900,5793
2968,HBMD,0.0,0.0,302208832,2020-12-31,2893,2900,5793
2969,HBNC,0.0,0.0,820408832,2020-12-31,2893,2900,5793
2970,HBT,0.0,0.0,469053792,2020-12-31,2893,2900,5793
2971,HCAQ,0.0,0.0,261237680,2020-12-31,2893,2900,5793
2972,HFBL,0.0,0.0,52389536,2020-06-30,2893,2900,5793
2973,HFWA,0.0,0.0,1021057792,2020-12-31,2893,2900,5793
2974,HIFS,0.0,0.0,609301504,2020-12-31,2893,2900,5793
2975,HLXA,0.0,0.0,155243056,2020-12-31,2893,2900,5793
2976,HMCO,0.0,0.0,388218752,2020-12-31,2893,2900,5793
2977,HMNF,0.0,0.0,96204304,2020-12-31,2893,2900,5793
2978,HMST,0.0,0.0,931486912,2020-12-31,2893,2900,5793
2979,HOMB,0.0,0.0,4454168064,2020-12-31,2893,2900,5793
2980,HONE,0.0,0.0,784216128,2020-12-31,2893,2900,5793
2981,HOPE,0.0,0.0,1882317696,2020-12-31,2893,2900,5793
2982,HTBI,0.0,0.0,423672768,2020-06-30,2893,2900,5793
2983,HTBK,0.0,0.0,740611200,2020-12-31,2893,2900,5793
2984,HTLF,0.0,0.0,2120071936,2020-12-31,2893,2900,5793
2985,HVBC,0.0,0.0,43075888,2020-12-31,2893,2900,5793
2986,HWBK,0.0,0.0,133612080,2020-12-31,2893,2900,5793
2987,HWC,0.0,0.0,3728222720,2020-12-31,2893,2900,5793
2988,IBCP,0.0,0.0,526466304,2020-12-31,2893,2900,5793
2989,IBKR,0.0,0.0,31038427136,2020-12-31,2893,2900,5793
2990,IBOC,0.0,0.0,2922496256,2020-12-31,2893,2900,5793
2991,IBTX,0.0,0.0,3207005952,2020-12-31,2893,2900,5793
2992,ICBK,0.0,0.0,144337600,2020-12-31,2893,2900,5793
2993,IIII,0.0,0.0,339977024,2020-12-31,2893,2900,5793
2994,INBK,0.0,0.0,344030528,2020-12-31,2893,2900,5793
2995,INDB,0.0,0.0,2757248768,2020-12-31,2893,2900,5793
2996,INKA,0.0,0.0,212606240,2020-12-31,2893,2900,5793
2997,IROQ,0.0,0.0,71450376,2020-06-30,2893,2900,5793
2998,ISBC,0.0,0.0,3643995648,2020-12-31,2893,2900,5793
2999,ISTR,0.0,0.0,218753488,2020-12-31,2893,2900,5793
3000,ITAC,0.0,0.0,97745176,2020-12-31,2893,2900,5793
3001,JCIC,0.0,0.0,421331264,2020-12-31,2893,2900,5793
3002,KFFB,0.0,0.0,57132444,2020-06-30,2893,2900,5793
3003,KRNY,0.0,0.0,1031453696,2020-06-30,2893,2900,5793
3004,KURI,0.0,0.0,428662496,2020-12-31,2893,2900,5793
3005,LARK,0.0,0.0,122234592,2020-12-31,2893,2900,5793
3006,LATN,0.0,0.0,251750000,2020-09-30,2893,2900,5793
3007,LBAI,0.0,0.0,881747392,2020-12-31,2893,2900,5793
3008,LBC,0.0,0.0,599067776,2020-12-31,2893,2900,5793
3009,LCNB,0.0,0.0,230926304,2020-12-31,2893,2900,5793
3010,LEGO,0.0,0.0,261220688,2020-12-31,2893,2900,5793
3011,LEVL,0.0,0.0,188535584,2020-12-31,2893,2900,5793
3012,LGHL,0.0,0.0,120733776,2020-12-31,2893,2900,5793
3013,LKFN,0.0,0.0,1776227712,2020-12-31,2893,2900,5793
3014,LMFA,0.0,0.0,33189090,2020-12-31,2893,2900,5793
3015,LMST,0.0,0.0,119689320,2020-12-31,2893,2900,5793
3016,LOAN,0.0,0.0,56276648,2020-12-31,2893,2900,5793
3017,LOB,0.0,0.0,2997594880,2020-12-31,2893,2900,5793
3018,LSAQ,0.0,0.0,103616960,2020-06-30,2893,2900,5793
3019,LSBK,0.0,0.0,86871608,2020-12-31,2893,2900,5793
3020,LWAC,0.0,0.0,224434192,2020-12-31,2893,2900,5793
3021,MBCN,0.0,0.0,131334464,2020-12-31,2893,2900,5793
3022,MBIN,0.0,0.0,1184383488,2020-12-31,2893,2900,5793
3023,MBINP,0.0,0.0,480945056,2020-12-31,2893,2900,5793
3024,MBWM,0.0,0.0,522398464,2020-12-31,2893,2900,5793
3025,MCAD,0.0,0.0,75197120,2020-12-31,2893,2900,5793
3026,MCBC,0.0,0.0,339923136,2020-12-31,2893,2900,5793
3027,MCBS,0.0,0.0,383578528,2020-12-31,2893,2900,5793
3028,MFNC,0.0,0.0,144540480,2020-12-31,2893,2900,5793
3029,MGYR,0.0,0.0,76818120,2020-09-30,2893,2900,5793
3030,MLAC,0.0,0.0,177891120,2020-12-31,2893,2900,5793
3031,MLVF,0.0,0.0,143295360,2020-09-30,2893,2900,5793
3032,MNSB,0.0,0.0,156548992,2020-12-31,2893,2900,5793
3033,MOFG,0.0,0.0,491898272,2020-12-31,2893,2900,5793
3034,MOGO,0.0,0.0,500822272,2020-12-31,2893,2900,5793
3035,MON,0.0,0.0,305937504,2020-12-31,2893,2900,5793
3036,MPB,0.0,0.0,217485872,2020-12-31,2893,2900,5793
3037,MRBK,0.0,0.0,159743424,2020-12-31,2893,2900,5793
3038,MRLN,0.0,0.0,162193584,2020-12-31,2893,2900,5793
3039,MSBI,0.0,0.0,631893568,2020-12-31,2893,2900,5793
3040,MSVB,0.0,0.0,49907672,2020-12-31,2893,2900,5793
3041,MUDS,0.0,0.0,436136384,2020-12-31,2893,2900,5793
3042,MVBF,0.0,0.0,392574944,2020-12-31,2893,2900,5793
3043,MYFW,0.0,0.0,205950448,2020-12-31,2893,2900,5793
3044,NAVI,0.0,0.0,2690422016,2020-12-31,2893,2900,5793
3045,NBN,0.0,0.0,228532160,2020-06-30,2893,2900,5793
3046,NBTB,0.0,0.0,1717110656,2020-12-31,2893,2900,5793
3047,NCBS,0.0,0.0,835089920,2020-12-31,2893,2900,5793
3048,NFBK,0.0,0.0,832865920,2020-12-31,2893,2900,5793
3049,NICK,0.0,0.0,81701416,2020-03-31,2893,2900,5793
3050,NKSH,0.0,0.0,225231424,2020-12-31,2893,2900,5793
3051,NMMC,0.0,0.0,165973248,2020-12-31,2893,2900,5793
3052,NRIM,0.0,0.0,260110128,2020-12-31,2893,2900,5793
3053,NTRS,0.0,0.0,22604736512,2020-12-31,2893,2900,5793
3054,NWBI,0.0,0.0,1848388352,2020-12-31,2893,2900,5793
3055,NWFL,0.0,0.0,214715424,2020-12-31,2893,2900,5793
3056,NYMT,0.0,0.0,1688801152,2020-12-31,2893,2900,5793
3057,NYMTN,0.0,0.0,1307202176,2020-12-31,2893,2900,5793
3058,NYMTO,0.0,0.0,1295048576,2020-12-31,2893,2900,5793
3059,NYMTP,0.0,0.0,1297944448,2020-12-31,2893,2900,5793
3060,OBNK,0.0,0.0,986703936,2020-12-31,2893,2900,5793
3061,OCFC,0.0,0.0,1418776704,2020-12-31,2893,2900,5793
3062,OFED,0.0,0.0,142361856,2020-06-30,2893,2900,5793
3063,ONB,0.0,0.0,3190896128,2020-12-31,2893,2900,5793
3064,OPBK,0.0,0.0,151809808,2020-12-31,2893,2900,5793
3065,OPHC,0.0,0.0,12720746,2020-12-31,2893,2900,5793
3066,OPOF,0.0,0.0,111257496,2020-12-31,2893,2900,5793
3067,OPRT,0.0,0.0,586193344,2020-12-31,2893,2900,5793
3068,ORRF,0.0,0.0,253515504,2020-12-31,2893,2900,5793
3069,OSBC,0.0,0.0,387550464,2020-12-31,2893,2900,5793
3070,OSTR,0.0,0.0,277724096,2020-12-31,2893,2900,5793
3071,OVBC,0.0,0.0,109452992,2020-12-31,2893,2900,5793
3072,OVLY,0.0,0.0,137137536,2020-12-31,2893,2900,5793
3073,OZK,0.0,0.0,5145980928,2020-12-31,2893,2900,5793
3074,PACW,0.0,0.0,4673132544,2020-12-31,2893,2900,5793
3075,PBCT,0.0,0.0,7670468608,2020-12-31,2893,2900,5793
3076,PBCTP,0.0,0.0,6753138176,2020-12-31,2893,2900,5793
3077,PBFS,0.0,0.0,297333952,2020-06-30,2893,2900,5793
3078,PBHC,0.0,0.0,63113228,2020-12-31,2893,2900,5793
3079,PBIP,0.0,0.0,111007928,2020-09-30,2893,2900,5793
3080,PCB,0.0,0.0,227964416,2020-12-31,2893,2900,5793
3081,PCSB,0.0,0.0,268321296,2020-06-30,2893,2900,5793
3082,PDLB,0.0,0.0,191181760,2020-12-31,2893,2900,5793
3083,PEBK,0.0,0.0,133265280,2020-12-31,2893,2900,5793
3084,PEBO,0.0,0.0,652273408,2020-12-31,2893,2900,5793
3085,PFBC,0.0,0.0,992828672,2020-12-31,2893,2900,5793
3086,PFBI,0.0,0.0,276026784,2020-12-31,2893,2900,5793
3087,PFC,0.0,0.0,1214007808,2020-12-31,2893,2900,5793
3088,PFHD,0.0,0.0,243290720,2020-12-31,2893,2900,5793
3089,PFIS,0.0,0.0,291764928,2020-12-31,2893,2900,5793
3090,PGC,0.0,0.0,606418048,2020-12-31,2893,2900,5793
3091,PGRW,0.0,0.0,171560272,2020-12-31,2893,2900,5793
3092,PKBK,0.0,0.0,234507904,2020-12-31,2893,2900,5793
3093,PLBC,0.0,0.0,151741104,2020-12-31,2893,2900,5793
3094,PMBC,0.0,0.0,212655392,2020-12-31,2893,2900,5793
3095,PNBK,0.0,0.0,40277384,2020-12-31,2893,2900,5793
3096,PNFP,0.0,0.0,6884683776,2020-12-31,2893,2900,5793
3097,PPBI,0.0,0.0,4092255744,2020-12-31,2893,2900,5793
3098,PROV,0.0,0.0,126518248,2020-06-30,2893,2900,5793
3099,PRSR,0.0,0.0,400562496,2020-12-31,2893,2900,5793
3100,PSAC,0.0,0.0,442452320,2020-12-31,2893,2900,5793
3101,PTRS,0.0,0.0,133304032,2020-12-31,2893,2900,5793
3102,PVBC,0.0,0.0,282368288,2020-12-31,2893,2900,5793
3103,PWOD,0.0,0.0,170984080,2020-12-31,2893,2900,5793
3104,QCRH,0.0,0.0,760962176,2020-12-31,2893,2900,5793
3105,RAAC,0.0,0.0,394449664,2020-12-31,2893,2900,5793
3106,RACA,0.0,0.0,184055856,2020-12-31,2893,2900,5793
3107,RACB,0.0,0.0,207214208,2020-12-31,2893,2900,5793
3108,RBB,0.0,0.0,393082432,2020-12-31,2893,2900,5793
3109,RBCAA,0.0,0.0,948903808,2020-12-31,2893,2900,5793
3110,RBKB,0.0,0.0,150990896,2020-12-31,2893,2900,5793
3111,RBNC,0.0,0.0,467055136,2020-12-31,2893,2900,5793
3112,RCHG,0.0,0.0,250500000,2020-12-31,2893,2900,5793
3113,RCLF,0.0,0.0,308660000,2020-12-31,2893,2900,5793
3114,RILY,0.0,0.0,1669805440,2020-12-31,2893,2900,5793
3115,RIVE,0.0,0.0,96458144,2020-12-31,2893,2900,5793
3116,RMBI,0.0,0.0,181554704,2020-12-31,2893,2900,5793
3117,RNDB,0.0,0.0,106941112,2020-12-31,2893,2900,5793
3118,RNST,0.0,0.0,2360346624,2020-12-31,2893,2900,5793
3119,ROCC,0.0,0.0,147525488,2020-12-31,2893,2900,5793
3120,RRBI,0.0,0.0,406135552,2020-12-31,2893,2900,5793
3121,RVSB,0.0,0.0,154405328,2020-03-31,2893,2900,5793
3122,SAII,0.0,0.0,219290624,2020-12-31,2893,2900,5793
3123,SAL,0.0,0.0,123308800,2020-12-31,2893,2900,5793
3124,SASR,0.0,0.0,2060542464,2020-12-31,2893,2900,5793
3125,SBCF,0.0,0.0,2018278784,2020-12-31,2893,2900,5793
3126,SBFG,0.0,0.0,131165936,2020-12-31,2893,2900,5793
3127,SBNY,0.0,0.0,13153459200,2020-12-31,2893,2900,5793
3128,SBSI,0.0,0.0,1268160896,2020-12-31,2893,2900,5793
3129,SBT,0.0,0.0,267524064,2020-12-31,2893,2900,5793
3130,SDAC,0.0,0.0,389382336,2020-12-31,2893,2900,5793
3131,SFBC,0.0,0.0,107653320,2020-12-31,2893,2900,5793
3132,SFBS,0.0,0.0,3306530816,2020-12-31,2893,2900,5793
3133,SFNC,0.0,0.0,3218830848,2020-12-31,2893,2900,5793
3134,SFST,0.0,0.0,377925440,2020-12-31,2893,2900,5793
3135,SGAM,0.0,0.0,178609872,2020-12-31,2893,2900,5793
3136,SHBI,0.0,0.0,199899824,2020-12-31,2893,2900,5793
3137,SIEB,0.0,0.0,131390272,2020-12-31,2893,2900,5793
3138,SIVB,0.0,0.0,26863613952,2020-12-31,2893,2900,5793
3139,SLCR,0.0,0.0,421762496,2020-12-31,2893,2900,5793
3140,SLCT,0.0,0.0,196155680,2020-12-31,2893,2900,5793
3141,SLM,0.0,0.0,6398375936,2020-12-31,2893,2900,5793
3142,SLMBP,0.0,0.0,3721167872,2020-12-31,2893,2900,5793
3143,SMBC,0.0,0.0,361037920,2020-06-30,2893,2900,5793
3144,SMBK,0.0,0.0,326894176,2020-12-31,2893,2900,5793
3145,SMMF,0.0,0.0,338045056,2020-12-31,2893,2900,5793
3146,SNEX,0.0,0.0,1301068544,2020-09-30,2893,2900,5793
3147,SPFI,0.0,0.0,407280192,2020-12-31,2893,2900,5793
3148,SRCE,0.0,0.0,1232891648,2020-12-31,2893,2900,5793
3149,SRSA,0.0,0.0,256000000,2020-12-31,2893,2900,5793
3150,SSB,0.0,0.0,5672671744,2020-12-31,2893,2900,5793
3151,SSBI,0.0,0.0,101240928,2020-12-31,2893,2900,5793
3152,SSPK,0.0,0.0,594348416,2020-12-31,2893,2900,5793
3153,STBA,0.0,0.0,1308123904,2020-12-31,2893,2900,5793
3154,STND,0.0,0.0,156396224,2020-12-31,2893,2900,5793
3155,STXB,0.0,0.0,388629792,2020-12-31,2893,2900,5793
3156,SV,0.0,0.0,288075008,2020-12-31,2893,2900,5793
3157,SVBI,0.0,0.0,155877776,2020-12-31,2893,2900,5793
3158,SWET,0.0,0.0,338100000,2020-12-31,2893,2900,5793
3159,SWKH,0.0,0.0,209796992,2020-12-31,2893,2900,5793
3160,SYBT,0.0,0.0,1165708800,2020-12-31,2893,2900,5793
3161,TBBK,0.0,0.0,1263142144,2020-12-31,2893,2900,5793
3162,TBK,0.0,0.0,2334513664,2020-12-31,2893,2900,5793
3163,TBNK,0.0,0.0,253449488,2020-12-31,2893,2900,5793
3164,TCAC,0.0,0.0,242552320,2020-12-31,2893,2900,5793
3165,TCBI,0.0,0.0,3358582272,2020-12-31,2893,2900,5793
3166,TCBIL,0.0,0.0,2944381952,2020-12-31,2893,2900,5793
3167,TCBIP,0.0,0.0,2953335808,2020-12-31,2893,2900,5793
3168,TCBK,0.0,0.0,1420063616,2020-12-31,2893,2900,5793
3169,TCF,0.0,0.0,7343351808,2020-12-31,2893,2900,5793
3170,TCFC,0.0,0.0,209909920,2020-12-31,2893,2900,5793
3171,TECTP,0.0,0.0,38895936,2020-12-31,2893,2900,5793
3172,TFSL,0.0,0.0,5737841152,2020-09-30,2893,2900,5793
3173,THFF,0.0,0.0,604932992,2020-12-31,2893,2900,5793
3174,TIGR,0.0,0.0,2814140160,2020-12-31,2893,2900,5793
3175,TMTS,0.0,0.0,249250000,2020-12-31,2893,2900,5793
3176,TOWN,0.0,0.0,2245250048,2020-12-31,2893,2900,5793
3177,TRMK,0.0,0.0,2138668928,2020-12-31,2893,2900,5793
3178,TRMT,0.0,0.0,47343684,2020-12-31,2893,2900,5793
3179,TRST,0.0,0.0,726204544,2020-12-31,2893,2900,5793
3180,TSBK,0.0,0.0,227452128,2020-09-30,2893,2900,5793
3181,TSC,0.0,0.0,788227456,2020-12-31,2893,2900,5793
3182,TSCAP,0.0,0.0,567989120,2020-12-31,2893,2900,5793
3183,TSCBP,0.0,0.0,635785216,2020-12-31,2893,2900,5793
3184,TSIA,0.0,0.0,398249984,2020-12-31,2893,2900,5793
3185,TW,0.0,0.0,18285844480,2020-12-31,2893,2900,5793
3186,UBCP,0.0,0.0,84503096,2020-12-31,2893,2900,5793
3187,UBFO,0.0,0.0,133020552,2020-12-31,2893,2900,5793
3188,UBOH,0.0,0.0,89084728,2020-12-31,2893,2900,5793
3189,UBSI,0.0,0.0,5026275840,2020-12-31,2893,2900,5793
3190,UCBI,0.0,0.0,2952939520,2020-12-31,2893,2900,5793
3191,UMBF,0.0,0.0,4477070336,2020-12-31,2893,2900,5793
3192,UMPQ,0.0,0.0,3940948736,2020-12-31,2893,2900,5793
3193,UNB,0.0,0.0,137776912,2020-12-31,2893,2900,5793
3194,UNTY,0.0,0.0,218957888,2020-12-31,2893,2900,5793
3195,UVSP,0.0,0.0,826169984,2020-12-31,2893,2900,5793
3196,VABK,0.0,0.0,91598032,2020-12-31,2893,2900,5793
3197,VACQ,0.0,0.0,444000000,2020-12-31,2893,2900,5793
3198,VBFC,0.0,0.0,64377852,2020-12-31,2893,2900,5793
3199,VBTX,0.0,0.0,1689534336,2020-12-31,2893,2900,5793
3200,VCKA,0.0,0.0,170947504,2020-12-31,2893,2900,5793
3201,VIH,0.0,0.0,369381376,2020-12-31,2893,2900,5793
3202,VIRT,0.0,0.0,5954220032,2020-12-31,2893,2900,5793
3203,VLY,0.0,0.0,5597445632,2020-12-31,2893,2900,5793
3204,VLYPO,0.0,0.0,3449646592,2020-12-31,2893,2900,5793
3205,VLYPP,0.0,0.0,3455500800,2020-12-31,2893,2900,5793
3206,VSPR,0.0,0.0,609500032,2020-12-31,2893,2900,5793
3207,WABC,0.0,0.0,1715903360,2020-12-31,2893,2900,5793
3208,WAFD,0.0,0.0,2359463680,2020-09-30,2893,2900,5793
3209,WASH,0.0,0.0,901926656,2020-12-31,2893,2900,5793
3210,WMPN,0.0,0.0,70784536,2020-06-30,2893,2900,5793
3211,WNEB,0.0,0.0,203088944,2020-12-31,2893,2900,5793
3212,WSBC,0.0,0.0,2444290048,2020-12-31,2893,2900,5793
3213,WSBF,0.0,0.0,523701984,2020-12-31,2893,2900,5793
3214,WSFS,0.0,0.0,2407457024,2020-12-31,2893,2900,5793
3215,WTBA,0.0,0.0,409756160,2020-12-31,2893,2900,5793
3216,WTFC,0.0,0.0,4365830656,2020-12-31,2893,2900,5793
3217,WTFCM,0.0,0.0,3964420096,2020-12-31,2893,2900,5793
3218,WVFC,0.0,0.0,30481094,2020-06-30,2893,2900,5793
3219,ZION,0.0,0.0,9152868352,2020-12-31,2893,2900,5793
3220,AAC,0.0,0.0,1234518528,2020-12-31,2893,2900,5793
3221,AAIC,0.0,0.0,132949112,2020-12-31,2893,2900,5793
3222,ABR,0.0,0.0,2129681792,2020-12-31,2893,2900,5793
3223,ACR,0.0,0.0,145214448,2020-12-31,2893,2900,5793
3224,ACRE,0.0,0.0,562236672,2020-12-31,2893,2900,5793
3225,ADRA,0.0,0.0,139868736,2020-12-31,2893,2900,5793
3226,AGAC,0.0,0.0,499904992,2020-12-31,2893,2900,5793
3227,AGCB,0.0,0.0,634291008,2020-12-31,2893,2900,5793
3228,AGM,0.0,0.0,1053822848,2020-12-31,2893,2900,5793
3229,AIW,0.0,0.0,264734720,2020-12-31,2893,2900,5793
3230,AJAX,0.0,0.0,914111552,2020-12-31,2893,2900,5793
3231,AJX,0.0,0.0,262182400,2020-12-31,2893,2900,5793
3232,ALLY,0.0,0.0,17599727616,2020-12-31,2893,2900,5793
3233,APGB,0.0,0.0,849562560,2020-12-31,2893,2900,5793
3234,APO,0.0,0.0,10921447424,2020-12-31,2893,2900,5793
3235,ARI,0.0,0.0,2025013376,2020-12-31,2893,2900,5793
3236,ARR,0.0,0.0,821014912,2020-12-31,2893,2900,5793
3237,ASAQ,0.0,0.0,311874976,2020-12-31,2893,2900,5793
3238,ASB,0.0,0.0,3330694144,2020-12-31,2893,2900,5793
3239,ASPL,0.0,0.0,302979488,2020-12-31,2893,2900,5793
3240,ATA,0.0,0.0,144130000,2020-12-31,2893,2900,5793
3241,ATMR,0.0,0.0,425643744,2020-12-31,2893,2900,5793
3242,AVAL,0.0,0.0,7018515456,2020-12-31,2893,2900,5793
3243,AVAN,0.0,0.0,751500032,2020-12-31,2893,2900,5793
3244,AX,0.0,0.0,2867011584,2020-06-30,2893,2900,5793
3245,AXP,0.0,0.0,118729555968,2020-12-31,2893,2900,5793
3246,BAC,0.0,0.0,345003753472,2020-12-31,2893,2900,5793
3247,BANC,0.0,0.0,939457280,2020-12-31,2893,2900,5793
3248,BAP,0.0,0.0,11964225536,2020-12-31,2893,2900,5793
3249,BBAR,0.0,0.0,551393984,2020-12-31,2893,2900,5793
3250,BBD,0.0,0.0,37032673280,2020-12-31,2893,2900,5793
3251,BBDO,0.0,0.0,36080484352,2020-12-31,2893,2900,5793
3252,BBVA,0.0,0.0,35053301760,2020-12-31,2893,2900,5793
3253,BCH,0.0,0.0,11830097920,2020-12-31,2893,2900,5793
3254,BCS,0.0,0.0,43805802496,2020-12-31,2893,2900,5793
3255,BHB,0.0,0.0,457170624,2020-12-31,2893,2900,5793
3256,BHLB,0.0,0.0,1147790592,2020-12-31,2893,2900,5793
3257,BITE,0.0,0.0,226356544,2020-12-31,2893,2900,5793
3258,BK,0.0,0.0,42637357056,2020-12-31,2893,2900,5793
3259,BKU,0.0,0.0,4125862912,2020-12-31,2893,2900,5793
3260,BLX,0.0,0.0,590010368,2020-12-31,2893,2900,5793
3261,BMA,0.0,0.0,1377768704,2020-12-31,2893,2900,5793
3262,BMO,0.0,0.0,59057385472,2020-10-31,2893,2900,5793
3263,BNS,0.0,0.0,75486871552,2020-10-31,2893,2900,5793
3264,BOH,0.0,0.0,3660728064,2020-12-31,2893,2900,5793
3265,BRBS,0.0,0.0,278026560,2020-12-31,2893,2900,5793
3266,BRMK,0.0,0.0,1413089536,2020-12-31,2893,2900,5793
3267,BSAC,0.0,0.0,11713329152,2020-12-31,2893,2900,5793
3268,BSBR,0.0,0.0,24872534016,2020-12-31,2893,2900,5793
3269,BSMX,0.0,0.0,7674361344,2020-12-31,2893,2900,5793
3270,BX,0.0,0.0,54131752960,2020-12-31,2893,2900,5793
3271,BXMT,0.0,0.0,4680283136,2020-12-31,2893,2900,5793
3272,BXS,0.0,0.0,3311359744,2020-12-31,2893,2900,5793
3273,BY,0.0,0.0,841996224,2020-12-31,2893,2900,5793
3274,C,0.0,0.0,151118086144,2020-12-31,2893,2900,5793
3275,CADE,0.0,0.0,2673357824,2020-12-31,2893,2900,5793
3276,CAP,0.0,0.0,430387488,2020-12-31,2893,2900,5793
3277,CBU,0.0,0.0,4227616000,2020-12-31,2893,2900,5793
3278,CCIV,0.0,0.0,5943487488,2020-12-31,2893,2900,5793
3279,CCV,0.0,0.0,632499968,2020-12-31,2893,2900,5793
3280,CCVI,0.0,0.0,693449984,2020-12-31,2893,2900,5793
3281,CFG,0.0,0.0,19287058432,2020-12-31,2893,2900,5793
3282,CFR,0.0,0.0,6998904320,2020-12-31,2893,2900,5793
3283,CHFW,0.0,0.0,119858640,2020-12-31,2893,2900,5793
3284,CHMI,0.0,0.0,163240064,2020-12-31,2893,2900,5793
3285,CIB,0.0,0.0,7992791040,2020-12-31,2893,2900,5793
3286,CIM,0.0,0.0,2971905792,2020-12-31,2893,2900,5793
3287,CIT,0.0,0.0,5163410432,2020-12-31,2893,2900,5793
3288,CLII,0.0,0.0,394737472,2020-12-31,2893,2900,5793
3289,CM,0.0,0.0,44130168832,2020-10-31,2893,2900,5793
3290,CMA,0.0,0.0,9972211712,2020-12-31,2893,2900,5793
3291,CMO,0.0,0.0,613047232,2020-12-31,2893,2900,5793
3292,CNF,0.0,0.0,264727280,2020-12-31,2893,2900,5793
3293,COF,0.0,0.0,61266046976,2020-12-31,2893,2900,5793
3294,COHN,0.0,0.0,42627996,2020-12-31,2893,2900,5793
3295,CPF,0.0,0.0,773723840,2020-12-31,2893,2900,5793
3296,CPSR,0.0,0.0,344309984,2020-12-31,2893,2900,5793
3297,CRHC,0.0,0.0,1043280000,2020-12-31,2893,2900,5793
3298,CS,0.0,0.0,25253916672,2020-12-31,2893,2900,5793
3299,CUBI,0.0,0.0,1027097984,2020-12-31,2893,2900,5793
3300,CVII,0.0,0.0,1704300032,2020-12-31,2893,2900,5793
3301,DB,0.0,0.0,25263515648,2020-12-31,2893,2900,5793
3302,DFS,0.0,0.0,30689640448,2020-12-31,2893,2900,5793
3303,DGNR,0.0,0.0,881475008,2020-12-31,2893,2900,5793
3304,DX,0.0,0.0,584629632,2020-12-31,2893,2900,5793
3305,EARN,0.0,0.0,151578176,2020-12-31,2893,2900,5793
3306,EFC,0.0,0.0,769244480,2020-12-31,2893,2900,5793
3307,EMPW,0.0,0.0,311250016,2020-12-31,2893,2900,5793
3308,ENVA,0.0,0.0,1259623936,2020-12-31,2893,2900,5793
3309,EPWR,0.0,0.0,339480000,2020-12-31,2893,2900,5793
3310,EQD,0.0,0.0,514912480,2020-12-31,2893,2900,5793
3311,EQHA,0.0,0.0,269224032,2020-12-31,2893,2900,5793
3312,EVBN,0.0,0.0,186105776,2020-12-31,2893,2900,5793
3313,EVR,0.0,0.0,5532774912,2020-12-31,2893,2900,5793
3314,FBC,0.0,0.0,2361604096,2020-12-31,2893,2900,5793
3315,FBK,0.0,0.0,2056410368,2020-12-31,2893,2900,5793
3316,FBP,0.0,0.0,2525164800,2020-12-31,2893,2900,5793
3317,FCF,0.0,0.0,1391284736,2020-12-31,2893,2900,5793
3318,FHN,0.0,0.0,9600654336,2020-12-31,2893,2900,5793
3319,FNB,0.0,0.0,4131670272,2020-12-31,2893,2900,5793
3320,FRC,0.0,0.0,29933058048,2020-12-31,2893,2900,5793
3321,FRX,0.0,0.0,376875008,2020-12-31,2893,2900,5793
3322,FUSE,0.0,0.0,444062496,2020-12-31,2893,2900,5793
3323,GDOT,0.0,0.0,2535094016,2020-12-31,2893,2900,5793
3324,GFX,0.0,0.0,425212480,2020-12-31,2893,2900,5793
3325,GHL,0.0,0.0,322725184,2020-12-31,2893,2900,5793
3326,GNPK,0.0,0.0,216389040,2020-12-31,2893,2900,5793
3327,GPMT,0.0,0.0,688846272,2020-12-31,2893,2900,5793
3328,GS,0.0,0.0,112546856960,2020-12-31,2893,2900,5793
3329,GWB,0.0,0.0,1756205952,2020-09-30,2893,2900,5793
3330,HASI,0.0,0.0,4201820160,2020-12-31,2893,2900,5793
3331,HDB,0.0,0.0,105419268096,2020-03-31,2893,2900,5793
3332,HLI,0.0,0.0,4541815808,2020-03-31,2893,2900,5793
3333,HSBC,0.0,0.0,121893322752,2020-12-31,2893,2900,5793
3334,HTH,0.0,0.0,2708932864,2020-12-31,2893,2900,5793
3335,HTPA,0.0,0.0,376875008,2020-12-31,2893,2900,5793
3336,IBN,0.0,0.0,53403525120,2020-03-31,2893,2900,5793
3337,IFS,0.0,0.0,3512894208,2020-12-31,2893,2900,5793
3338,IMH,0.0,0.0,44148336,2020-12-31,2893,2900,5793
3339,IMPX,0.0,0.0,500500000,2020-12-31,2893,2900,5793
3340,ING,0.0,0.0,48269619200,2020-12-31,2893,2900,5793
3341,IPOD,0.0,0.0,661825024,2020-12-31,2893,2900,5793
3342,IPOE,0.0,0.0,1788106240,2020-12-31,2893,2900,5793
3343,IPOF,0.0,0.0,1575500032,2020-12-31,2893,2900,5793
3344,ITCB,0.0,0.0,1887355520,2020-12-31,2893,2900,5793
3345,ITUB,0.0,0.0,43811151872,2020-12-31,2893,2900,5793
3346,IVR,0.0,0.0,907232640,2020-12-31,2893,2900,5793
3347,JMP,0.0,0.0,133213240,2020-12-31,2893,2900,5793
3348,JPM,0.0,0.0,473858146304,2020-12-31,2893,2900,5793
3349,JWSM,0.0,0.0,1296337536,2020-12-31,2893,2900,5793
3350,KB,0.0,0.0,18555123712,2020-12-31,2893,2900,5793
3351,KEY,0.0,0.0,19786795008,2020-12-31,2893,2900,5793
3352,KKR,0.0,0.0,29597444096,2020-12-31,2893,2900,5793
3353,KREF,0.0,0.0,1056768576,2020-12-31,2893,2900,5793
3354,KWAC,0.0,0.0,145513952,2020-12-31,2893,2900,5793
3355,LADR,0.0,0.0,1473718144,2020-12-31,2893,2900,5793
3356,LAZ,0.0,0.0,4983982080,2020-12-31,2893,2900,5793
3357,LDI,0.0,0.0,6776249344,2020-12-31,2893,2900,5793
3358,LEAP,0.0,0.0,675147712,2020-12-31,2893,2900,5793
3359,LFT,0.0,0.0,90295104,2020-12-31,2893,2900,5793
3360,LNFA,0.0,0.0,172500000,2020-12-31,2893,2900,5793
3361,LYG,0.0,0.0,42143633408,2020-12-31,2893,2900,5793
3362,MC,0.0,0.0,3144667392,2020-12-31,2893,2900,5793
3363,MCB,0.0,0.0,453130784,2020-12-31,2893,2900,5793
3364,MDH,0.0,0.0,269100000,2020-12-31,2893,2900,5793
3365,MFA,0.0,0.0,1880565376,2020-12-31,2893,2900,5793
3366,MFG,0.0,0.0,36157194240,2020-03-31,2893,2900,5793
3367,MITT,0.0,0.0,167483456,2020-12-31,2893,2900,5793
3368,MS,0.0,0.0,150989996032,2020-12-31,2893,2900,5793
3369,MTB,0.0,0.0,19762042880,2020-12-31,2893,2900,5793
3370,MUFG,0.0,0.0,68684759040,2020-03-31,2893,2900,5793
3371,NBA,0.0,0.0,154521520,2020-12-31,2893,2900,5793
3372,NBHC,0.0,0.0,1223436800,2020-12-31,2893,2900,5793
3373,NGA,0.0,0.0,669786816,2020-12-31,2893,2900,5793
3374,NLY,0.0,0.0,12111009792,2020-12-31,2893,2900,5793
3375,NMR,0.0,0.0,16396249088,2020-03-31,2893,2900,5793
3376,NNI,0.0,0.0,2858940160,2020-12-31,2893,2900,5793
3377,NREF,0.0,0.0,100037424,2020-12-31,2893,2900,5793
3378,NRZ,0.0,0.0,4562766848,2020-12-31,2893,2900,5793
3379,NSH,0.0,0.0,287212480,2020-12-31,2893,2900,5793
3380,NSTB,0.0,0.0,501485024,2020-12-31,2893,2900,5793
3381,NTB,0.0,0.0,1871999872,2020-12-31,2893,2900,5793
3382,NWG,0.0,0.0,30770745344,2020-12-31,2893,2900,5793
3383,NYCB,0.0,0.0,5849237504,2020-12-31,2893,2900,5793
3384,OFG,0.0,0.0,1182936448,2020-12-31,2893,2900,5793
3385,OMF,0.0,0.0,7367644160,2020-12-31,2893,2900,5793
3386,OPY,0.0,0.0,541629760,2020-12-31,2893,2900,5793
3387,ORC,0.0,0.0,568758080,2020-12-31,2893,2900,5793
3388,PB,0.0,0.0,7015285248,2020-12-31,2893,2900,5793
3389,PDAC,0.0,0.0,398460768,2020-12-31,2893,2900,5793
3390,PFS,0.0,0.0,1784580352,2020-12-31,2893,2900,5793
3391,PFSI,0.0,0.0,4063243520,2020-12-31,2893,2900,5793
3392,PIPR,0.0,0.0,2101383808,2020-12-31,2893,2900,5793
3393,PJT,0.0,0.0,2807844608,2020-12-31,2893,2900,5793
3394,PMT,0.0,0.0,1986447872,2020-12-31,2893,2900,5793
3395,PNC,0.0,0.0,76412649472,2020-12-31,2893,2900,5793
3396,PRK,0.0,0.0,2124343936,2020-12-31,2893,2900,5793
3397,PV,0.0,0.0,537500032,2020-12-31,2893,2900,5793
3398,QFTA,0.0,0.0,247537008,2020-12-31,2893,2900,5793
3399,RC,0.0,0.0,978960192,2020-12-31,2893,2900,5793
3400,RF,0.0,0.0,20395108352,2020-12-31,2893,2900,5793
3401,RJF,0.0,0.0,17493428224,2020-09-30,2893,2900,5793
3402,ROT,0.0,0.0,343275008,2020-12-31,2893,2900,5793
3403,RWT,0.0,0.0,1171633664,2020-12-31,2893,2900,5793
3404,RY,0.0,0.0,132780859392,2020-10-31,2893,2900,5793
3405,SACH,0.0,0.0,120687896,2020-12-31,2893,2900,5793
3406,SAN,0.0,0.0,59196792832,2020-12-31,2893,2900,5793
3407,SC,0.0,0.0,8883631104,2020-12-31,2893,2900,5793
3408,SCHW,0.0,0.0,127382290432,2020-12-31,2893,2900,5793
3409,SEAH,0.0,0.0,559124992,2020-12-31,2893,2900,5793
3410,SF,0.0,0.0,7043755008,2020-12-31,2893,2900,5793
3411,SHG,0.0,0.0,17139277824,2020-12-31,2893,2900,5793
3412,SI,0.0,0.0,3834155520,2020-12-31,2893,2900,5793
3413,SMFG,0.0,0.0,48668762112,2020-03-31,2893,2900,5793
3414,SNV,0.0,0.0,6833164800,2020-12-31,2893,2900,5793
3415,SPFR,0.0,0.0,461437504,2020-12-31,2893,2900,5793
3416,STL,0.0,0.0,4484425728,2020-12-31,2893,2900,5793
3417,STT,0.0,0.0,30135918592,2020-12-31,2893,2900,5793
3418,STWD,0.0,0.0,7098849792,2020-12-31,2893,2900,5793
3419,SUPV,0.0,0.0,254100000,2020-12-31,2893,2900,5793
3420,SYF,0.0,0.0,24889655296,2020-12-31,2893,2900,5793
3421,TD,0.0,0.0,119967662080,2020-10-31,2893,2900,5793
3422,TFC,0.0,0.0,80693895168,2020-12-31,2893,2900,5793
3423,TINV,0.0,0.0,350174976,2020-12-31,2893,2900,5793
3424,TMP,0.0,0.0,1203715968,2020-12-31,2893,2900,5793
3425,TREB,0.0,0.0,658518784,2020-12-31,2893,2900,5793
3426,TRTX,0.0,0.0,872763968,2020-12-31,2893,2900,5793
3427,TWO,0.0,0.0,2028257792,2020-12-31,2893,2900,5793
3428,UBS,0.0,0.0,54420824064,2020-12-31,2893,2900,5793
3429,USB,0.0,0.0,86082232320,2020-12-31,2893,2900,5793
3430,VEL,0.0,0.0,183050736,2020-12-31,2893,2900,5793
3431,VGAC,0.0,0.0,639502144,2020-12-31,2893,2900,5793
3432,WAL,0.0,0.0,9412130816,2020-12-31,2893,2900,5793
3433,WBK,0.0,0.0,69253029888,2020-09-30,2893,2900,5793
3434,WBS,0.0,0.0,5102880256,2020-12-31,2893,2900,5793
3435,WD,0.0,0.0,3298545408,2020-12-31,2893,2900,5793
3436,WF,0.0,0.0,6512918016,2020-12-31,2893,2900,5793
3437,WFC,0.0,0.0,167432667136,2020-12-31,2893,2900,5793
3438,WMC,0.0,0.0,193384384,2020-12-31,2893,2900,5793
3439,WPF,0.0,0.0,1295043840,2020-12-31,2893,2900,5793
3440,XPOA,0.0,0.0,375375008,2020-12-31,2893,2900,5793
3441,NOAH,0.2796805380636137,-2.2388668289142224,2639840000,2020-12-31,398,5707,6105
3442,DRD,0.22831097262637448,-8.025367765691268,858725312,2020-06-30,565,5719,6284
3443,IBA,0.13522832737760251,-0.5536293969074589,2062701312,2020-12-31,1060,5644,6704
3444,IMAB,0.12041049630920196,-0.3334113614933208,3716052224,2020-12-31,1173,5553,6726
3445,DOYU,0.10535636535997558,-2.8702144072428575,3305754368,2020-12-31,1288,5711,6999
3446,CFIV,-0.00010519580322135008,-8.420496000485836e-05,625475008,2020-12-31,3576,3604,7180
3447,MNTK,-0.00032703108103394147,-4.8331416737040217e-05,1486972672,2020-12-31,3581,3600,7181
3448,VTAQ,-0.00012007534147348481,-8.48951803060004e-05,215409376,2020-12-31,3577,3605,7182
3449,ETAC,-0.0002424193738408688,-0.0001936459429711653,752094016,2020-12-31,3578,3617,7195
3450,DWIN,-0.0002844291808424718,-0.0002273186244115517,253761792,2020-12-31,3579,3622,7201
3451,FTCV,-0.0004222907042659786,-0.0002140756999284559,495023392,2020-12-31,3583,3620,7203
3452,MOTV,-0.0003376554978192853,-0.00027013852500055205,519569984,2020-12-31,3582,3625,7207
3453,PRTY,-0.0004635710422622267,-0.0002724352204774619,665505344,2020-12-31,3584,3626,7210
3454,LCY,-0.00046573476413980854,-0.0003642967077997354,640214976,2020-12-31,3585,3635,7220
3455,SHEN,-0.0006707790628041021,-0.0003315664344014212,2446672896,2020-12-31,3593,3632,7225
3456,DAKT,-0.0006110009439415781,-0.000425529061046022,286885632,2020-05-02,3588,3640,7228
3457,JYAC,-0.0006487665036106595,-0.0004892553579840139,139749952,2020-12-31,3589,3644,7233
3458,PCPC,-0.0005555695109163702,-0.0005260907308352202,438615552,2020-12-31,3586,3650,7236
3459,CONX,-0.0006495984303279474,-0.0005175162721694082,942388544,2020-12-31,3590,3647,7237
3460,CFAC,-0.0006658088255376546,-0.0005256595596720368,291914976,2020-12-31,3591,3649,7240
3461,GHVI,-0.0007731851805651465,-0.00045478623541296787,588225024,2020-12-31,3597,3643,7240
3462,CFV,-0.002087951647435533,-1.750399866301218e-06,314678016,2020-12-31,3657,3583,7240
3463,ALTG,-0.000725268349289237,-0.0005205937560867822,392341792,2020-12-31,3596,3648,7244
3464,APSG,-0.0007123118441446059,-0.0005718764551630791,1017947008,2020-12-31,3595,3653,7248
3465,CMLF,-0.0009310209156933751,-0.000497359996999076,830155520,2020-12-31,3605,3646,7251
3466,TIPT,-0.0007003337991250766,-0.0006342203326789508,326686528,2020-12-31,3594,3660,7254
3467,PRPB,-0.0008008185442933249,-0.0006091487380200271,1089340032,2020-12-31,3598,3659,7257
3468,AYX,-0.0015443759044965067,-0.00029403447137409594,5731845120,2020-12-31,3633,3628,7261
3469,SNRH,-0.0008335947600649645,-0.0006721423962381015,514912480,2020-12-31,3600,3662,7262
3470,ARL,-0.0006030911183471128,-0.0007998510680569327,147629280,2020-12-31,3587,3678,7265
3471,BHSE,-0.0009027344939915915,-0.0007385038807121651,93562496,2020-12-31,3601,3669,7270
3472,TCI,-0.0006699145889516755,-0.0008322931241559681,185745376,2020-12-31,3592,3681,7273
3473,ACND,-0.0009207841781930646,-0.0007407971241792932,515947520,2020-12-31,3603,3670,7273
3474,SVAC,-0.0009250899607112791,-0.00074572470722646,504282400,2020-12-31,3604,3671,7275
3475,TWCT,-0.000944471934955377,-0.000758158365781916,749249984,2020-12-31,3606,3673,7279
3476,GOAC,-0.0009462310540424694,-0.0007595404683752997,718031232,2020-12-31,3607,3674,7281
3477,GE,-0.0009546829128313798,-0.0007681404017382783,119471243264,2020-12-31,3608,3676,7284
3478,SHIP,-0.0009185852416256217,-0.0009343558663616743,149325616,2020-12-31,3602,3685,7287
3479,BOWX,-0.0012123842699573986,-0.000748260399667827,784271232,2020-12-31,3617,3672,7289
3480,HCAR,-0.0009756820428140419,-0.000806471729585173,401994016,2020-12-31,3610,3680,7290
3481,PSTH,-0.0010612457445805953,-0.0008417871936033613,5072000000,2020-12-31,3612,3683,7295
3482,HZON,-0.0011412613249978884,-0.0008872109914533457,676593792,2020-12-31,3614,3684,7298
3483,SQ,-0.003029746750852242,-0.00015358559190691414,118950010880,2020-12-31,3689,3611,7300
3484,BSN,-0.0012010768790432847,-0.0009675650388842075,380484128,2020-12-31,3615,3686,7301
3485,ZNGA,-0.0023514851485148514,-0.00029773652967793476,11512061952,2020-12-31,3672,3629,7301
3486,ROCR,-0.004104537302876965,-6.7090015906045025e-06,145316896,2020-12-31,3721,3584,7305
3487,HPX,-0.0012431188554665768,-0.0009934676494558192,317630272,2020-12-31,3618,3688,7306
3488,NOAC,-0.001290791157572864,-0.001057925054172358,282280480,2020-12-31,3619,3693,7312
3489,MTAC,-0.0012984025331325636,-0.0010541207968496292,310000000,2020-12-31,3620,3692,7312
3490,LOKB,-0.00130144309027534,-0.0010289795212888783,321942496,2020-12-31,3621,3691,7312
3491,BAND,-0.0032334866960522504,-0.00017100258670253122,3224040448,2020-12-31,3698,3614,7312
3492,GF,-0.0010156089796899102,-0.0011780068636496124,312952576,2020-12-31,3611,3706,7317
3493,MRAC,-0.0013648076234869743,-0.0011016065542755968,464852064,2020-12-31,3623,3696,7319
3494,ACIC,-0.0013778320032906098,-0.0010821366247557162,638124992,2020-12-31,3625,3694,7319
3495,FRPH,-0.001211814757985772,-0.0011829190036125154,450333728,2020-12-31,3616,3708,7324
3496,VNTR,-0.0010638297872340426,-0.0012307081573502715,492080640,2020-12-31,3613,3712,7325
3497,RMGB,-0.0014171861354305535,-0.001131275452544235,434268736,2020-12-31,3626,3699,7325
3498,VTIQ,-0.005072445070990775,-1.2458997511207942e-05,346724992,2020-12-31,3740,3586,7326
3499,PACE,-0.0014278492948831196,-0.0011368281359597626,565875520,2020-12-31,3627,3701,7328
3500,FMAC,-0.0014553886748208305,-0.0011547941762147535,523192480,2020-12-31,3629,3702,7331
3501,PTIC,-0.0014332055655456254,-0.0011773817542835487,282037504,2020-12-31,3628,3705,7333
3502,YAC,-0.001457092836663284,-0.0011639128358229044,432975008,2020-12-31,3630,3704,7334
3503,CND,-0.0013214283483850234,-0.0013004161075167609,281818880,2020-12-31,3622,3714,7336
3504,FCAC,-0.0015242992811377461,-0.0012235648220303092,430818752,2020-12-31,3631,3709,7340
3505,DEH,-0.001530396972745733,-0.0012306516615417072,430387488,2020-12-31,3632,3711,7343
3506,LPL,-0.000955232760930734,-0.0016290229585183328,8106015744,2020-12-31,3609,3735,7344
3507,FGNA,-0.0015646046297001749,-0.0012305297155208402,310576032,2020-12-31,3634,3710,7344
3508,NEBC,-0.0016631660448392818,-0.0013495087143470558,340656160,2020-12-31,3636,3717,7353
3509,BTAQ,-0.001720172494900603,-0.0013435922858978364,444968096,2020-12-31,3638,3716,7354
3510,HZAC,-0.0016952937540789966,-0.0013677046956452738,675220160,2020-12-31,3637,3720,7357
3511,BCTG,-0.0018624033735921022,-0.0012882287469189863,242631232,2020-12-31,3645,3713,7358
3512,UAA,-0.0030815871143990183,-0.0007120132236542249,9582075904,2020-12-31,3692,3667,7359
3513,CEVA,-0.00342138658081064,-0.000576550556326402,1316350848,2020-12-31,3705,3654,7359
3514,UA,-0.0030815871143990183,-0.0007123036875861308,9577801728,2020-12-31,3692,3668,7360
3515,GSAH,-0.0018303693377728684,-0.001367210003639839,1004062528,2020-12-31,3644,3719,7363
3516,VII,-0.001769300100515047,-0.0014352557860882098,285774976,2020-12-31,3642,3724,7366
3517,VCVC,-0.001770368525935526,-0.001425697657967585,253071376,2020-12-31,3643,3723,7366
3518,MTLS,-0.00444690878846687,-0.00041286110144645485,1879132928,2020-12-31,3731,3638,7369
3519,PRU,-0.00028458728225763756,-0.00245687380615588,37307498496,2020-12-31,3580,3793,7373
3520,HSAQ,-0.0019270323465782543,-0.0014456547310008876,215338496,2020-12-31,3648,3725,7373
3521,TREE,-0.004179828201240045,-0.0005433968434400466,2987367424,2020-12-31,3724,3652,7376
3522,ENPC,-0.001723768706179292,-0.0016866602534967605,424085856,2020-12-31,3639,3739,7378
3523,PAIC,-0.001963012384523326,-0.0016014562231244634,90827776,2020-12-31,3650,3731,7381
3524,TWND,-0.001984140335938542,-0.001591907194665662,419023296,2020-12-31,3651,3730,7381
3525,ESSC,-0.001984665724583347,-0.0015585744053565609,177389072,2020-06-30,3652,3729,7381
3526,IFN,-0.0016107720816608397,-0.001797153046805074,575758400,2020-12-31,3635,3750,7385
3527,CCAC,-0.002023088680384147,-0.0016096642383322318,350174976,2020-12-31,3654,3732,7386
3528,RMT,-0.001725463022196041,-0.0017758385248878151,515111712,2020-12-31,3640,3747,7387
3529,IGAC,-0.0020184136402113424,-0.0016234168240765272,374249984,2020-12-31,3653,3734,7387
3530,DUNE,-0.0017414516741109062,-0.001783487781132634,169050000,2020-12-31,3641,3748,7389
3531,COOL,-0.0020781307122744396,-0.0016834006689693184,496500000,2020-12-31,3656,3738,7394
3532,RNET,-0.0033666876107771517,-0.001084457737781768,187883024,2020-12-31,3703,3695,7398
3533,RSVA,-0.0028445650188371964,-0.0013403530223759811,497949984,2020-12-31,3684,3715,7399
3534,BRP,-0.005936799388785211,-0.00043096078948777456,2809264128,2020-12-31,3757,3642,7399
3535,LUXA,-0.00215635618455147,-0.0016593014681752266,449362496,2020-12-31,3663,3737,7400
3536,HQH,-0.0018674742069980331,-0.0018629202629027708,1057307968,2020-09-30,3646,3759,7405
3537,CHPM,-0.0021539666315211047,-0.0017384046595374074,375000000,2020-12-31,3662,3744,7406
3538,SPNV,-0.0021638752704713797,-0.0017252677373146362,506143776,2020-12-31,3664,3742,7406
3539,KINZ,-0.0021742450947519138,-0.0017697069657038812,343620000,2020-12-31,3665,3746,7411
3540,KW,-0.0021007768340235164,-0.0018271245597218698,2926082048,2020-12-31,3658,3755,7413
3541,PMVC,-0.0021972695439952073,-0.0017873419534126314,217300048,2020-12-31,3666,3749,7415
3542,PIAI,-0.0018917142815921034,-0.0020143571986591183,305883040,2020-12-31,3647,3769,7416
3543,VYGG,-0.0020767083523149745,-0.0019105961194055964,626061696,2020-12-31,3655,3763,7418
3544,MAAC,-0.002212700912969274,-0.0018030801139086027,505697056,2020-12-31,3667,3752,7419
3545,SHAC,-0.012572590946661084,-1.6703817597078577e-05,280312512,2020-12-31,3836,3588,7424
3546,ERES,-0.002287723843903319,-0.001858036450290466,428231264,2020-12-31,3669,3757,7426
3547,NGAC,-0.002303950034929424,-0.0018592686850712303,465939584,2020-12-31,3670,3758,7428
3548,CRU,-0.012728647789470986,-2.1198829263470205e-05,327642688,2020-12-31,3838,3591,7429
3549,MFIN,-0.0021511424618799314,-0.002015254694724519,190304000,2020-12-31,3660,3770,7430
3550,MFINL,-0.0021511424618799314,-0.0020729529299749585,151217248,2020-12-31,3660,3772,7432
3551,DDOG,-0.008479146581561226,-0.0004942711576299224,27216490496,2020-12-31,3787,3645,7432
3552,TAC,-0.0019528707199583388,-0.002226724832693753,2644350976,2020-12-31,3649,3785,7434
3553,EXPC,-0.002447863451036307,-0.0019002857521577207,357500000,2020-12-31,3676,3761,7437
3554,DBDR,-0.0023958822391120095,-0.0019721406099437147,288002752,2020-12-31,3674,3767,7441
3555,TACA,-0.002148071649870019,-0.0022018450686330793,228619984,2020-12-31,3659,3783,7442
3556,SNPR,-0.0025263265998059672,-0.0019324628339597476,452381248,2020-12-31,3679,3764,7443
3557,SVOK,-0.002455280850304798,-0.0019931169696567495,321173952,2020-12-31,3677,3768,7445
3558,SLAC,-0.014876724186413863,-1.4315731000073108e-05,424781280,2020-12-31,3860,3587,7447
3559,QELL,-0.0023573390453013863,-0.0020911106815983973,430145824,2020-12-31,3673,3776,7449
3560,FSRV,-0.00316687613794164,-0.0018437293214668613,432448256,2020-12-31,3695,3756,7451
3561,LBRDA,-0.0033073102450497625,-0.0018005358756955836,28949719040,2020-12-31,3700,3751,7451
3562,LORL,-0.005741078683414809,-0.0011235450795065336,1177611648,2020-12-31,3754,3697,7451
3563,LBRDK,-0.0033073102450497625,-0.0018085078869878107,28803672064,2020-12-31,3700,3753,7453
3564,OACB,-0.0025972915253831535,-0.00208909564347613,312185760,2020-12-31,3680,3774,7454
3565,TVAC,-0.002622709537717245,-0.00213561173333996,217134368,2020-12-31,3681,3779,7460
3566,HIGA,-0.0026567821592277468,-0.002128808133124141,455385952,2020-12-31,3682,3778,7460
3567,FRGI,-0.002310512938039085,-0.0024521917251827275,366639488,2021-01-03,3671,3792,7463
3568,IIAC,-0.0027857899989401215,-0.002234813149735157,502118720,2020-12-31,3683,3787,7470
3569,THCB,-0.003261495330346501,-0.0020565513383986305,447450720,2020-12-31,3699,3771,7470
3570,OLN,-0.004444948406848849,-0.001749403358487145,6360119808,2020-12-31,3729,3745,7474
3571,API,-0.009097611402692616,-0.0008023466633533385,6545552896,2020-12-31,3797,3679,7476
3572,DFPH,-0.002966614435719563,-0.0023650965535211496,289800000,2020-12-31,3688,3790,7478
3573,TDF,-0.002435118819323479,-0.002610414211853242,786283392,2020-12-31,3675,3804,7479
3574,FST,-0.003317190953735747,-0.002115260241646193,315000000,2020-12-31,3702,3777,7479
3575,PTON,-0.011678249971516463,-0.0005913807339702471,34927939584,2020-06-30,3826,3655,7481
3576,HLAH,-0.017291301259657617,-5.8756751469679185e-05,324381280,2020-12-31,3886,3601,7487
3577,BCAC,-0.018544102019128587,-4.237736791132275e-05,74047624,2020-12-31,3892,3596,7488
3578,MRVL,-0.01166143397193567,-0.0007105187889267042,33514717184,2021-01-30,3825,3666,7491
3579,MESA,-0.0022381537154450306,-0.002932454738012942,460965184,2020-09-30,3668,3824,7492
3580,RTP,-0.0031986682663970377,-0.002522238570011949,877162496,2020-12-31,3696,3796,7492
3581,EZGO,-0.006576820533757072,-0.0014882584574241963,76953352,2020-09-30,3767,3726,7493
3582,FSII,-0.0206951871657754,-1.1944791543865388e-05,259133536,2020-12-31,3908,3585,7493
3583,EOS,-0.002894048676260336,-0.002743667766588695,1125150080,2020-12-31,3685,3810,7495
3584,GRSV,-0.003211719152923077,-0.0025481556644455353,662812544,2020-12-31,3697,3798,7495
3585,ICLK,-0.006827075826262157,-0.0015353943532998803,1079206912,2020-12-31,3773,3727,7500
3586,CBAH,-0.002938541781652921,-0.0028004793111536795,424349312,2020-12-31,3686,3816,7502
3587,RICE,-0.004501922031575628,-0.0020898505586573034,513097216,2020-12-31,3732,3775,7507
3588,TLGA,-0.021666089056151878,-2.7326273717614152e-05,487000000,2020-12-31,3916,3592,7508
3589,BLSA,-0.0034884329412920106,-0.00258866222549109,195121136,2020-12-31,3707,3802,7509
3590,ASYS,-0.0056888134154107406,-0.0018855922794508548,174925408,2020-09-30,3752,3760,7512
3591,FEN,-0.0030346793981323155,-0.0028981968459249937,267765920,2020-11-30,3690,3823,7513
3592,L,-0.002455886319435572,-0.00334283142033966,14145534976,2020-12-31,3678,3836,7514
3593,PIPP,-0.0034143667681111787,-0.002781472483235125,269227392,2020-12-31,3704,3812,7516
3594,AONE,-0.0035380199084320044,-0.0026434488747558433,288906240,2020-12-31,3710,3806,7516
3595,GIL,-0.007344390013711456,-0.0017019710643219603,6607594496,2021-01-03,3776,3740,7516
3596,FIVN,-0.013962743034635154,-0.0007027640521095561,11575707648,2020-12-31,3853,3664,7517
3597,THCA,-0.0035452397382989636,-0.0027914348099870165,222073760,2020-12-31,3711,3814,7525
3598,ANGI,-0.012950064567297427,-0.0008407650822825416,7440803840,2020-12-31,3843,3682,7525
3599,OCA,-0.0035136421172749554,-0.0028255100193022844,258124992,2020-12-31,3708,3819,7527
3600,EGLE,-0.0031634649185647793,-0.003315886530419487,452295776,2020-12-31,3694,3834,7528
3601,DMYD,-0.005258788300661011,-0.0021460438804111436,677924992,2020-12-31,3748,3781,7529
3602,CLI,-0.0030581687336118132,-0.0033899817832611584,1439869184,2020-12-31,3691,3839,7530
3603,MOTN,-0.0035179849723335666,-0.0028674749279410626,142025008,2020-12-31,3709,3822,7531
3604,TZPS,-0.024009526980305784,-4.237421339052714e-05,353686496,2020-12-31,3936,3595,7531
3605,FLAC,-0.00369108291986061,-0.0028548206314160007,179995152,2020-12-31,3716,3820,7536
3606,NPA,-0.004843096247777601,-0.002578160261846252,435735456,2020-12-31,3737,3801,7538
3607,DFNS,-0.0036324464334131514,-0.002939266069438999,214762496,2020-12-31,3714,3826,7540
3608,STPC,-0.02511157605777222,-4.291778663080786e-05,524759392,2020-12-31,3945,3597,7542
3609,CVR,-0.0029433501362009446,-0.0037724930478543655,23051910,2020-12-31,3687,3858,7545
3610,ETWO,-0.009343902203174421,-0.0017355064538360583,2237944064,2020-12-31,3802,3743,7545
3611,HOL,-0.004007978735776275,-0.0029883729762065696,403500000,2020-12-31,3719,3828,7547
3612,JWS,-0.004587675232229807,-0.0028003487568464868,1133325056,2020-12-31,3733,3815,7548
3613,RBAC,-0.003959878308707343,-0.0031516736279904307,723781248,2020-12-31,3718,3831,7549
3614,CIA,-0.0013670310116029485,-0.006013974098247022,301342368,2020-12-31,3624,3928,7552
3615,EOG,-0.00433679607017912,-0.0029348761450231895,41888342016,2020-12-31,3727,3825,7552
3616,OEPW,-0.027035029281779983,-3.8387017227616046e-05,484934400,2020-12-31,3962,3593,7555
3617,CCX,-0.004161264185171883,-0.003366635967604761,865087488,2020-12-31,3722,3837,7559
3618,ROKU,-0.02195985141075212,-0.00042634719381928965,47986163712,2020-12-31,3918,3641,7559
3619,SBG,-0.004171020251603152,-0.003378928120160759,285343744,2020-12-31,3723,3838,7561
3620,NAAC,-0.027363299795048885,-4.294522354130122e-05,465354080,2020-12-31,3967,3598,7565
3621,RTPZ,-0.0043335901328407575,-0.0034476385895793236,290949984,2020-12-31,3726,3840,7566
3622,TNDM,-0.013368795279506445,-0.00139194011499619,5504258560,2020-12-31,3846,3722,7568
3623,PHIC,-0.004309699952153879,-0.0034916957044394486,214110672,2020-12-31,3725,3844,7569
3624,ZNTE,-0.003652379308639783,-0.0036818967947267055,232070000,2020-12-31,3715,3855,7570
3625,ZGYH,-0.0044460391145947145,-0.0034488622495818,89892224,2020-06-30,3730,3841,7571
3626,ARYA,-0.005122305766012321,-0.0031524890043110538,244244144,2020-12-31,3741,3832,7573
3627,SRDX,-0.01303192874628887,-0.001616066216725584,785994944,2020-09-30,3844,3733,7577
3628,IIF,-0.0035622437536922463,-0.0039643527916523565,259560720,2020-12-31,3712,3868,7580
3629,BSET,-0.00402889558418986,-0.003825535857763895,257055024,2020-11-28,3720,3860,7580
3630,STPK,-0.009057551514247655,-0.002341291130717684,1493103744,2020-12-31,3796,3789,7585
3631,KRNT,-0.015036569096934363,-0.001375090218097736,4929647104,2020-12-31,3864,3721,7585
3632,THBR,-0.004632509612395211,-0.0036179454094098723,447206240,2020-12-31,3734,3853,7587
3633,HEC,-0.004659603257838372,-0.003767519128331982,513877504,2020-12-31,3735,3857,7592
3634,OTRA,-0.004662242562558422,-0.0038502308521096667,130920344,2020-12-31,3736,3863,7599
3635,VTOL,-0.00380196983299037,-0.0046599897774418355,767422208,2020-03-31,3717,3890,7607
3636,MXC,-0.0064145105989119626,-0.003492006405996801,17329266,2020-03-31,3762,3845,7607
3637,BREZ,-0.005047106696951058,-0.004043704381792268,146396256,2020-12-31,3738,3871,7609
3638,MCMJ,-0.005058713485902131,-0.004022671823122703,164373872,2020-12-31,3739,3870,7609
3639,HQL,-0.004367704294440719,-0.0045280529799148666,466438912,2020-09-30,3728,3883,7611
3640,REV,-0.00973393900064893,-0.0027004998927757516,591521728,2020-12-31,3804,3808,7612
3641,CMCTP,-0.006456251348048027,-0.0035981573587740598,805843840,2020-12-31,3764,3852,7616
3642,PVH,-0.008626456002767846,-0.0030380497331821614,7864329216,2021-01-31,3788,3829,7617
3643,FVRR,-0.019936201360525204,-0.0013657520429324044,8123815936,2020-12-31,3904,3718,7622
3644,VCRA,-0.012132011912317532,-0.0024905250519330667,1226387200,2020-12-31,3832,3794,7626
3645,KSMT,-0.005525352852704278,-0.004400697171049408,314642496,2020-12-31,3749,3878,7627
3646,GDP,-0.005779924266422344,-0.004265084756080738,127321848,2020-12-31,3755,3875,7630
3647,MANU,-0.009964919416340434,-0.0028567396782133,2691752448,2020-06-30,3809,3821,7630
3648,ADTN,-0.008344779060680096,-0.0034940574844511615,885815488,2020-12-31,3785,3846,7631
3649,TLYS,-0.005156985055873521,-0.004889182011569591,369076704,2021-01-30,3742,3895,7637
3650,GLEO,-0.005696846235639077,-0.004547531911966662,174870000,2020-12-31,3753,3884,7637
3651,VERU,-0.027157874172584244,-0.0007907552756145859,811062272,2020-09-30,3963,3677,7640
3652,CPUH,-0.04351944230453506,-1.9288855317714447e-05,1071651264,2020-12-31,4056,3589,7645
3653,ASG,-0.005223871373096613,-0.004928002598910151,364849600,2020-12-31,3747,3899,7646
3654,IPHI,-0.02529675889397559,-0.0011291530802605785,9700803584,2020-12-31,3948,3698,7646
3655,SPRQ,-0.006145089220531676,-0.004900356919309659,434268736,2020-12-31,3759,3898,7657
3656,DMYI,-0.006584486128136508,-0.004787120023220269,413624992,2020-12-31,3768,3894,7662
3657,CVEO,-0.00521883202267164,-0.005485562699867228,234676288,2020-12-31,3746,3918,7664
3658,LCAP,-0.0063680523037040245,-0.005060424490158626,290766016,2020-12-31,3761,3905,7666
3659,PINS,-0.028236031144655588,-0.0010206918564599756,52393881600,2020-12-31,3976,3690,7666
3660,ENFA,-0.045089992542164684,-9.285505281085273e-05,364947072,2020-12-31,4060,3606,7666
3661,PTK,-0.006336940846622639,-0.0051004510662256515,142887488,2020-12-31,3760,3907,7667
3662,GWRE,-0.014978703977765849,-0.0026828629285833767,8714738688,2020-07-31,3862,3807,7669
3663,CLNC,-0.0051674494824693225,-0.00611320988932322,1082940672,2020-12-31,3745,3929,7674
3664,GSAQ,-0.04612161506375699,-0.00015389101965396644,316969248,2020-12-31,4063,3612,7675
3665,NHIC,-0.0065077202858764525,-0.005193564933640606,216919584,2020-12-31,3766,3910,7676
3666,SCVX,-0.006591269138242888,-0.00528990849753256,287212480,2020-12-31,3769,3912,7681
3667,HHLA,-0.049137132679170414,-7.381874394299625e-05,514912480,2020-12-31,4081,3602,7683
3668,BILL,-0.018719203194055047,-0.002443124635720244,12894444544,2020-06-30,3895,3791,7686
3669,ALHC,-0.02918878148068039,-0.0011559288355616833,4462739456,2020-12-31,3983,3703,7686
3670,ASA,-0.005551070327435162,-0.006270296031020228,411260672,2020-11-30,3750,3938,7688
3671,STWO,-0.0067950453411172555,-0.005468740662428863,311406240,2020-12-31,3772,3917,7689
3672,VIAO,-0.01616161616161616,-0.002788847021477915,303556896,2020-12-31,3878,3813,7691
3673,BOMN,-0.010949675812199482,-0.004062505005891158,777259904,2020-12-31,3819,3873,7692
3674,IACA,-0.006996152346034112,-0.005531201764898287,328612992,2020-12-31,3774,3919,7693
3675,NOVA,-0.008964948826719102,-0.004962556475693761,4090701056,2020-12-31,3793,3901,7694
3676,LTHM,-0.012279704377487209,-0.00384748001003286,2499632128,2020-12-31,3833,3862,7695
3677,TPGY,-0.010300276061007429,-0.004582007678124906,791875008,2020-12-31,3811,3885,7696
3678,FVAM,-0.007610378514445335,-0.005698459706118825,111559552,2020-12-31,3779,3922,7701
3679,PEN,-0.025224041271128386,-0.0018130108527372282,9915140096,2020-12-31,3947,3754,7701
3680,CNQ,-0.00564214215543106,-0.006917247065947672,36436627456,2020-12-31,3751,3956,7707
3681,CTAC,-0.0077630806457704435,-0.006127044862650129,330484256,2020-12-31,3781,3930,7711
3682,FAII,-0.007985023564053924,-0.006253726801061571,440306240,2020-12-31,3783,3936,7719
3683,JBGS,-0.007096117048599961,-0.006530129948774423,4216306944,2020-12-31,3775,3946,7721
3684,SPWR,-0.01646893149226034,-0.0034839734128556212,5117963264,2021-01-03,3879,3842,7721
3685,LIVK,-0.008297707441823786,-0.0065915183829851984,101932952,2020-12-31,3784,3947,7731
3686,MNTX,-0.013661675535206039,-0.004508969467513251,171254304,2020-12-31,3850,3882,7732
3687,ACTC,-0.011475694504545738,-0.005412112222204536,590728128,2020-12-31,3824,3915,7739
3688,OSS,-0.017639674289595057,-0.0035723441301008492,115242224,2020-12-31,3889,3851,7740
3689,TTI,-0.008710698762988916,-0.006903140076049625,333052704,2020-12-31,3791,3955,7746
3690,CMCT,-0.006456251348048027,-0.008052493730373417,184601120,2020-12-31,3764,3984,7748
3691,ARMK,-0.015685340142673393,-0.0043717873828953155,9877165056,2020-10-02,3872,3877,7749
3692,ESTE,-0.0061287368134098725,-0.008461394806320596,569475904,2020-12-31,3758,3997,7755
3693,FROG,-0.02517163398798765,-0.002713203111733901,4620113408,2020-12-31,3946,3809,7755
3694,SYPR,-0.01213179758308157,-0.005834301479288275,68169664,2020-12-31,3831,3925,7756
3695,IRL,-0.008705212488396176,-0.007323466042727887,63108332,2020-10-31,3790,3967,7757
3696,CLNE,-0.018864467466237107,-0.003951399430884625,2448438272,2020-12-31,3896,3867,7763
3697,GNRS,-0.009184259497378904,-0.00728026577393802,218487136,2020-12-31,3799,3966,7765
3698,AKR,-0.007349235292373702,-0.008195564429286263,1695846016,2020-12-31,3777,3990,7767
3699,MXE,-0.008987074286050783,-0.007571124197666904,18710866,2020-07-31,3794,3973,7767
3700,TBA,-0.06634434949217938,-0.00011572007228516808,1305849984,2020-12-31,4157,3610,7767
3701,CHAQ,-0.009242628740203821,-0.007326247155768239,109291968,2020-12-31,3800,3969,7769
3702,NEO,-0.029581774906494388,-0.0021516480630566995,5525917696,2020-12-31,3987,3782,7769
3703,CTHR,-0.01457537304429889,-0.005316941186052747,91696792,2020-06-30,3857,3913,7770
3704,AMHC,-0.00932236186153793,-0.007513293022596578,125000000,2020-12-31,3801,3970,7771
3705,WDAY,-0.028091466752575827,-0.0025633183570575287,62573465600,2021-01-31,3974,3800,7774
3706,HUBS,-0.03354629214076401,-0.0020768681930430455,23934910464,2020-12-31,4001,3773,7774
3707,IVAN,-0.06688710343035607,-0.0001875990344968566,349484992,2020-12-31,4159,3616,7775
3708,NFE,-0.024605488432018322,-0.0031925524228633884,8956622848,2020-12-31,3944,3833,7777
3709,PYR,-0.03591962285740753,-0.0019634096286237834,1064204224,2020-12-31,4012,3765,7777
3710,SCPE,-0.009940093561615397,-0.007538971302982093,229265632,2020-12-31,3807,3971,7778
3711,GBLI,-0.005847326029491205,-0.009623434336257642,413371840,2020-12-31,3756,4025,7781
3712,SFTW,-0.009861077097405281,-0.007774589637836733,401636992,2020-12-31,3805,3978,7783
3713,KOSS,-0.02726491514925795,-0.0028236870852883507,172806288,2020-06-30,3966,3818,7784
3714,GCO,-0.007418682166439163,-0.009011116891268097,727889024,2021-01-30,3778,4007,7785
3715,YSAC,-0.009907942320411017,-0.007861617686705883,171345888,2020-12-31,3806,3979,7785
3716,CONN,-0.007757095107797429,-0.00901977805815197,635838016,2021-01-31,3780,4008,7788
3717,GPAC,-0.07317073170731707,-8.200978829468388e-05,365624992,2020-12-31,4185,3603,7788
3718,SOAC,-0.009948646649174308,-0.008013340707843309,374249984,2020-12-31,3808,3982,7790
3719,KYN,-0.00868101209961401,-0.008877190888856804,914219072,2020-11-30,3789,4003,7792
3720,TMPM,-0.010303947648621463,-0.00812783703127186,125331264,2020-12-31,3812,3987,7799
3721,ENG,-0.02760559319590601,-0.0033421559268798414,113132688,2020-12-26,3970,3835,7805
3722,LC,-0.009109939709107099,-0.009024523696258238,1475286656,2020-12-31,3798,4009,7807
3723,TBIO,-0.015367637670320851,-0.006373729503882665,1298155648,2020-12-31,3867,3942,7809
3724,HGSH,-0.006681190031176158,-0.010279023489321915,50681248,2020-09-30,3770,4041,7811
3725,JIH,-0.012514374057030308,-0.0076635956102446105,571837504,2020-12-31,3834,3977,7811
3726,HGV,-0.01381957773512476,-0.007198994214120357,3293698560,2020-12-31,3851,3963,7814
3727,BL,-0.0389373378361682,-0.0022137178539382105,6551351808,2020-12-31,4033,3784,7817
3728,STNE,-0.010734332100009614,-0.008769161760869996,21026523136,2020-12-31,3817,4001,7818
3729,WMG,-0.02647887323943662,-0.0038554336920595088,19072174080,2020-09-30,3956,3864,7820
3730,EXFO,-0.012643371297028557,-0.008135261644016198,226145408,2020-08-31,3837,3988,7825
3731,LFTR,-0.011119595762252545,-0.0089204423827148,259391760,2020-12-31,3821,4005,7826
3732,BVN,-0.009022778487655219,-0.010015943235357138,2704961536,2020-12-31,3795,4032,7827
3733,BMRN,-0.020883198151645792,-0.006145120489924966,14013637632,2020-12-31,3910,3931,7841
3734,JAMF,-0.04333919718535103,-0.0023352909835607943,4404899840,2020-12-31,4055,3788,7843
3735,HBM,-0.008386846285075593,-0.011153046354008253,2050391808,2020-12-31,3786,4058,7844
3736,REX,-0.0119520533942259,-0.009426802761914288,516869920,2021-01-31,3830,4017,7847
3737,PFSW,-0.01614349031390581,-0.007581207635471153,143908432,2020-12-31,3877,3974,7851
3738,CSTA,-0.0869050279844513,-9.580313312670633e-05,393476256,2020-12-31,4243,3608,7851
3739,WIFI,-0.014423682401920039,-0.00881053709377006,626506176,2020-12-31,3854,4002,7856
3740,MARA,-0.052553855683091164,-0.0019061138808583596,4841425408,2020-12-31,4095,3762,7857
3741,HES,-0.015413914181991312,-0.008402096000493303,22655641600,2020-12-31,3868,3995,7863
3742,XELA,-0.022551272232150456,-0.006320547571853724,127961864,2020-12-31,3923,3940,7863
3743,OPRX,-0.05929619586962116,-0.0016424725061509088,806704704,2020-12-31,4127,3736,7863
3744,ANIP,-0.019081984526390743,-0.007324809625894424,393958464,2020-12-31,3898,3968,7866
3745,BLMN,-0.013365343653232747,-0.009494150241334088,2499488256,2020-12-27,3845,4023,7868
3746,DXR,-0.020514937435025762,-0.007119171762711268,46591316,2020-12-31,3907,3961,7868
3747,LIVN,-0.029197251471588376,-0.004609514479737488,3893071872,2020-12-31,3984,3886,7870
3748,AZEK,-0.04663577876715984,-0.0026427616837665473,7234048512,2020-09-30,4069,3805,7874
3749,MEC,-0.018608033039583517,-0.008022228358470418,300891008,2020-12-31,3893,3983,7876
3750,LQDT,-0.03273030893403841,-0.00447288112257705,659006464,2020-09-30,3999,3880,7879
3751,CRSA,-0.012872427831799083,-0.010268960284563384,315625024,2020-12-31,3841,4039,7880
3752,ELLO,-0.015548416429759829,-0.00945127374561158,415996576,2020-12-31,3870,4021,7891
3753,TWIN,-0.011281265310737303,-0.011647485353741134,136300560,2020-06-30,3822,4073,7895
3754,RCG,-0.013962661344883769,-0.010682657922311767,15594135,2020-12-31,3852,4050,7902
3755,OLK,-0.07538005867572538,-0.0011786267141597952,4474662912,2020-12-31,4195,3707,7902
3756,TDAC,-0.02017126340612771,-0.008482770497631633,158931056,2020-12-31,3906,3998,7904
3757,MDIA,-0.011806412564161014,-0.011788821117731252,26902838,2020-12-31,3827,4078,7905
3758,APXT,-0.015658392495359465,-0.010041279533095247,544523200,2020-12-31,3871,4034,7905
3759,OSPN,-0.033623870518042935,-0.005085844646942096,1046939904,2020-12-31,4002,3906,7908
3760,FMO,-0.011811980250866995,-0.012231508624483136,69960040,2020-11-30,3828,4083,7911
3761,DSX,-0.010402300250980774,-0.01283203175230799,285589184,2020-12-31,3813,4100,7913
3762,AMTX,-0.030663999353378598,-0.006003611155295843,707289152,2020-12-31,3990,3927,7917
3763,GNMK,-0.04433197107827727,-0.003831234289304116,1765544064,2020-12-31,4057,3861,7918
3764,CSU,-0.012536881860025965,-0.01224725262042782,80838856,2020-12-31,3835,4084,7919
3765,STKS,-0.016779082144857054,-0.010204335842548632,256256880,2020-12-31,3883,4037,7920
3766,BLFS,-0.056988450132667394,-0.0025889068547935907,1202450432,2020-12-31,4117,3803,7920
3767,GXGX,-0.014461964713403774,-0.011516625591040466,363328128,2020-12-31,3855,4067,7922
3768,GIK,-0.014765555596286312,-0.011445571374118042,262301152,2020-12-31,3859,4064,7923
3769,FOXW,-0.10067584421137651,-0.00035348749093152643,71803120,2020-12-31,4289,3634,7923
3770,GRNV,-0.01454234977097946,-0.01155724121710989,73168752,2020-12-31,3856,4069,7925
3771,WHG,-0.015508749869013938,-0.011151737166652109,147208224,2020-12-31,3869,4057,7926
3772,NOTV,-0.028180305551353806,-0.006885340243578576,221512864,2020-09-30,3975,3954,7929
3773,PANW,-0.04020357416746067,-0.004700440331251057,33987262464,2020-07-31,4040,3893,7933
3774,MEOH,-0.014602727464750926,-0.011756520291591329,3043099392,2020-12-31,3858,4076,7934
3775,MAG,-0.03689390922260201,-0.005459507116785512,1637202432,2020-12-31,4019,3916,7935
3776,UFI,-0.01751404377300853,-0.011087220351976092,528366080,2020-06-28,3888,4056,7944
3777,CAR,-0.00999677523379555,-0.013977914436354247,5381921792,2020-12-31,3810,4136,7946
3778,ALC,-0.03370501773948302,-0.0064667095503836295,36483747840,2020-12-31,4003,3945,7948
3779,BATL,-0.014892911943012612,-0.012428567343704119,192928992,2020-12-31,3861,4089,7950
3780,HZN,-0.024080507966934228,-0.009394014700900804,270558080,2020-12-31,3937,4016,7953
3781,DOCN,-0.05410211255541775,-0.0035398507026326797,4234233600,2020-12-31,4109,3848,7957
3782,SHAK,-0.03284018684581325,-0.007064337345223961,4811147264,2020-12-30,4000,3960,7960
3783,CRWD,-0.07567834380786426,-0.001970142637316692,45375184896,2021-01-31,4198,3766,7964
3784,ZDGE,-0.07192575406032482,-0.0022328400755056758,182542624,2020-07-31,4180,3786,7966
3785,CVX,-0.015049219426597081,-0.012897754830391937,198424608768,2020-12-31,3865,4103,7968
3786,JOB,-0.031623740201567746,-0.0076347558743552766,21023850,2020-09-30,3993,3975,7968
3787,HAYN,-0.010923992873689017,-0.014806301785110203,367654080,2020-09-30,3818,4151,7969
3788,AMRN,-0.029809028093738817,-0.00800697552879582,2334255616,2020-12-31,3988,3981,7969
3789,ZS,-0.0574370623865475,-0.0035650617422226345,25154336768,2020-07-31,4121,3850,7971
3790,GSQD,-0.12009662947198896,-0.00011009631430863867,426506272,2020-12-31,4363,3609,7972
3791,PRA,-0.007978911866830425,-0.016759964660428676,1464819968,2020-12-31,3782,4192,7974
3792,OSUR,-0.026985248247770724,-0.009259330260224104,749672128,2020-12-31,3961,4015,7976
3793,SPOT,-0.048880199075719874,-0.004998276335499683,53269966848,2020-12-31,4077,3903,7980
3794,ZKIN,-0.026374655431580494,-0.00976185506577665,155135184,2020-09-30,3955,4027,7982
3795,HHC,-0.015972548884178168,-0.013288205705130887,5509462528,2020-12-31,3876,4109,7985
3796,F,-0.0106486086668197,-0.015805123165018007,49929912320,2020-12-31,3814,4172,7986
3797,UTI,-0.010671290616927958,-0.015914351042940478,198402576,2020-09-30,3816,4178,7994
3798,AC,-0.0110197195446467,-0.016197441840804648,771873920,2020-12-31,3820,4182,8002
3799,ELSE,-0.017282277194171466,-0.013666903135355065,15483571,2020-12-31,3885,4120,8005
3800,OOMA,-0.04441208008578333,-0.006759488860849528,381176000,2021-01-31,4059,3952,8011
3801,GPRO,-0.05273119232597968,-0.0053451123269061904,1981881600,2020-12-31,4097,3914,8011
3802,LHC,-0.12887820898929123,-0.0002221807395260797,457031264,2020-12-31,4390,3621,8011
3803,ALAC,-0.0289373129531912,-0.010091987075669578,50398420,2020-12-31,3982,4036,8018
3804,ALUS,-0.01790858595718098,-0.014181635474063098,362968768,2020-12-31,3890,4138,8028
3805,IDN,-0.1003032844418674,-0.0017074819928748197,163067632,2020-12-31,4287,3741,8028
3806,FVT,-0.13920359762601794,-0.00020581925625952281,287500000,2020-12-31,4410,3619,8029
3807,CHWY,-0.08359638941664388,-0.0025310949576124557,34923536384,2021-01-31,4234,3797,8031
3808,TCOM,-0.012902348354338561,-0.016671150583690335,22366035968,2020-12-31,3842,4191,8033
3809,TRC,-0.015766193783791488,-0.01509687137141681,423492512,2020-12-31,3873,4160,8033
3810,ZVO,-0.01994246686550306,-0.013858077490739248,124779784,2020-12-31,3905,4130,8035
3811,UPWK,-0.07232936847371733,-0.003672849186859251,5993177600,2020-12-31,4182,3854,8036
3812,POW,-0.13669660845488413,-0.00033023696430192366,338788000,2020-12-31,4407,3631,8038
3813,PATI,-0.012815562098759474,-0.016963874168051358,37588812,2020-09-30,3840,4202,8042
3814,AOSL,-0.023659202466503344,-0.013337322976613202,866678784,2020-06-30,3932,4111,8043
3815,BOX,-0.03629442431944339,-0.009946798953092566,3468962048,2021-01-31,4016,4028,8044
3816,HWCC,-0.01656715974573754,-0.015538606116129092,88465872,2020-12-31,3881,4166,8047
3817,SRAC,-0.021190829542834536,-0.013964703604830625,264184624,2020-12-31,3913,4135,8048
3818,TWI,-0.023296317566298297,-0.013794372656148421,612765184,2020-12-31,3930,4128,8058
3819,SA,-0.026506691983955805,-0.012878501480352788,1299409792,2020-12-31,3957,4101,8058
3820,TURN,-0.013464969208245296,-0.01738607733554017,76869856,2020-12-31,3848,4212,8060
3821,MAYS,-0.012765434010666581,-0.01823937093310762,57066732,2020-07-31,3839,4223,8062
3822,RUTH,-0.028895522105417643,-0.012333791873814488,861800960,2020-12-27,3980,4086,8066
3823,AMBC,-0.016857557670592032,-0.016429520690565462,790004096,2020-12-31,3884,4188,8072
3824,VREX,-0.028741328047571853,-0.012670764032507064,860440000,2020-10-02,3979,4093,8072
3825,RELL,-0.01648921322327232,-0.016792524642166934,99850208,2020-05-30,3880,4194,8074
3826,NTUS,-0.03869352543224248,-0.01038719970291025,864909312,2020-12-31,4031,4044,8075
3827,GDEN,-0.022908498102032278,-0.014867614473239218,811542400,2020-12-31,3925,4154,8079
3828,ALIM,-0.04656812073599338,-0.009142493750836624,55002792,2020-12-31,4067,4013,8080
3829,RNG,-0.08085802807206453,-0.0037889299511608505,28713267200,2020-12-31,4223,3859,8082
3830,INVE,-0.05179987004548408,-0.00833448697464797,208962896,2020-12-31,4091,3992,8083
3831,TKAT,-0.07917346087454155,-0.004057224760592412,372068896,2020-12-31,4216,3872,8088
3832,CUBA,-0.02104765599431267,-0.016392904476463445,37538000,2020-06-30,3912,4185,8097
3833,DGNU,-0.17785998861696073,-3.8982842216571895e-05,513000000,2020-12-31,4503,3594,8097
3834,BSPE,-0.006422463801718011,-0.026086438627836068,90990000,2020-12-31,3763,4335,8098
3835,SSY,-0.018975660399123313,-0.01694453122722596,17317294,2020-06-30,3897,4201,8098
3836,PAGS,-0.02152914903216618,-0.0164182983708154,15275267072,2020-12-31,3915,4187,8102
3837,NET,-0.08121609564019837,-0.00450515393645238,21889585152,2020-12-31,4224,3881,8105
3838,MODN,-0.07782202012110359,-0.00494422539531754,1344491136,2020-09-30,4207,3900,8107
3839,ATRO,-0.028665077628086993,-0.01393811690449196,564887616,2020-12-31,3978,4133,8111
3840,OKTA,-0.07342261618980933,-0.006001457540118878,32049842176,2021-01-31,4186,3926,8112
3841,GT,-0.0186340371081254,-0.017953678830538354,4210841600,2020-12-31,3894,4219,8113
3842,HAAC,-0.019602868918408095,-0.01759852499771122,589837504,2020-12-31,3902,4214,8116
3843,APPH,-0.05337806178156691,-0.009172973180529582,1662769792,2020-12-31,4104,4014,8118
3844,OII,-0.02189499174645553,-0.016965476540713495,1081332352,2020-12-31,3917,4203,8120
3845,CVET,-0.05099150141643059,-0.010017703106837904,3916457216,2020-12-31,4087,4033,8120
3846,QS,-0.08544986658510605,-0.00468330233861676,17400838144,2020-12-31,4238,3891,8129
3847,AEAC,-0.16523897630862236,-0.0006091401832201328,224480000,2020-12-31,4471,3658,8129
3848,RRC,-0.018030321811858756,-0.019144482113811468,2301165056,2020-12-31,3891,4239,8130
3849,GOCO,-0.05092953267843961,-0.010484653866081519,3897762048,2020-12-31,4086,4047,8133
3850,MUR,-0.013372395613036497,-0.02240088750141732,2533884928,2020-12-31,3847,4290,8137
3851,PWFL,-0.05225380419178869,-0.010426889018195447,290692544,2020-12-31,4094,4045,8139
3852,DZSI,-0.04151402527807881,-0.012784841309324346,415217888,2020-12-31,4048,4098,8146
3853,APPN,-0.0970636591324657,-0.003977658871834407,9485294592,2020-12-31,4277,3869,8146
3854,GRIN,-0.015023804259475177,-0.021821721786849543,131147608,2020-12-31,3863,4285,8148
3855,LXU,-0.01578173159170471,-0.021353005137410706,169112256,2020-12-31,3874,4274,8148
3856,DCRB,-0.023633458937259783,-0.017949384645572684,300213984,2020-12-31,3931,4218,8149
3857,WK,-0.07953148000389731,-0.0061509412018622535,4661689856,2020-12-31,4218,3932,8150
3858,GMII,-0.19255246946373702,-0.0001564590010014909,567259968,2020-12-31,4537,3613,8150
3859,PXS,-0.02100753978127062,-0.01949676656868755,37595260,2020-12-31,3911,4242,8153
3860,FARO,-0.05833817001050997,-0.009962543515206035,1570878976,2020-12-31,4123,4030,8153
3861,DOCU,-0.09889441667908618,-0.004105613728641289,41121951744,2021-01-31,4280,3874,8154
3862,KAIR,-0.18538142684276923,-0.000400989734709571,269100000,2020-12-31,4518,3636,8154
3863,CIDM,-0.039159365742533245,-0.01368283774843805,204123424,2020-03-31,4034,4123,8157
3864,CAAS,-0.02152696507370704,-0.019563246855000726,152716400,2020-12-31,3914,4244,8158
3865,LMPX,-0.05661535855542449,-0.010309232924000574,158719504,2020-12-31,4115,4043,8158
3866,DNMR,-0.08651789788502032,-0.00574504378135886,3034939648,2020-12-31,4242,3924,8166
3867,TALO,-0.017376470395491332,-0.02159730633406513,958425408,2020-12-31,3887,4281,8168
3868,GFL,-0.04668495223682966,-0.012796917141108878,11863294976,2020-12-31,4070,4099,8169
3869,PUMP,-0.023046773044295133,-0.019590571491092647,1032826944,2020-12-31,3927,4245,8172
3870,TENB,-0.07100086552836572,-0.008716917587891468,3944004864,2020-12-31,4174,3999,8173
3871,GIX,-0.02311685945875388,-0.019611869697816125,199311744,2020-12-31,3928,4246,8174
3872,PNTM,-0.20790465731461472,-0.00027328728213360195,838352320,2020-12-31,4552,3627,8179
3873,VFF,-0.05169771258999453,-0.012679921491841287,1020690560,2020-12-31,4089,4095,8184
3874,PEI,-0.019319401737149647,-0.022071225389958482,161843664,2020-12-31,3900,4287,8187
3875,CRNT,-0.03456823893457337,-0.015941018002134343,307204768,2020-12-31,4007,4180,8187
3876,PACX,-0.20591175882470564,-0.0004221574461668973,497087520,2020-12-31,4548,3639,8187
3877,BRT,-0.025922038180297827,-0.019033653031354188,293797760,2020-12-31,3951,4237,8188
3878,RMBS,-0.04022847835625524,-0.014940423981726974,2281398784,2020-12-31,4041,4156,8197
3879,LNDC,-0.027209748983197075,-0.01893803004770718,290592896,2020-05-31,3965,4234,8199
3880,AFRM,-0.09651415478259467,-0.005706904988956074,18201249792,2020-06-30,4276,3923,8199
3881,HURC,-0.023878715192890202,-0.02094136331969953,229900352,2020-10-31,3934,4267,8201
3882,APLE,-0.022519162188647728,-0.021781888538930816,3374969088,2020-12-31,3922,4283,8205
3883,GCAC,-0.242075,-4.5866032618067485e-05,211096880,2020-03-31,4611,3599,8210
3884,NGS,-0.011386831515717035,-0.029425044427672714,124232064,2020-12-31,3823,4389,8212
3885,SCHL,-0.022614369392748572,-0.022266516837878707,1051469696,2020-05-31,3924,4289,8213
3886,COP,-0.028597024363681077,-0.019002565450546453,69270642688,2020-12-31,3977,4236,8213
3887,AIRI,-0.03006120871545259,-0.018258114469419953,43200272,2020-12-31,3989,4224,8213
3888,CCNC,-0.09406863264142287,-0.006639988354106679,141373104,2020-12-31,4268,3949,8217
3889,FPH,-0.015886377921372628,-0.02630171608127221,1114560512,2020-12-31,3875,4344,8219
3890,HFC,-0.027425121181161034,-0.0201435579622874,5712135680,2020-12-31,3968,4252,8220
3891,WRN,-0.041382477231067846,-0.015809963707973478,168758864,2020-12-31,4047,4173,8220
3892,SWBK,-0.23223354301706178,-0.00034448228711535294,401241664,2020-12-31,4594,3633,8227
3893,APTS,-0.019675895313970904,-0.025327762315098604,514438272,2020-12-31,3903,4326,8229
3894,BTRS,-0.11549493275543374,-0.004429887062653369,2360528640,2020-12-31,4350,3879,8229
3895,HCC,-0.024168455174501963,-0.022538327031781307,865816640,2020-12-31,3938,4293,8231
3896,RFL,-0.06446036810563428,-0.012368671882083859,684869376,2020-07-31,4144,4087,8231
3897,BYND,-0.12319786715036277,-0.003873826691339948,8205526528,2020-12-31,4369,3865,8234
3898,ALLT,-0.06381730538160331,-0.012679330729960178,676840832,2020-12-31,4141,4094,8235
3899,AVLR,-0.11180909515905267,-0.004970974748224463,12178430976,2020-12-31,4334,3902,8236
3900,ZEN,-0.09277530942452707,-0.007643672786395201,17083071488,2020-12-31,4263,3976,8239
3901,CAL,-0.02718975082581486,-0.021503646209306736,810183424,2021-01-30,3964,4280,8244
3902,DNN,-0.049091917371412726,-0.015426222385885686,931304832,2020-12-31,4080,4164,8244
3903,NAV,-0.03978520868928484,-0.017278957500850827,4405439488,2020-10-31,4037,4210,8247
3904,DRQ,-0.025322797287636215,-0.022902487522173238,1077035520,2020-12-31,3949,4299,8248
3905,SOI,-0.030719755629318397,-0.020348869876528612,536353632,2020-12-31,3991,4257,8248
3906,OFIX,-0.05026783293944265,-0.015678814798781478,832123840,2020-12-31,4085,4168,8253
3907,CPHC,-0.02599186717783058,-0.022942472789207257,65237252,2020-12-31,3954,4301,8255
3908,NTIP,-0.041677298630603044,-0.017242306342156608,80309944,2020-12-31,4049,4208,8257
3909,CLR,-0.02598704240403567,-0.02360304223615082,9378447360,2020-12-31,3953,4307,8260
3910,BURL,-0.06538361519273858,-0.013190817585183364,21606578176,2021-01-30,4152,4108,8260
3911,PFPT,-0.0741909765330004,-0.01159883131347314,7468868608,2020-12-31,4189,4071,8260
3912,GMBT,-0.25698708516942925,-0.0003250359742615249,424781280,2020-12-31,4637,3630,8267
3913,CREE,-0.07798748537416696,-0.011423220390608576,12793833472,2020-06-28,4208,4062,8270
3914,PRTG,-0.046600821633757145,-0.016983519247469523,349211296,2020-03-31,4068,4204,8272
3915,HTHT,-0.024462376121273846,-0.02563883685040249,34356158464,2020-12-31,3943,4330,8273
3916,SEMR,-0.14855913354607872,-0.0034892866509866017,1753725952,2020-12-31,4436,3843,8279
3917,ICCC,-0.04233402245515451,-0.018552762660097623,70403192,2020-12-31,4052,4228,8280
3918,CSBR,-0.09253656076651538,-0.009451451652837416,151577056,2020-04-30,4262,4022,8284
3919,KLAQ,-0.24995887995959812,-0.0006076051756813261,354703136,2020-12-31,4627,3657,8284
3920,NG,-0.11519660589663971,-0.006261789946108833,2939552000,2020-11-30,4348,3937,8285
3921,SSSS,-0.027984692672289493,-0.02391671460549644,380056864,2020-12-31,3973,4313,8286
3922,SFIX,-0.09553307433288276,-0.009135896675243772,5586355200,2020-08-01,4274,4012,8286
3923,IAC,-0.07411595640387106,-0.012889508408674432,21503430656,2020-12-31,4188,4102,8290
3924,JVA,-0.02942097553235636,-0.023385560891422384,30369752,2020-10-31,3986,4306,8292
3925,ONEM,-0.07722334047572668,-0.012451168610197554,5485424640,2020-12-31,4204,4090,8294
3926,USIO,-0.05308611507685217,-0.0167972425800872,165202624,2020-12-31,4100,4195,8295
3927,IOR,-0.015213894527210755,-0.032168818070251515,49395660,2020-12-31,3866,4431,8297
3928,RIOT,-0.1777745867063955,-0.002504852316750149,4174910720,2020-12-31,4502,3795,8297
3929,IPI,-0.02689783878153031,-0.0261513863879279,420109088,2020-12-31,3958,4340,8298
3930,CHNG,-0.08732872255135721,-0.01092903338398661,6899990016,2020-03-31,4245,4053,8298
3931,SNOW,-0.107256316087846,-0.00830790411810304,65503141888,2021-01-31,4307,3991,8298
3932,E,-0.024453401184391255,-0.02738524024337563,43139796992,2020-12-31,3942,4361,8303
3933,NDLS,-0.03465843262436017,-0.022662072606922223,480333728,2020-12-29,4009,4295,8304
3934,SITM,-0.14112657877754217,-0.004621447981889623,1710570880,2020-12-31,4418,3887,8305
3935,LMAO,-0.2914583120726605,-0.00024368450978799449,128709736,2020-12-31,4681,3624,8305
3936,NXE,-0.08322709495770184,-0.011675664742826395,1862691584,2020-12-31,4232,4074,8306
3937,DCBO,-0.15074135090609556,-0.00391132472564515,1577547520,2020-12-31,4444,3866,8310
3938,INGN,-0.08880568356374809,-0.01144113002841518,1206284544,2020-12-31,4249,4063,8312
3939,NTIC,-0.048184480623806224,-0.01932198630362972,139118848,2020-08-31,4074,4240,8314
3940,NVRO,-0.0870861633703836,-0.011577308225366933,5092556800,2020-12-31,4244,4070,8314
3941,AGYS,-0.11064249820531227,-0.008121340975271485,1191807744,2020-03-31,4328,3986,8314
3942,SD,-0.023221822729404408,-0.029537269591898927,134422576,2020-12-31,3929,4390,8319
3943,YELP,-0.07700990042260321,-0.013510667758409171,3038431488,2020-12-31,4202,4117,8319
3944,MDRX,-0.04625579634907569,-0.020423698951455602,2166295040,2020-12-31,4064,4258,8322
3945,FCEL,-0.10836251996012386,-0.009113423254474083,4017465344,2020-10-31,4314,4011,8325
3946,FWAA,-0.3111026271206662,-0.00017357192895575896,450559488,2020-12-31,4711,3615,8326
3947,ALGT,-0.04197477574606994,-0.02144939578899327,4150293248,2020-12-31,4050,4278,8328
3948,ARCO,-0.027740195465489136,-0.027318352519585018,1048765952,2020-12-31,3971,4360,8331
3949,MDRR,-0.0277553768406361,-0.027311876566914316,10257577,2020-12-31,3972,4359,8331
3950,SNCY,-0.05677925916654431,-0.017925486222715524,2183835136,2020-12-31,4116,4216,8332
3951,CVNA,-0.12532741426902208,-0.006917779156937405,46734405632,2020-12-31,4375,3957,8332
3952,GAIA,-0.0501555167817238,-0.019789669170096877,218891392,2020-12-31,4084,4250,8334
3953,BE,-0.06655402009843256,-0.01589050411830331,4270914816,2020-12-31,4158,4177,8335
3954,COUP,-0.12494286647078028,-0.0071206536741390165,19324827648,2021-01-31,4374,3962,8336
3955,GBR,-0.08050010967317395,-0.013672400928739744,26583396,2020-12-31,4220,4121,8341
3956,ASUR,-0.03434245013159434,-0.02612668719221839,149283456,2020-12-31,4006,4339,8345
3957,DSPG,-0.04638620484614241,-0.021503510929858895,350307968,2020-12-31,4066,4279,8345
3958,DFHT,-0.04089783172842395,-0.023702861393646545,251024144,2020-12-31,4042,4309,8351
3959,PSX,-0.03410678080648795,-0.026907676857658068,34604470272,2020-12-31,4005,4353,8358
3960,IRTC,-0.10450986398139196,-0.01128574099308509,3871374336,2020-12-31,4298,4060,8358
3961,GWPH,-0.12373166971424474,-0.008165180903334653,6657826816,2020-12-31,4372,3989,8361
3962,CDNA,-0.1444315508055675,-0.006167278691693822,3718278656,2020-12-31,4428,3933,8361
3963,MIT,-0.3228156530766668,-0.0004100357903929029,609374976,2020-12-31,4727,3637,8364
3964,CDMO,-0.12249597852125309,-0.008912299550637562,1179466496,2020-04-30,4365,4004,8369
3965,AE,-0.032656462646210666,-0.028215377137080423,117795760,2020-12-31,3997,4373,8370
3966,COTY,-0.053775311583045236,-0.02074807183539069,6648121856,2020-06-30,4107,4266,8373
3967,DCT,-0.1675839385156479,-0.004899485491794374,5543736832,2020-08-31,4478,3897,8375
3968,BLUA,-0.3524589107315501,-0.00022751884631918242,360394880,2020-12-31,4752,3623,8375
3969,MLP,-0.08792436379488856,-0.014350644328365653,222789952,2020-12-31,4247,4141,8388
3970,WKHS,-0.06236713922477164,-0.019822699503506926,1659282816,2020-12-31,4138,4251,8389
3971,FORD,-0.057737396560491,-0.02099600173545425,29164732,2020-09-30,4122,4268,8390
3972,EDRY,-0.02291135009609435,-0.035001391427453385,22281760,2020-12-31,3926,4466,8392
3973,XOM,-0.031341725814992,-0.03065613431768206,236526764032,2020-12-31,3992,4404,8396
3974,CYRX,-0.1427824664010061,-0.007541612792306501,2384664576,2020-12-31,4424,3972,8396
3975,TWLO,-0.14978514698252351,-0.007015143276007154,62776815616,2020-12-31,4439,3959,8398
3976,RUN,-0.0426875730367241,-0.026361582926024037,10453334016,2020-12-31,4054,4345,8399
3977,TRT,-0.025726141078838173,-0.03406290521236619,16845942,2020-06-30,3950,4451,8401
3978,HYLN,-0.08568834981458591,-0.01539425942673857,1825133696,2020-12-31,4239,4162,8401
3979,OXM,-0.062110170642284884,-0.021152964670039083,1491519488,2021-01-30,4137,4271,8408
3980,TBCP,-0.4028,-9.57093698589182e-05,525947424,2020-12-31,4804,3607,8411
3981,BIVI,-0.12096970074858338,-0.010636987555044355,229617296,2020-06-30,4364,4048,8412
3982,PDS,-0.022476508027139633,-0.03758984317174995,324723168,2020-12-31,3921,4494,8415
3983,NNBR,-0.0318914384723279,-0.03174067977308792,299921408,2020-12-31,3995,4423,8418
3984,IMO,-0.025969889982628835,-0.03543847538062487,18255472640,2020-12-31,3952,4469,8421
3985,GATO,-0.0748012275073232,-0.01858619002929669,607755072,2020-12-31,4193,4229,8422
3986,WIX,-0.12324085054934486,-0.01090161309681099,16819528704,2020-12-31,4370,4052,8422
3987,ISUN,-0.10189712799075432,-0.013910592719424323,111917256,2020-12-31,4292,4131,8423
3988,SDGR,-0.11374071314807242,-0.012074963638771176,5173909504,2020-12-31,4342,4081,8423
3989,FAT,-0.05653025240372907,-0.023711595346862353,101647584,2020-12-27,4114,4310,8424
3990,DDS,-0.04213269978202452,-0.028805661934682498,2192170240,2021-01-30,4051,4377,8428
3991,PEGA,-0.10928263167031635,-0.013290421539202363,9992842240,2020-12-31,4321,4110,8431
3992,IMBI,-0.057282623345939476,-0.023864088542698163,127509168,2021-01-30,4120,4312,8432
3993,KOPN,-0.19184612350986943,-0.004891680323488758,974009856,2020-12-26,4536,3896,8432
3994,CPNG,-0.17318797845733885,-0.0064307675986784345,78639161344,2020-12-31,4490,3943,8433
3995,EQT,-0.023954762826644972,-0.03803225610408024,4793500672,2020-12-31,3935,4500,8435
3996,THM,-0.07590017414935715,-0.019401434724998494,230369472,2020-12-31,4199,4241,8440
3997,RBLX,-0.17300620356508348,-0.006673463115398924,39545290752,2020-12-31,4489,3951,8440
3998,PDFS,-0.07006902912210203,-0.02114211670936832,692438720,2020-12-31,4171,4270,8441
3999,NYC,-0.024394314159749964,-0.038613921852777594,107705184,2020-12-31,3940,4502,8442
4000,STRS,-0.0386927330550966,-0.03100685897374592,261798064,2020-12-31,4030,4412,8442
4001,TISI,-0.046747500042588715,-0.028042221445691542,367094240,2020-12-31,4072,4370,8442
4002,NTZ,-0.0293141592920354,-0.03451832349843339,175483280,2020-12-31,3985,4458,8443
4003,VLO,-0.03623032647894724,-0.03197812638076364,29058676736,2020-12-31,4015,4428,8443
4004,SWTX,-0.10829639604256672,-0.014264849881787247,3376901888,2020-12-31,4312,4139,8451
4005,BB,-0.0995850622406639,-0.015773457315652214,5151173632,2021-02-28,4282,4170,8452
4006,SYNL,-0.034815048641202974,-0.033559640160990674,89443832,2020-12-31,4010,4443,8453
4007,PING,-0.11327836043403479,-0.013475288776717938,1768586624,2020-12-31,4338,4115,8453
4008,CAKE,-0.03965308170750363,-0.031277236361159026,2685920512,2020-12-29,4036,4419,8455
4009,EXTR,-0.07307998678867712,-0.02132847391673761,1165070848,2020-06-30,4183,4273,8456
4010,IONS,-0.07310595262859183,-0.021319285445925026,5966914560,2020-12-31,4184,4272,8456
4011,GSAT,-0.06740119383741525,-0.02283544378267099,2237246208,2020-12-31,4161,4298,8459
4012,OMEG,-0.36021774878242324,-0.0011336233805342856,171380544,2020-12-31,4761,3700,8461
4013,HIMS,-0.18838866980979513,-0.006180132266191754,2462548992,2020-12-31,4528,3934,8462
4014,LI,-0.026913685321465673,-0.03878992588847594,20589697024,2020-12-31,3959,4505,8464
4015,BNED,-0.035551669906279594,-0.03422111536871167,358624736,2020-05-02,4011,4453,8464
4016,MPC,-0.037854522159454895,-0.03339947879844084,34443526144,2020-12-31,4023,4442,8465
4017,MTA,-0.09159644513806749,-0.017124529197697802,391096480,2020-12-31,4260,4205,8465
4018,ASPU,-0.08476915141969044,-0.01889373916259578,144712320,2020-04-30,4235,4233,8468
4019,RFIL,-0.07532281205164992,-0.021366460436233935,67014928,2020-10-31,4194,4275,8469
4020,GILT,-0.06601103342575922,-0.02437366585289271,598748800,2020-12-31,4154,4317,8471
4021,GPS,-0.04904742602351034,-0.029740485058285925,12162112512,2021-01-30,4079,4394,8473
4022,GCMG,-0.10113341303610635,-0.016207725200506437,2252368640,2020-12-31,4291,4183,8474
4023,EVH,-0.08209524347531352,-0.01971762702805614,1739054464,2020-12-31,4226,4249,8475
4024,MSGS,-0.08881154789752953,-0.01868604555056885,4435766272,2020-06-30,4250,4230,8480
4025,ATRC,-0.12952078119368496,-0.012550064351685425,3003260672,2020-12-31,4393,4091,8484
4026,ACEL,-0.10580478481766406,-0.016261360899824374,1115099648,2020-12-31,4302,4184,8486
4027,SRG,-0.038078479455322285,-0.03478831036921264,1021404480,2020-12-31,4027,4463,8490
4028,KEQU,-0.03206922498118887,-0.03765379836180709,33899556,2020-04-30,3996,4495,8491
4029,CCO,-0.05547800898385877,-0.029029352244768068,987182464,2020-12-31,4112,4380,8492
4030,DDD,-0.11158967715703401,-0.015293422133813834,2966683136,2020-12-31,4332,4161,8493
4031,STRT,-0.038818647915586126,-0.03468297444349076,191904384,2020-06-28,4032,4462,8494
4032,NEWR,-0.09529387328427784,-0.01813120305021956,4119477760,2020-03-31,4273,4222,8495
4033,ANGO,-0.11409226867806749,-0.014877015569059104,906526016,2020-05-31,4343,4155,8498
4034,BGI,-0.03806401592156432,-0.03579893426084669,41872196,2020-03-28,4026,4475,8501
4035,IO,-0.036000315865158825,-0.036925313467861404,45978624,2020-12-31,4013,4489,8502
4036,DNZ,-0.4482801072520318,-0.0006040281114136481,355421888,2020-12-31,4846,3656,8502
4037,HP,-0.028904733152746057,-0.0403033890677094,2784816128,2020-09-30,3981,4522,8503
4038,KNDI,-0.048204906849279895,-0.03286207814426267,466649248,2020-12-31,4075,4436,8511
4039,SKYW,-0.03603743377794763,-0.03790675251182904,2716442880,2020-12-31,4014,4498,8512
4040,LACQ,-0.10839583249196043,-0.016837830154828856,80293080,2020-12-31,4315,4198,8513
4041,BHFAP,-0.005166422440862466,-0.06512524859099023,4619104256,2020-12-31,3743,4772,8515
4042,EQC,-0.052749054004568675,-0.031859343381313146,3430388992,2020-12-31,4098,4424,8522
4043,MRNA,-0.14107947024764667,-0.013110876249529434,56441982976,2020-12-31,4416,4106,8522
4044,EDN,-0.016724296097664244,-0.051156619744560226,261315120,2020-12-31,3882,4642,8524
4045,CCXI,-0.11647425626996138,-0.01584027117134103,3445976832,2020-12-31,4356,4174,8530
4046,CDOR,-0.034606383694587545,-0.04030743552660879,42971860,2020-12-31,4008,4523,8531
4047,SCOR,-0.07626133884487311,-0.026050104762714736,278643072,2020-12-31,4201,4334,8535
4048,ITI,-0.10040259789585627,-0.01966859909753756,256506096,2020-03-31,4288,4247,8535
4049,GROW,-0.14260281288944276,-0.013465979187054297,178376704,2020-06-30,4423,4113,8536
4050,BHF,-0.005166422440862466,-0.06722488362158893,4027298048,2020-12-31,3743,4798,8541
4051,PCT,-0.13242805678939637,-0.014275231676448076,3186057728,2020-12-31,4401,4140,8541
4052,XNET,-0.06056601355144111,-0.031090982884371947,454786720,2020-12-31,4130,4413,8543
4053,TXG,-0.2976125639128915,-0.003550735451210724,21167683584,2020-12-31,4695,3849,8544
4054,HUIZ,-0.03716826345845162,-0.040784040285659975,429514048,2020-12-31,4020,4527,8547
4055,TRCH,-0.1286793131272195,-0.015069827952077721,268830912,2020-12-31,4388,4159,8547
4056,RPAY,-0.14038726364720933,-0.013942522200220873,1950354176,2020-12-31,4414,4134,8548
4057,CLDT,-0.03795859638213805,-0.04057537453003302,634293952,2020-12-31,4025,4525,8550
4058,LOTZ,-0.23069153592350683,-0.007238323818860207,909360000,2020-12-31,4589,3964,8553
4059,DSGN,-0.2544443765654591,-0.005630770847256479,1479420160,2020-12-31,4634,3920,8554
4060,LVS,-0.07902108211705734,-0.026180057495157432,47313797120,2020-12-31,4215,4341,8556
4061,RPD,-0.1335317042342532,-0.01498935410018928,4177591808,2020-12-31,4403,4157,8560
4062,XPL,-0.06458613655106558,-0.03118947345209871,48139404,2020-12-31,4147,4418,8565
4063,SND,-0.020821846000924755,-0.05348005875249015,109828560,2020-12-31,3909,4659,8568
4064,LLNW,-0.07778732510821809,-0.027451062121528542,444403296,2020-12-31,4206,4363,8569
4065,RDCM,-0.05837017032064103,-0.033817293092043677,134136808,2020-12-31,4124,4446,8570
4066,KIQ,-0.10624691781276242,-0.020716592397371225,49187744,2020-12-31,4305,4265,8570
4067,PLG,-0.13791217377715267,-0.015395951063171398,304378592,2020-08-31,4409,4163,8572
4068,COUR,-0.21185952608987554,-0.00942727415234648,6989039104,2020-12-31,4555,4018,8573
4069,BLDP,-0.25128569452652494,-0.006465467834225541,6893258240,2020-12-31,4629,3944,8573
4070,BA,-0.07183984336109912,-0.03008661579260893,147287392256,2020-12-31,4179,4398,8577
4071,FTHM,-0.3808074397314015,-0.0025620505098055153,475295680,2020-12-31,4778,3799,8577
4072,CERT,-0.2841652547895217,-0.005162612764849967,4124313856,2020-12-31,4670,3908,8578
4073,INCY,-0.14879855717069265,-0.01444824016365791,17578725376,2020-12-31,4437,4144,8581
4074,CEIX,-0.02439681508553741,-0.051405732335264145,315135296,2020-12-31,3941,4643,8584
4075,ARYD,-0.5664932565307745,-0.00019470000854499928,208557248,2020-12-31,4966,3618,8584
4076,LPSN,-0.15792136163127496,-0.013848157877892073,3852170240,2020-12-31,4456,4129,8585
4077,SCWX,-0.08354175306650519,-0.027176337018506982,1134180224,2021-01-29,4233,4356,8589
4078,ALYA,-0.08080518437804668,-0.028461976213787134,191120864,2020-03-31,4222,4374,8596
4079,DASH,-0.2256787330316742,-0.009449895108153751,45165690880,2020-12-31,4578,4020,8598
4080,IMGN,-0.14549138945565204,-0.01560995348193517,1509973888,2020-12-31,4432,4167,8599
4081,SVFA,-0.5332496670265549,-0.0006632916741575212,783366144,2020-12-31,4939,3661,8600
4082,MASS,-0.3127016562701656,-0.0046229383602918615,1391920000,2020-12-31,4713,3888,8601
4083,MXL,-0.14216020936451043,-0.016117759995739687,2652264960,2020-12-31,4421,4181,8602
4084,CRHM,-0.12859699202293728,-0.01792837886484925,283878432,2020-12-31,4387,4217,8604
4085,LMNR,-0.05127096926124479,-0.040106183037562984,307894112,2020-10-31,4088,4519,8607
4086,GP,-0.26989861633381396,-0.00700764865737636,447435392,2020-03-31,4649,3958,8607
4087,LASR,-0.1501907138145631,-0.015683446818758506,1396379776,2020-12-31,4440,4169,8609
4088,EVER,-0.2352706211304174,-0.009074760457330642,1034507712,2020-12-31,4599,4010,8609
4089,SHI,-0.019154163998322697,-0.058516056972238197,4948164096,2020-12-31,3899,4711,8610
4090,SE,-0.2256821850423356,-0.009972640831608957,130380464128,2020-12-31,4579,4031,8610
4091,UIS,-0.053176966989327376,-0.03937018349677175,1616174208,2020-12-31,4101,4511,8612
4092,MCF,-0.10361103842515247,-0.024825172430656142,728878080,2020-12-31,4295,4320,8615
4093,PLT,-0.11080431416723184,-0.022045431022810823,1547637888,2020-03-28,4330,4286,8616
4094,KIDS,-0.12620863407326705,-0.018886617137312267,974068736,2020-12-31,4384,4232,8616
4095,NCNO,-0.282961103473924,-0.006650628313115042,6662345728,2021-01-31,4666,3950,8616
4096,CSPI,-0.04953215764026575,-0.04178823109596092,37878580,2020-09-30,4083,4537,8620
4097,CSTL,-0.29545454545454547,-0.006252632280997309,1736248576,2020-12-31,4690,3935,8625
4098,NSYS,-0.04595498105638511,-0.044416947008255825,18046722,2020-12-31,4062,4565,8627
4099,GSV,-0.03741070351873044,-0.04722786844842566,212361296,2020-12-31,4021,4607,8628
4100,WLDN,-0.11101761011452732,-0.022793377954396545,518127296,2021-01-01,4331,4297,8628
4101,TMQ,-0.06625364306286395,-0.035828022223567006,333038496,2020-11-30,4155,4476,8631
4102,SNAP,-0.2534778868156229,-0.008763736853899178,95430139904,2020-12-31,4631,4000,8631
4103,FSLY,-0.22799964928036048,-0.010990343494756053,7776756224,2020-12-31,4582,4055,8637
4104,ANDA,-0.09444396417024897,-0.027888327141164106,45186932,2020-12-31,4270,4368,8638
4105,WORK,-0.226152087889494,-0.011324507284073948,24597852160,2021-01-31,4580,4061,8641
4106,ERJ,-0.032674439478805786,-0.05149498404013676,2046609280,2020-12-31,3998,4644,8642
4107,NEW,-0.03821303169354907,-0.04863530406205761,326304480,2020-12-31,4028,4616,8644
4108,ALKS,-0.07880373260548508,-0.032435963295064985,3028706816,2020-12-31,4213,4434,8647
4109,TMKR,-0.5735897079713035,-0.0007605034242260207,336375008,2020-12-31,4972,3675,8647
4110,JCS,-0.057134757062856485,-0.041067344380879826,54659560,2020-12-31,4118,4531,8649
4111,MDB,-0.23476443807351027,-0.010961956175999734,18231099392,2021-01-31,4598,4054,8652
4112,FEYE,-0.11986942036654717,-0.022496994536234962,4680978944,2020-12-31,4362,4292,8654
4113,GME,-0.12968839411122093,-0.020534735598638866,11090204672,2021-01-30,4394,4262,8656
4114,GH,-0.17368804241437874,-0.015497937081205792,15784111104,2020-12-31,4492,4165,8657
4115,RADI,-0.10529750846710939,-0.02747735301406843,949357824,2020-12-31,4300,4364,8664
4116,ATHA,-0.09181283864450362,-0.03066542753903176,708257216,2020-12-31,4261,4405,8666
4117,BOAS,-0.70725,-2.0123848022181587e-05,281175008,2020-12-31,5076,3590,8666
4118,HPK,-0.056172507983807164,-0.04354401543860894,667266496,2020-12-31,4113,4557,8670
4119,WPRT,-0.12314636334141267,-0.02319817233850865,985811648,2020-12-31,4368,4303,8671
4120,XM,-0.18564376614037284,-0.014825948773202622,16439492608,2020-12-31,4519,4152,8671
4121,GRNQ,-0.1692075287981684,-0.016778168592283548,167689440,2020-12-31,4480,4193,8673
4122,CNNE,-0.04267895737312189,-0.049527527093751154,3750370816,2020-12-31,4053,4623,8676
4123,ADN,-0.48405186170497605,-0.002136595895548636,631650816,2020-12-31,4896,3780,8676
4124,ABGI,-0.5457133696697659,-0.0015434179009728994,192746032,2020-12-31,4949,3728,8677
4125,GPRK,-0.0788855649610081,-0.03498438259139657,963695296,2020-12-31,4214,4464,8678
4126,SNMP,-0.041013918642363895,-0.050730781571566186,56185400,2020-12-31,4043,4637,8680
4127,KYMR,-0.10248714594635272,-0.029341436476938237,1498496512,2020-12-31,4294,4387,8681
4128,U,-0.2593936188357221,-0.01030907308507857,27028942848,2020-12-31,4640,4042,8682
4129,CLDR,-0.112003682710326,-0.026541283682975283,3686197248,2021-01-31,4335,4348,8683
4130,GRUB,-0.16650508159683727,-0.01740538338456758,6111065600,2020-12-31,4473,4213,8686
4131,CHRA,-0.09360318634991643,-0.031626676185742726,159418704,2020-12-31,4267,4422,8689
4132,ITP,-0.026913991986051263,-0.061005670097058075,70635688,2020-12-31,3960,4733,8693
4133,RSSS,-0.2306411504239095,-0.013101543788925954,64380368,2020-06-30,4588,4105,8693
4134,PD,-0.1726833650300906,-0.01714197489927015,3492584704,2021-01-31,4488,4206,8694
4135,SPT,-0.27299870333720055,-0.010058418712530551,3232551424,2020-12-31,4659,4035,8694
4136,INN,-0.04851810949086074,-0.04901305096579904,1054975744,2020-12-31,4076,4619,8695
4137,FRD,-0.048925440570592,-0.04942185419450561,58285372,2020-03-31,4078,4621,8699
4138,OPEN,-0.216594127672331,-0.013910753519990661,12102683648,2020-12-31,4567,4132,8699
4139,FARM,-0.0529310601846297,-0.04770263481594267,176290304,2020-06-30,4099,4611,8710
4140,AI,-0.26853030763972613,-0.011517257470707873,6159879680,2020-04-30,4645,4068,8713
4141,USAP,-0.031724375538329026,-0.05933590084398746,88770296,2020-12-31,3994,4720,8714
4142,CSII,-0.17922183129353272,-0.01721049922272242,1452133376,2020-06-30,4507,4207,8714
4143,BBQ,-0.06019829443669355,-0.045495832701516095,129373416,2021-01-03,4128,4587,8715
4144,VET,-0.045765291579703514,-0.05298321501180096,1100608896,2020-12-31,4061,4655,8716
4145,GPRE,-0.0643656901770398,-0.04472042320346052,1232472448,2020-12-31,4143,4574,8717
4146,WTT,-0.08260482434838919,-0.03731047248841657,39205140,2020-12-31,4228,4490,8718
4147,BJRI,-0.06599550741640066,-0.04463669931591983,1382712448,2020-12-29,4153,4570,8723
4148,GLPG,-0.05321184379968168,-0.04971149798896853,5093286912,2020-12-31,4102,4626,8728
4149,LAC,-0.18225688188117067,-0.01804097586392559,1790362880,2020-12-31,4514,4221,8735
4150,QUOT,-0.17765913616699855,-0.01895749064182498,1561802752,2020-12-31,4501,4235,8736
4151,CENX,-0.06763569148042346,-0.04493859857847099,1344533120,2020-12-31,4162,4577,8739
4152,RLAY,-0.16133845335307317,-0.02140945668640524,3040152064,2020-12-31,4464,4277,8741
4153,DT,-0.2957785249074648,-0.010859763790303534,14946395136,2020-03-31,4691,4051,8742
4154,RHP,-0.08303196422241399,-0.03942903201186986,4219024384,2020-12-31,4231,4513,8744
4155,EVBG,-0.24988582793164407,-0.013551899198774664,4796033536,2020-12-31,4626,4118,8744
4156,QTWO,-0.2406385689546555,-0.014157240571432679,5721188864,2020-12-31,4609,4137,8746
4157,BORR,-0.04131810808231814,-0.05774321363346808,266515008,2020-12-31,4045,4704,8749
4158,ASM,-0.08487427044128075,-0.03965506684036515,124406096,2020-12-31,4236,4515,8751
4159,TPHS,-0.05351803514011954,-0.05187511766117769,67805032,2020-12-31,4106,4648,8754
4160,HALL,-0.060870592839278,-0.04971633114641182,67488984,2020-12-31,4131,4627,8758
4161,MGNI,-0.3942393465527433,-0.0072664611370261084,4643602432,2020-12-31,4797,3965,8762
4162,MBI,-0.049284290632360936,-0.05610953489525908,545660928,2020-12-31,4082,4683,8765
4163,LODE,-0.135575855136007,-0.02739708209262849,197418080,2020-12-31,4405,4362,8767
4164,VOLT,-0.06337778064766086,-0.04979768390794567,89989520,2020-11-01,4140,4629,8769
4165,VRNS,-0.26783601260808276,-0.013764822752233528,5506152960,2020-12-31,4644,4125,8769
4166,PHR,-0.30324226563342155,-0.01145033000431775,2374317312,2021-01-31,4705,4065,8770
4167,PEB,-0.05172707602161017,-0.05585422730422896,3162362112,2020-12-31,4090,4681,8771
4168,ZNH,-0.02374062150765349,-0.07249393289324843,14790688768,2020-12-31,3933,4842,8775
4169,AAU,-0.054593142276083764,-0.05427085911485681,73197544,2020-12-31,4110,4665,8775
4170,PSTG,-0.11697001938486767,-0.03195344756865101,6066470912,2021-01-31,4358,4426,8784
4171,BENE,-0.7763704630788486,-0.0010161402224233185,152512512,2020-12-31,5097,3689,8786
4172,GRPN,-0.07441428786898777,-0.04647152562338183,1412609536,2020-12-31,4192,4597,8789
4173,ARWR,-0.26114725413869894,-0.014675827078133528,6450673152,2020-09-30,4641,4148,8789
4174,RLJ,-0.053397365915541575,-0.056189226917469186,2551281408,2020-12-31,4105,4685,8790
4175,BNTX,-0.32648337079484885,-0.011215912205397756,29499373568,2020-12-31,4731,4059,8790
4176,YRD,-0.011841254857083853,-0.08931448560879779,362873408,2020-12-31,3829,4966,8795
4177,SMAR,-0.24970483444608135,-0.015781494943837498,7706319872,2021-01-31,4624,4171,8795
4178,SEER,-0.3156004089327418,-0.011842913761701882,3166768128,2020-12-31,4717,4079,8796
4179,UIHC,-0.06786749097795972,-0.05027525559793608,317550464,2020-12-31,4163,4634,8797
4180,UUUU,-0.1514715379647569,-0.027164671930182273,914435904,2020-12-31,4446,4355,8801
4181,ONE,-0.039949488835519166,-0.06462601571169158,390415008,2020-08-31,4039,4767,8806
4182,SVFB,-0.8623312883435583,-0.0006860470645596905,307199104,2020-12-31,5143,3663,8806
4183,VVNT,-0.10737081220654891,-0.038089762624778985,2840557568,2020-12-31,4308,4501,8809
4184,KVHI,-0.08255785417233215,-0.045309853876503894,244563456,2020-12-31,4227,4584,8811
4185,PAR,-0.30796581376667503,-0.012963702940001083,1838842880,2020-12-31,4708,4104,8812
4186,MRO,-0.05191387559808613,-0.05986281539289814,8608819200,2020-12-31,4092,4725,8817
4187,EMKR,-0.10989177708101547,-0.037439839966307245,227008112,2020-09-30,4326,4491,8817
4188,PLM,-0.04629798801274482,-0.06267769589803905,295945440,2020-12-31,4065,4754,8819
4189,UGRO,-0.17354701692065558,-0.025559758496974082,92039256,2020-12-31,4491,4328,8819
4190,LSPD,-0.5060559137960292,-0.005221657053656767,9248376832,2020-03-31,4910,3911,8821
4191,SVFC,-0.9249570552147239,-0.0005374503831216169,420660000,2020-12-31,5171,3651,8822
4192,SWAV,-0.2982607550203722,-0.013788158294990048,4773797888,2020-12-31,4697,4127,8824
4193,AXGN,-0.15882107109335927,-0.02804954150627456,817878272,2020-12-31,4458,4371,8829
4194,ARKR,-0.05408431073086105,-0.05979056140870136,72692224,2020-10-03,4108,4724,8832
4195,LTRX,-0.15750568612585292,-0.028944534720122303,131790416,2020-06-30,4455,4378,8833
4196,MDLA,-0.18692110395514946,-0.023761978101298355,4610676736,2021-01-31,4522,4311,8833
4197,FORA,-0.36653736047959673,-0.011488377547401915,358031840,2020-12-31,4768,4066,8834
4198,EMAN,-0.18207902287504277,-0.024890502659329083,270964160,2020-12-31,4513,4322,8835
4199,NUVB,-0.22937756101671705,-0.020143698319626202,2185220096,2020-12-31,4584,4253,8837
4200,ORLA,-0.15171282075240308,-0.02958842146970759,872330368,2020-12-31,4447,4391,8838
4201,CDZI,-0.18055022196279627,-0.025585283940230897,384963712,2020-12-31,4511,4329,8840
4202,PDD,-0.11527041286870676,-0.03777464899344768,172429606912,2020-12-31,4349,4497,8846
4203,PAYS,-0.14493498018414838,-0.03132549441549214,209844592,2020-12-31,4431,4420,8851
4204,PLYA,-0.07112152856391665,-0.05608047833205896,1162430080,2020-12-31,4175,4682,8857
4205,ADPT,-0.17758185519857206,-0.027244802226871898,5627272192,2020-12-31,4500,4358,8858
4206,PK,-0.06038445465942332,-0.06107239205045161,5072178176,2020-12-31,4129,4734,8863
4207,AOUT,-0.13109531282497305,-0.0352285878321174,372482176,2020-04-30,4399,4468,8867
4208,DRH,-0.06302502124803624,-0.06054155481373371,2140084736,2020-12-31,4139,4729,8868
4209,GKOS,-0.2056154671859008,-0.025031094058039015,3806206720,2020-12-31,4547,4323,8870
4210,WYNN,-0.10193590872425148,-0.045001165599396806,15193939968,2020-12-31,4293,4578,8871
4211,SSYS,-0.10987894914364951,-0.04273988696342921,1511911680,2020-12-31,4325,4547,8872
4212,XNCR,-0.1481480042504502,-0.033120534888325955,2345042432,2020-12-31,4435,4437,8872
4213,PHX,-0.05714259806067672,-0.0632946855390372,58984320,2020-09-30,4119,4756,8875
4214,PLAN,-0.27006014839531106,-0.01852597916373405,8216526848,2021-01-31,4651,4227,8878
4215,FOSL,-0.06729645117704387,-0.05925878920254008,669832832,2021-01-02,4160,4719,8879
4216,SXTC,-0.10794616491720865,-0.04471585851109448,24978184,2020-03-31,4310,4573,8883
4217,ENTA,-0.1058805280930876,-0.04516723416038391,983380096,2020-09-30,4303,4581,8884
4218,PACB,-0.299233553331914,-0.016417264832690823,6035885568,2020-12-31,4699,4186,8885
4219,FATE,-0.2853772166113001,-0.017709927287857162,7314167296,2020-12-31,4672,4215,8887
4220,ITMR,-0.20776566757493187,-0.026257099798248244,386464800,2020-12-31,4551,4342,8893
4221,KOS,-0.061187440823448874,-0.06389709584849197,1133806336,2020-12-31,4133,4761,8894
4222,SEAS,-0.11968348747746235,-0.04111914037093597,3920734208,2020-12-31,4361,4533,8894
4223,KRTX,-0.2377022389279294,-0.02243040123695528,3158756352,2020-12-31,4604,4291,8895
4224,VEI,-0.08291647647954475,-0.054323537504756554,912895296,2020-12-31,4230,4666,8896
4225,REPH,-0.11453756590509666,-0.04316836552624628,101103360,2020-12-31,4345,4555,8900
4226,TSRI,-0.10791570686516681,-0.04632903363997741,17795884,2020-05-31,4309,4594,8903
4227,INFN,-0.12934834782831037,-0.03943218537418099,2040521856,2020-12-26,4392,4514,8906
4228,FOUR,-0.5227272727272727,-0.00799276740205738,8168044544,2020-12-31,4927,3980,8907
4229,SOHON,-0.06873179877082396,-0.06192259774735958,78046232,2020-12-31,4165,4743,8908
4230,SOHOO,-0.06873179877082396,-0.062129695309372145,76447520,2020-12-31,4165,4746,8911
4231,MNKD,-0.25484550922831734,-0.021393709848447632,1033644096,2020-12-31,4635,4276,8911
4232,SOHOB,-0.06873179877082396,-0.062135523867772526,76402680,2020-12-31,4165,4747,8912
4233,CPHI,-0.09999984873735837,-0.04993449698735335,40283252,2020-12-31,4283,4631,8914
4234,YPF,-0.03791702098040498,-0.08024187035219656,1581118208,2020-12-31,4024,4897,8921
4235,NTRA,-0.2483176783559461,-0.02290708266774703,9088612352,2020-12-31,4622,4300,8922
4236,ESTC,-0.397454831433844,-0.013769451563475272,11096724480,2020-04-30,4800,4126,8926
4237,H,-0.0884287113474185,-0.05582878461125996,8566325248,2020-12-31,4248,4680,8928
4238,TATT,-0.047652498211913766,-0.07494904429221344,45236488,2020-12-31,4073,4859,8932
4239,ACTG,-0.05878154335432459,-0.06907962746862516,323273504,2020-12-31,4125,4812,8937
4240,GSM,-0.07555049703066628,-0.061829097949231804,620817216,2020-12-31,4196,4742,8938
4241,BHR,-0.06146905408887918,-0.06806379104044974,260315552,2020-12-31,4135,4805,8940
4242,TMDX,-0.2090003881526311,-0.029604155547342553,869271232,2020-12-31,4553,4392,8945
4243,DNOW,-0.10690423162583519,-0.05085619799741854,1058837760,2020-12-31,4306,4641,8947
4244,SOGO,-0.14110368919918856,-0.04111383901084692,3289952768,2020-12-31,4417,4532,8949
4245,SOHO,-0.06873179877082396,-0.0663141475278578,46284360,2020-12-31,4165,4787,8952
4246,EQH,-0.013651670513451133,-0.11691214387207803,14238780416,2020-12-31,3849,5104,8953
4247,STXS,-0.4566091679636248,-0.01255244806535775,564254080,2020-12-31,4861,4092,8953
4248,GEVO,-0.35794082125603865,-0.016805652676933694,1625010304,2020-12-31,4758,4196,8954
4249,DLCA,-0.8679787196110809,-0.0027563590946555485,255645008,2020-12-31,5147,3811,8958
4250,PLRX,-0.1716463125615672,-0.03552594113178638,1211524992,2020-12-31,4487,4472,8959
4251,CDXS,-0.36068638981875206,-0.016827522776586733,1545616768,2020-12-31,4762,4197,8959
4252,FLXS,-0.10010228435049437,-0.05576989658407242,284281888,2020-06-30,4284,4677,8961
4253,JAX,-0.06095530300455854,-0.07057254727461368,152108208,2021-01-03,4132,4830,8962
4254,HST,-0.08756199923693248,-0.0591951443750536,12231028736,2020-12-31,4246,4717,8963
4255,OSH,-0.4740764752476283,-0.012088996491028046,15094899712,2020-12-31,4883,4082,8965
4256,UAMY,-0.23451175524286458,-0.027912109602730686,114108000,2020-12-31,4597,4369,8966
4257,CDLX,-0.4203351789353819,-0.014615600614283537,3523270912,2020-12-31,4820,4146,8966
4258,MGM,-0.07424974764649464,-0.06587564740887084,20676317184,2020-12-31,4190,4780,8970
4259,BBW,-0.061419570823473435,-0.07194387666989217,143802304,2021-01-30,4134,4837,8971
4260,XHR,-0.07865781907731127,-0.0641128555537834,2171380224,2020-12-31,4211,4762,8973
4261,TIL,-0.4760451267319029,-0.0122554124216996,2824510464,2020-12-31,4888,4085,8973
4262,GTE,-0.06862677552846438,-0.06898229849050948,239999952,2020-12-31,4164,4811,8975
4263,PFIE,-0.09155119696030425,-0.05937976836999359,58606084,2020-12-31,4259,4721,8980
4264,UFCS,-0.05333745966636111,-0.07791906533806486,848292288,2020-12-31,4103,4878,8981
4265,NETI,-0.041295045439026776,-0.08516893665395746,241382096,2020-12-31,4044,4939,8983
4266,BSQR,-0.1419710544452102,-0.04438458404175503,42421260,2020-12-31,4419,4564,8983
4267,PS,-0.2022379092820667,-0.03332932388043972,3334610944,2020-12-31,4544,4439,8983
4268,X,-0.08261777674634486,-0.06346048477615485,5918580224,2020-12-31,4229,4757,8986
4269,TMST,-0.06208985360928824,-0.07447484336668918,543125760,2020-12-31,4136,4854,8990
4270,CDMOP,-0.12249597852125309,-0.04964614237138455,204990912,2020-04-30,4365,4625,8990
4271,M,-0.07353061058123421,-0.06781950416229982,5215008768,2021-01-30,4187,4804,8991
4272,XONE,-0.28832831325301206,-0.024720787453858833,640799552,2020-12-31,4675,4318,8993
4273,PLL,-0.6681131157943021,-0.006631233297501196,994150144,2020-06-30,5046,3948,8994
4274,FURY,-0.06456493437950811,-0.0737999366165122,153253120,2020-12-31,4146,4852,8998
4275,PI,-0.23778058897943574,-0.029787235874297477,1298175488,2020-12-31,4605,4395,9000
4276,SVMK,-0.2539051679868038,-0.028064666771607096,2688782592,2020-12-31,4632,4372,9004
4277,SMHI,-0.05535323497691172,-0.08035241342814804,118253832,2020-12-31,4111,4899,9010
4278,IPA,-0.40766405602066114,-0.016895256868473305,236550864,2020-04-30,4810,4200,9010
4279,STTK,-0.19505535133307983,-0.03556985490712245,1179330816,2020-12-31,4538,4473,9011
4280,UBER,-0.18874009047341783,-0.03625405122968847,107337285632,2020-12-31,4529,4483,9012
4281,QUMU,-0.19141599745928042,-0.03650911459261782,103782184,2020-12-31,4534,4486,9020
4282,TWST,-0.3933197297116478,-0.01844002944723666,6432526336,2020-09-30,4795,4226,9021
4283,FENG,-0.03658150238611892,-0.0959618539856168,126859224,2020-12-31,4017,5005,9022
4284,BIGC,-0.6176400172378018,-0.009616038503173803,4197774336,2020-12-31,5000,4024,9024
4285,TLND,-0.24496697672810264,-0.030893508936500204,2093336064,2020-12-31,4617,4409,9026
4286,HT,-0.06497308237117272,-0.07793837494583422,409323872,2020-12-31,4149,4879,9028
4287,TUYA,-0.7931727591728273,-0.005633200092733219,12465855488,2020-12-31,5109,3921,9030
4288,CPS,-0.0776807601630369,-0.07049744568128771,549662656,2020-12-31,4205,4827,9032
4289,NTLA,-0.270011189264632,-0.029131989923045835,4784185856,2020-12-31,4650,4383,9033
4290,AXR,-0.06447230126381091,-0.0794472518263707,73820448,2020-04-30,4145,4890,9035
4291,QTRX,-0.5120793787748059,-0.013678553659254302,2398013696,2020-12-31,4914,4122,9036
4292,CAAP,-0.15119038391595466,-0.046455060201910814,783470464,2020-12-31,4445,4595,9040
4293,MORF,-0.34566634918309036,-0.02278107263271522,2133626496,2020-12-31,4745,4296,9041
4294,DRRX,-0.27139537885633147,-0.029361059222450445,420323712,2020-12-31,4654,4388,9042
4295,MWK,-0.33815503044452155,-0.023234558334424775,838137280,2020-12-31,4739,4304,9043
4296,ZUO,-0.2325849506568112,-0.03390843095116475,1986819968,2021-01-31,4596,4448,9044
4297,OTRK,-0.31603803553654247,-0.025245942818134068,595882880,2020-12-31,4719,4325,9044
4298,IEP,-0.08526306039273805,-0.0695670078331281,13606693888,2020-12-31,4237,4815,9052
4299,AIRG,-0.460714802488786,-0.016576685391796,223394000,2020-12-31,4864,4189,9053
4300,KMPH,-0.5202960060942431,-0.014443448289929557,259643136,2020-12-31,4924,4143,9067
4301,VIST,-0.052092737939821006,-0.09137440917294337,242924560,2020-12-31,4093,4975,9068
4302,SIBN,-0.23553430753502916,-0.035469932089574295,1104887040,2020-12-31,4600,4470,9070
4303,INSP,-0.6734561836524406,-0.009443684800108262,6096961024,2020-12-31,5051,4019,9070
4304,TRVG,-0.25511138553333007,-0.033194228346178446,1430790272,2020-12-31,4636,4438,9074
4305,BATRK,-0.11636363636363636,-0.05943522803825976,1520604928,2020-12-31,4354,4722,9076
4306,AMPG,-0.5245697529909684,-0.014467969777914785,61455052,2020-12-31,4931,4145,9076
4307,LBRT,-0.09934825682849674,-0.06684486651144678,1946224384,2020-12-31,4281,4796,9077
4308,BATRA,-0.11636363636363636,-0.059672683990502136,1512035072,2020-12-31,4354,4723,9077
4309,AUUD,-0.16254523911114932,-0.04790889262283368,34439988,2020-12-31,4466,4613,9079
4310,TPTX,-0.22382907824388149,-0.03872525200917105,3866962944,2020-12-31,4575,4504,9079
4311,GLDG,-0.17637733276840062,-0.04538415951373888,246081712,2020-11-30,4496,4585,9081
4312,MPLN,-0.6251984102570413,-0.011620582895125336,4180775168,2020-12-31,5010,4072,9082
4313,EXPE,-0.189289698772778,-0.04309603275689182,25173495808,2020-12-31,4530,4553,9083
4314,NH,-0.18711076593936374,-0.04398666134550584,365948096,2020-12-31,4523,4561,9084
4315,NNDM,-0.3460956739252681,-0.026110788659251722,1945788032,2020-12-31,4746,4338,9084
4316,SY,-0.02756916361769048,-0.1209456869855819,1024940864,2020-12-31,3969,5121,9090
4317,CEA,-0.0413532827553775,-0.10283691094867009,12217131008,2020-12-31,4046,5046,9092
4318,NBR,-0.06534989792651541,-0.08579632029219512,651986048,2020-12-31,4151,4945,9096
4319,AEHR,-0.17927585235277543,-0.0457711684730062,56144688,2020-05-31,4508,4589,9097
4320,ALLK,-0.31507118626386965,-0.02912454047603156,5577327104,2020-12-31,4715,4382,9097
4321,CJJD,-0.09105459300944145,-0.07213632247103442,43004352,2020-03-31,4258,4840,9098
4322,SPLK,-0.29918840503031713,-0.030318980635985652,23309375488,2021-01-31,4698,4402,9100
4323,HMHC,-0.11318697436016195,-0.06448582243608951,923722496,2020-12-31,4337,4764,9101
4324,JWN,-0.10529012424747022,-0.06764766396756153,5943195648,2021-01-30,4299,4803,9102
4325,SIX,-0.1745526118695437,-0.04748823306925752,4001620736,2020-12-31,4493,4609,9102
4326,QK,-0.08885357751007719,-0.07445074142655518,117752824,2020-09-30,4251,4853,9104
4327,ZLAB,-0.38522492440400746,-0.025187941901488754,12326036480,2020-12-31,4782,4324,9106
4328,FWONA,-0.2723926380368098,-0.03420407634493806,10422908928,2020-12-31,4657,4452,9109
4329,INSG,-0.45050416816999295,-0.020478289422347196,957651200,2020-12-31,4849,4260,9109
4330,ESTA,-0.48524248218320876,-0.01728022697091586,1624279040,2020-12-31,4898,4211,9109
4331,MLCO,-0.12533580194650093,-0.061172461897761606,9687625728,2020-12-31,4376,4735,9111
4332,IFMK,-0.070567642670193,-0.08517176749253202,54410100,2020-03-31,4172,4940,9112
4333,FWONK,-0.2723926380368098,-0.03426766659857754,10398820352,2020-12-31,4657,4455,9112
4334,WPP,-0.13983372514448036,-0.05768014198098289,15827417088,2020-12-31,4412,4703,9115
4335,VERX,-0.2719581726806871,-0.034602840974521966,3034042880,2020-12-31,4655,4461,9116
4336,DS,-0.07706885088715112,-0.08210890674824001,309477504,2020-12-31,4203,4916,9119
4337,CSLT,-0.1903415858093408,-0.045663436471896454,277414720,2020-12-31,4532,4588,9120
4338,SILK,-0.3977529137529138,-0.02477721059881145,1723081088,2020-12-31,4801,4319,9120
4339,MEIP,-0.12587197373820272,-0.061647554250098956,387096320,2020-06-30,4381,4740,9121
4340,HCAT,-0.2848588474705072,-0.033973917401507334,2129890432,2020-12-31,4671,4450,9121
4341,SHO,-0.09093802838773679,-0.07549320734371875,2647629056,2020-12-31,4256,4866,9122
4342,RCL,-0.09764810479620485,-0.07283228701802989,22879762432,2020-12-31,4279,4845,9124
4343,CLRO,-0.11465941905894343,-0.06579792181244323,55013096,2020-12-31,4346,4779,9125
4344,GDYN,-0.471894893674658,-0.01970935311651544,806502464,2020-12-31,4878,4248,9126
4345,NOV,-0.09322625698324022,-0.07531010501173348,5081681920,2020-12-31,4265,4862,9127
4346,PRPH,-0.21329550928651717,-0.04453324819902404,80014704,2020-12-31,4559,4569,9128
4347,GVP,-0.09459654178674351,-0.07513177243118291,30725886,2020-12-31,4271,4860,9131
4348,PRO,-0.2923363460611128,-0.033914938673168436,1911591936,2020-12-31,4683,4449,9132
4349,NRP,-0.06510759395807193,-0.09238722066197916,203026272,2020-12-31,4150,4983,9133
4350,VCYT,-0.7802017414473997,-0.010278966261072124,3522268928,2020-12-31,5100,4040,9140
4351,GAU,-0.10602130915517749,-0.07200298656502437,263482832,2020-12-31,4304,4838,9142
4352,BLI,-0.6436367692283178,-0.013763596381326513,3130982400,2020-12-31,5020,4124,9144
4353,GOL,-0.09052295317069417,-0.07983787172315879,1470925440,2020-12-31,4253,4893,9146
4354,KRON,-0.2237582159171951,-0.04486221420016484,1528981248,2020-12-31,4574,4575,9149
4355,TDUP,-0.3852559331844869,-0.027564148575878553,1660933760,2020-12-31,4783,4366,9149
4356,BWAY,-0.29682217714672077,-0.03447881539900864,150218016,2020-12-31,4693,4457,9150
4357,OLB,-0.5596920838427815,-0.016601890659340944,39638512,2020-12-31,4962,4190,9152
4358,CRIS,-0.4041883116883117,-0.026681974991687202,1052336320,2020-12-31,4805,4350,9155
4359,POWW,-0.4883862531852197,-0.020219907367952154,676620160,2020-03-31,4900,4255,9155
4360,AMR,-0.06469987871641661,-0.09674098363479898,260941328,2020-12-31,4148,5010,9158
4361,VERY,-0.04437737100281838,-0.11606999865628667,212563744,2020-12-31,4058,5101,9159
4362,IDYA,-0.15688990096724506,-0.058199863468758495,640683648,2020-12-31,4454,4708,9162
4363,URG,-0.16694822990577016,-0.05619063150840067,225387920,2020-12-31,4476,4686,9162
4364,HOFV,-0.11179913355243712,-0.07069554890735612,335636960,2020-12-31,4333,4831,9164
4365,RVMD,-0.2952148299468492,-0.036008756380221926,3131260928,2020-12-31,4689,4478,9167
4366,EWTX,-0.6977272727272728,-0.012703796772923492,1453870208,2020-12-31,5071,4096,9167
4367,CGEN,-0.24272503082614058,-0.043514465658498654,720425280,2020-12-31,4613,4556,9169
4368,MVIS,-1.1092271293375395,-0.006277912384035376,2246077440,2020-12-31,5230,3939,9169
4369,YEXT,-0.20635750521187674,-0.04927662301876027,1884585728,2021-01-31,4550,4620,9170
4370,CUTR,-0.2835713274017228,-0.03868781227984153,558383040,2020-12-31,4668,4503,9171
4371,AXU,-0.15048684343519422,-0.06064020064349807,376643040,2020-12-31,4443,4730,9173
4372,ASAN,-0.3803098504902067,-0.030209077616888402,5527462912,2021-01-31,4776,4400,9176
4373,AHT,-0.09342360030312956,-0.08168973339882186,278299360,2020-12-31,4266,4911,9177
4374,NBEV,-0.1441772655007949,-0.06240521736500721,346756960,2020-12-31,4426,4751,9177
4375,RGS,-0.07140174622718891,-0.09557521111104808,498837344,2020-06-30,4177,5002,9179
4376,LIND,-0.13560471252377737,-0.06526587224549048,914793152,2020-12-31,4406,4773,9179
4377,PSNL,-0.2508451576040377,-0.0430196516904602,1007580800,2020-12-31,4628,4552,9180
4378,CVI,-0.09409045889732585,-0.08194805504060612,1857812864,2020-12-31,4269,4914,9183
4379,DVAX,-0.21393580278209068,-0.049439201752814924,1140487936,2020-12-31,4561,4622,9183
4380,TLRY,-0.3157440567133166,-0.03498667277095707,3393938176,2020-12-31,4718,4465,9183
4381,EXAS,-0.4436122948451864,-0.026876107019855957,21227933696,2020-12-31,4837,4352,9189
4382,ICAD,-0.5241471721288593,-0.020463718855322867,462238144,2020-12-31,4930,4259,9189
4383,CLPT,-0.7095596623317363,-0.013473020454159145,457282368,2020-12-31,5078,4114,9192
4384,METC,-0.09023967180417901,-0.08523846107938562,187604128,2020-12-31,4252,4941,9193
4385,BOXL,-0.2433248129099812,-0.04502508845113377,140716944,2020-12-31,4615,4579,9194
4386,SFE,-0.14482318305962472,-0.0648668496304766,138019648,2020-12-31,4429,4769,9198
4387,ASPN,-0.2853910581261495,-0.040620470616956866,531498432,2020-12-31,4673,4526,9199
4388,SPR,-0.11667118880576767,-0.07253730247890106,5051678208,2020-12-31,4357,4843,9200
4389,WAFU,-0.27413673616233974,-0.04267869795180366,40743580,2020-03-31,4660,4545,9205
4390,RBCN,-0.07923316167847856,-0.09374075938701507,26402634,2020-12-31,4217,4989,9206
4391,CYTK,-0.21217206302171793,-0.05213381288190905,1718032128,2020-12-31,4557,4650,9207
4392,AGS,-0.2322354653807661,-0.04790664838237407,290405280,2020-12-31,4595,4612,9207
4393,VRM,-0.320790809453503,-0.0364740761327417,5470104064,2020-12-31,4724,4485,9209
4394,COMP,-0.30235308028851837,-0.039100913933660504,6697689088,2020-12-31,4702,4508,9210
4395,DRNA,-0.19725328528963867,-0.05540917972036552,1991212160,2020-12-31,4539,4675,9214
4396,DOMO,-0.3257519091662374,-0.03656309008375214,1794400128,2021-01-31,4729,4487,9216
4397,NKTX,-0.21481178737353096,-0.0526851674564723,1065517568,2020-12-31,4563,4654,9217
4398,REPL,-0.31031239228104207,-0.039047678337114984,1398059520,2020-03-31,4710,4507,9217
4399,AMSC,-0.2750309170471842,-0.04367632723802229,513293600,2020-03-31,4662,4559,9221
4400,XENE,-0.22177899331141593,-0.0521049265009082,630958144,2020-12-31,4573,4649,9222
4401,IZEA,-0.548741484324758,-0.021036150104208604,302151232,2020-12-31,4953,4269,9222
4402,AVDL,-0.1665311499239138,-0.06267679211516962,513324448,2020-12-31,4474,4753,9227
4403,SU,-0.07208692873122403,-0.10419010053967852,31646224384,2020-12-31,4181,5051,9232
4404,SHSP,-0.35520822443159206,-0.03600784439308953,202415168,2020-12-31,4756,4477,9233
4405,NRIX,-0.23753266928630173,-0.05037648208783994,1364764160,2020-11-30,4602,4635,9237
4406,MILE,-0.3696952200272199,-0.03521179430756172,1188792960,2020-12-31,4770,4467,9237
4407,EMX,-0.2943983846789243,-0.04295483713336263,271260992,2020-12-31,4687,4551,9238
4408,CCL,-0.10014460579645207,-0.08750539345018343,34882822144,2020-11-30,4285,4954,9239
4409,IKNX,-0.12873732745613276,-0.07371281393902661,19375580,2020-12-31,4389,4851,9240
4410,DTSS,-0.5040362790193129,-0.02585000210661479,74072880,2020-06-30,4907,4333,9240
4411,CHPT,-0.7534827528226333,-0.0148403145796191,8155643904,2021-01-31,5091,4153,9244
4412,PLAY,-0.11366172364401708,-0.08101883652604706,2100305664,2021-01-31,4341,4904,9245
4413,RSI,-0.3392080340685184,-0.0390069392900311,3275025408,2020-12-31,4740,4506,9246
4414,FPRX,-0.29197532043322955,-0.04444138014372021,1766941568,2020-12-31,4682,4567,9249
4415,ATEC,-0.4739515847061969,-0.02771073827664653,1674632960,2020-12-31,4882,4367,9249
4416,LGVN,-0.46746280460336687,-0.028532135734017465,129096488,2020-12-31,4875,4375,9250
4417,KRUS,-0.1630581444183324,-0.06613780009265671,271242784,2020-08-31,4467,4785,9252
4418,ANAB,-0.14751141284539687,-0.07012885759817847,571136768,2020-12-31,4434,4821,9255
4419,RCUS,-0.2130248030247173,-0.057338902049716006,2218425088,2020-12-31,4558,4698,9256
4420,SSKN,-0.17820137279762166,-0.06364611013900023,54757620,2020-12-31,4504,4758,9262
4421,DAIO,-0.20972495088408644,-0.05835747993650706,45560856,2020-12-31,4554,4709,9263
4422,GLBS,-0.09517829542945462,-0.09418721364533332,48314500,2020-12-31,4272,4995,9267
4423,XBIT,-0.16047485665615918,-0.06872105676350264,499326688,2020-12-31,4461,4809,9270
4424,CCCC,-0.2841609943213869,-0.04720894270530469,1408279552,2020-12-31,4669,4605,9274
4425,BMRA,-0.32194718687047674,-0.04283513743122948,63259136,2020-05-31,4725,4549,9274
4426,MSGE,-0.07865267145273942,-0.10781746063340197,2197208320,2020-06-30,4210,5071,9281
4427,CVE,-0.08591917887367026,-0.10240940818380803,15263232000,2020-12-31,4240,5043,9283
4428,USAS,-0.10940347679798121,-0.08866014102276634,299230784,2020-12-31,4322,4961,9283
4429,BEAM,-0.4687985536314585,-0.0311002849010986,4328605184,2020-12-31,4877,4414,9291
4430,DOGZ,-0.10103902602383928,-0.09589579799906295,53157528,2020-06-30,4290,5004,9294
4431,NCLH,-0.11517097948012314,-0.0859468441724645,11248493568,2020-12-31,4347,4947,9294
4432,AXNX,-0.5962137763532922,-0.023320706385445738,2500746496,2020-12-31,4990,4305,9295
4433,FNHC,-0.10368667736180577,-0.09553745770997076,80235408,2020-12-31,4296,5000,9296
4434,IPHA,-0.17671046237983173,-0.06738512745021072,348391776,2020-12-31,4497,4799,9296
4435,MTBC,-0.22023907440916818,-0.06008769197617401,125547944,2020-12-31,4570,4727,9297
4436,XXII,-0.452392471817698,-0.033606439279135786,550156736,2020-12-31,4854,4444,9298
4437,MDWT,-0.019347192901094448,-0.20800192021835337,183701072,2020-12-31,3901,5405,9306
4438,NVAX,-0.49663705774040506,-0.03038959922023409,13275398144,2020-12-31,4903,4403,9306
4439,ALNY,-0.289814116770421,-0.05021715530287225,16217143296,2020-12-31,4679,4633,9312
4440,CUK,-0.10014460579645207,-0.09931753780791508,28199872512,2020-11-30,4285,5028,9313
4441,ISR,-0.6302810516772439,-0.0231321580919297,151084000,2020-06-30,5014,4302,9316
4442,ALLO,-0.2497301970431917,-0.057044608413272656,4616067072,2020-12-31,4625,4692,9317
4443,TRX,-0.19854784718571492,-0.06590873328733995,148605600,2020-08-31,4540,4781,9321
4444,LIQT,-0.32043766054427114,-0.04720523040211198,178352640,2020-12-31,4723,4604,9327
4445,PARR,-0.10888222715831118,-0.09856842444159905,883242432,2020-12-31,4318,5018,9336
4446,ALVR,-0.28847032933247574,-0.053734635619745834,1437425408,2020-12-31,4676,4661,9337
4447,GBS,-0.46174028953449586,-0.035632704742494636,64957340,2020-06-30,4867,4474,9341
4448,VLRS,-0.03920081628150681,-0.16908586338059028,1802942592,2020-12-31,4035,5307,9342
4449,XLRN,-0.661516015388691,-0.023664329840238398,7680754688,2020-12-31,5037,4308,9345
4450,CPLG,-0.07130942452043369,-0.13323686838618418,550428544,2020-12-31,4176,5173,9349
4451,DYNT,-0.1256933961285419,-0.09082719067596313,18119146,2020-06-30,4379,4971,9350
4452,CPA,-0.1290284744927666,-0.0882072116354304,3420097792,2020-12-31,4391,4959,9350
4453,AMRS,-0.6225322559493186,-0.026277018428393105,4378433024,2020-12-31,5007,4343,9350
4454,LMND,-0.6813310772701635,-0.022584038662773406,5680210432,2020-12-31,5058,4294,9352
4455,TESS,-0.13109165029219919,-0.08763655216868586,69918312,2020-03-29,4398,4957,9355
4456,REDU,-0.06939559596482307,-0.13728190614696145,202961520,2020-12-31,4169,5189,9358
4457,PBYI,-0.24105613701236916,-0.06222282883670072,375611808,2020-12-31,4610,4748,9358
4458,LEAF,-0.2811089721336826,-0.05730021532915945,323610336,2020-12-31,4664,4696,9360
4459,TZOO,-0.31286467684021546,-0.051664728054252144,195249616,2020-12-31,4714,4646,9360
4460,EGHT,-0.4262891673523342,-0.0418813852633653,3495444736,2020-03-31,4826,4538,9364
4461,HSON,-0.17053364269141533,-0.07873489039960427,49403448,2020-12-31,4482,4884,9366
4462,AR,-0.06944792535558802,-0.13902961281631043,2767936000,2020-12-31,4170,5198,9368
4463,ACVA,-1.695750851090657,-0.008444063955350025,4840341504,2020-12-31,5372,3996,9368
4464,BILI,-0.252074482667408,-0.06161921359975193,39919398912,2020-12-31,4630,4739,9369
4465,TDOC,-1.0999831656031185,-0.014442451642490278,27966420992,2020-12-31,5228,4142,9370
4466,EDIT,-0.31614585287166597,-0.05233127071024398,2658136064,2020-12-31,4720,4651,9371
4467,LYV,-0.22663550024829057,-0.06650814718208506,18752043008,2020-12-31,4581,4793,9374
4468,BEST,-0.09104020527406127,-0.11959998588935564,631947520,2020-12-31,4257,5118,9375
4469,CETX,-0.10881161195294144,-0.10542721427587524,30545940,2020-09-30,4316,5059,9375
4470,KURA,-0.28811534771731157,-0.057565136744657824,1891654016,2020-12-31,4674,4701,9375
4471,FEIM,-0.1278518501176443,-0.09386744603403939,107175568,2020-04-30,4386,4990,9376
4472,RDIB,-0.09059113624889331,-0.1212210804157913,176401504,2020-12-31,4254,5123,9377
4473,MSC,-0.11341506837331992,-0.10167541964030546,1544488192,2020-12-31,4339,5039,9378
4474,KLR,-0.4644572318608575,-0.03934490725751138,455105888,2020-12-31,4869,4510,9379
4475,BEEM,-1.0056750865688717,-0.0159166751662938,352043712,2020-12-31,5200,4179,9379
4476,RNGR,-0.07857469164001828,-0.1331314936047036,84495576,2020-12-31,4209,5171,9380
4477,ORIC,-0.22449657406480614,-0.06833574795634524,791511168,2020-12-31,4576,4806,9382
4478,KRYS,-0.6716259947489467,-0.025665517548774098,1538549888,2020-12-31,5050,4332,9382
4479,PLUG,-0.5838666960935776,-0.030223539472446107,19046791168,2020-12-31,4985,4401,9386
4480,RDI,-0.09059113624889331,-0.12406359591513821,164700960,2020-12-31,4254,5136,9390
4481,AMTI,-0.5083786956985804,-0.03606534765374734,1847102592,2020-12-31,4911,4479,9390
4482,ABNB,-0.5825195945255769,-0.030951498332102284,109627817984,2020-12-31,4981,4410,9391
4483,RNWK,-0.2943673556021331,-0.05814113134728748,189151760,2020-12-31,4686,4707,9393
4484,BIMI,-0.1877920241364913,-0.07567885500059217,34223552,2020-12-31,4526,4868,9394
4485,RIGL,-0.37973472437023253,-0.0495368745908459,554594432,2020-12-31,4775,4624,9399
4486,VUZI,-1.5867883136469114,-0.010637608459488933,1833920640,2020-12-31,5356,4049,9405
4487,THTX,-0.47201850537549617,-0.04089797141142291,357483232,2020-11-30,4879,4529,9408
4488,SMTI,-0.8712891865825342,-0.020671189142415523,240472480,2020-12-31,5148,4263,9411
4489,GROY,-4.265390768950796,-0.002974727492081891,188942176,2020-09-30,5584,3827,9411
4490,DRTT,-0.17516152189519024,-0.08223929133507953,270519744,2020-12-31,4495,4917,9412
4491,MCRB,-0.3954269920537705,-0.04792039576302661,1884086656,2020-12-31,4799,4614,9413
4492,HMG,-0.07618210795188708,-0.14293035171325685,11945985,2020-12-31,4200,5214,9414
4493,RES,-0.1606927537102211,-0.08762388322743393,1165379456,2020-12-31,4462,4956,9418
4494,GBIO,-0.3511443772483864,-0.05469012105712302,1534825344,2020-12-31,4749,4669,9418
4495,MDXG,-0.6207904861839804,-0.031109448512820145,1415239936,2020-12-31,5004,4415,9419
4496,DMTK,-0.780022293500762,-0.024870457331799798,1397527040,2020-12-31,5099,4321,9420
4497,SREV,-0.1338830065765534,-0.09862159115794052,137195392,2020-12-31,4404,5020,9424
4498,RMO,-0.5387706410497897,-0.03625043665490721,1222162560,2020-12-31,4943,4482,9425
4499,BLNK,-1.8747696873388549,-0.00971702198756107,1848680064,2020-12-31,5399,4026,9425
4500,SGMO,-0.18674377506335207,-0.08117565934470641,1583728384,2020-12-31,4520,4906,9426
4501,RARE,-0.38493587239545374,-0.05154851806995578,6927903232,2020-12-31,4781,4645,9426
4502,PLCE,-0.16372036025215217,-0.08888693296169856,1085357952,2021-01-30,4468,4962,9430
4503,ORMP,-0.47516469304449743,-0.04245679078113966,291676832,2020-08-31,4887,4543,9430
4504,HCM,-0.4338181770054396,-0.04705264795204974,4229536512,2020-12-31,4832,4601,9433
4505,UUU,-0.21508617490344337,-0.07623982029439387,17022870,2020-03-31,4564,4870,9434
4506,MBII,-0.41789194838019783,-0.04890789676258906,324413216,2020-12-31,4817,4618,9435
4507,BCAB,-0.8836792812894513,-0.021680324851147598,1593971456,2020-12-31,5153,4282,9435
4508,SUMO,-0.46717351855328204,-0.04408784559363729,1966781568,2021-01-31,4874,4563,9437
4509,INTZ,-1.6412813538833484,-0.011711780967380772,478071104,2020-12-31,5362,4075,9437
4510,SUNW,-0.7432642699205634,-0.02682061946529212,360275360,2020-12-31,5088,4351,9439
4511,AEYE,-0.8900131406044678,-0.021782826690878013,309930016,2020-12-31,5155,4284,9439
4512,IBIO,-0.38710123292972853,-0.052675011871156356,315374624,2020-06-30,4787,4653,9440
4513,MMYT,-0.5236670925775352,-0.03941300223837852,3152087552,2020-03-31,4929,4512,9441
4514,BP,-0.10388074388415013,-0.1259593563414268,82333073408,2020-12-31,4297,5145,9442
4515,DM,-0.661661647271917,-0.030699389417807914,3451619840,2020-12-31,5038,4406,9444
4516,AGFY,-0.4591941391941392,-0.045408095478127394,256327120,2020-12-31,4862,4586,9448
4517,BRN,-0.19919638372677045,-0.08143109795729905,22513876,2020-09-30,4541,4909,9450
4518,GLSI,-5.571530636342711,-0.0028197480655165657,688593792,2020-12-31,5634,3817,9451
4519,TRIP,-0.526595744680851,-0.04017762421064307,7077174272,2020-12-31,4933,4520,9453
4520,AIKI,-0.24054679748649543,-0.07294789741559841,91573280,2020-12-31,4608,4847,9455
4521,PTGX,-0.31620065184894747,-0.06137886670782033,1128227968,2020-12-31,4721,4738,9459
4522,BTN,-0.13300146530440193,-0.1055714445589631,51061184,2020-12-31,4402,5060,9462
4523,CLDX,-0.3093146308590825,-0.0626868148520315,820418304,2020-12-31,4709,4755,9464
4524,NSTG,-0.6930979107955351,-0.030015062736420735,3135473152,2020-12-31,5067,4397,9464
4525,EXN,-0.159166982703184,-0.0962193347096363,89427872,2020-12-31,4459,5006,9465
4526,FUN,-0.21822032390273902,-0.08015902162116019,2820383744,2020-12-31,4569,4896,9465
4527,CVV,-0.13148568316215375,-0.10691727744694812,30402100,2020-12-31,4400,5066,9466
4528,IGMS,-0.521712982684742,-0.04231138762101951,2192104448,2020-12-31,4925,4541,9466
4529,FI,-0.13944349108384313,-0.1051150221913253,808377600,2020-12-31,4411,5058,9469
4530,ARGX,-0.6843956387510258,-0.030971487948483478,14294843392,2020-12-31,5060,4411,9471
4531,OXY,-0.10898131562087315,-0.12740789880091957,22953805824,2020-12-31,4319,5153,9472
4532,AMYT,-0.8300921187308086,-0.026455428761926976,503429344,2020-12-31,5127,4347,9474
4533,STRR,-0.1261690949062861,-0.11392292394186304,16242699,2020-12-31,4383,5092,9475
4534,VTNR,-0.1232592537538625,-0.11734220548500314,80200872,2020-12-31,4371,5107,9478
4535,SAVE,-0.10987134626617619,-0.12913294490891297,3641306112,2020-12-31,4324,5161,9485
4536,ADES,-0.11586549926753653,-0.12360852275857878,96668136,2020-12-31,4351,5134,9485
4537,EPIX,-0.997656898093455,-0.02217116934907008,1115950976,2020-09-30,5198,4288,9486
4538,NSEC,-0.0756333191809494,-0.1619466155438065,26788674,2020-12-31,4197,5291,9488
4539,FTCH,-0.6810102141842922,-0.0322242844761503,18153785344,2020-12-31,5057,4432,9489
4540,EAR,-1.1936641193987012,-0.017966710033735834,2025443712,2020-12-31,5271,4220,9491
4541,SANW,-0.17692401670154917,-0.0941557702124348,133301336,2020-06-30,4498,4994,9492
4542,AIHS,-0.28886791271602175,-0.0696732507435371,69968368,2020-03-31,4677,4817,9494
4543,IOVA,-0.3809349986038719,-0.059196967758545764,4437296128,2020-12-31,4779,4718,9497
4544,SANA,-0.5784514705700086,-0.04029922164124694,5883938304,2020-12-31,4978,4521,9499
4545,MDNA,-0.5583594302468476,-0.04194402522148346,217449136,2020-03-31,4961,4539,9500
4546,BDTX,-0.2378242008429991,-0.0799947515532044,890069056,2020-12-31,4606,4895,9501
4547,MSON,-0.5223049612947703,-0.044868204441984125,345223264,2020-06-30,4926,4576,9502
4548,TRHC,-0.5673691027748717,-0.04176495655285685,1065296704,2020-12-31,4967,4536,9503
4549,BGNE,-0.4163209008320732,-0.05689759465086876,29257596928,2020-12-31,4815,4689,9504
4550,REKR,-1.8343396810651804,-0.013457764374010046,893611968,2020-12-31,5392,4112,9504
4551,SAVA,-5.390476190476191,-0.004334587005834298,1658572288,2020-12-31,5628,3876,9504
4552,TWOU,-0.40481048381330115,-0.05754811834571651,2941269504,2020-12-31,4806,4700,9506
4553,LSF,-0.5357231756275586,-0.04442216034179178,340069216,2020-12-31,4940,4566,9506
4554,CLOV,-0.901661187729775,-0.026381140928436724,3335846144,2020-12-31,5163,4346,9509
4555,LEDS,-0.17841652100731534,-0.09660378797613732,19454902,2020-08-31,4505,5009,9514
4556,TELL,-0.23651114951040894,-0.08206226020673943,796369216,2020-12-31,4601,4915,9516
4557,AREC,-0.31925963141191793,-0.06664185197959442,188991632,2020-12-31,4722,4794,9516
4558,SDC,-0.44699918564445656,-0.055112710548636756,4000980480,2020-12-31,4843,4673,9516
4559,DUO,-0.1650270080038318,-0.1028483209526076,483073152,2020-12-31,4470,5047,9517
4560,YJ,-0.08636732610444899,-0.15823271468812108,454356256,2020-12-31,4241,5278,9519
4561,UAVS,-2.0525671725410164,-0.012765742209030413,408032288,2020-12-31,5427,4097,9524
4562,IMAX,-0.20610606096300957,-0.09200314916215982,1273883648,2020-12-31,4549,4978,9527
4563,CRON,-0.28934693251010557,-0.07331400401185473,3185167104,2020-12-31,4678,4849,9527
4564,OCGN,-2.7950380173607705,-0.010216777306330435,1309099392,2020-12-31,5490,4038,9528
4565,AAOI,-0.12270471931565527,-0.1298901340409166,224544480,2020-12-31,4367,5164,9531
4566,MEDS,-0.492407007724757,-0.04986194146412164,40789728,2020-12-31,4901,4630,9531
4567,ALK,-0.14053388090349075,-0.11940508392596033,9034373120,2020-12-31,4415,5117,9532
4568,RCMT,-0.18137468221066855,-0.09929657050535497,39853992,2021-01-02,4512,5027,9539
4569,ULCC,-0.15918045705279749,-0.11082223302735336,4596216832,2020-12-31,4460,5081,9541
4570,OMEX,-0.23948095360180774,-0.08459749251844674,90149208,2020-12-31,4607,4934,9541
4571,CRSP,-0.5452242213170233,-0.04629639503554407,8730140672,2020-12-31,4948,4593,9541
4572,XL,-1.2832690048665885,-0.019099966994297914,1121194368,2020-12-31,5303,4238,9541
4573,HARP,-0.3448505206583809,-0.06740767421774793,734752832,2020-12-31,4743,4800,9543
4574,AQB,-0.5577373531440181,-0.0452663123612,444078816,2020-12-31,4960,4583,9543
4575,DK,-0.154513750232942,-0.1152669222534444,1604569344,2020-12-31,4452,5096,9548
4576,GDRX,-1.5429695840089557,-0.017256787853519504,15744140288,2020-12-31,5347,4209,9556
4577,LUB,-0.14197799062299377,-0.12438872039856387,106674744,2020-08-26,4420,5139,9559
4578,CTSO,-0.8315296589940147,-0.03202900507639056,385047808,2020-12-31,5130,4429,9559
4579,AZUL,-0.12552639646431768,-0.13484854255094197,2343018752,2020-12-31,4378,5182,9560
4580,IRIX,-0.45107578456900094,-0.058983738587367864,113304032,2021-01-02,4852,4715,9567
4581,LUNG,-1.1571111588290028,-0.023947326003300674,1551796864,2020-12-31,5253,4314,9567
4582,SCX,-0.09599406731944464,-0.16297314496342338,45064004,2020-06-30,4275,5293,9568
4583,CNK,-0.16240587036326928,-0.11681434983186983,2705190144,2020-12-31,4465,5103,9568
4584,XTLB,-0.38072289156626504,-0.06635579304272109,17663620,2020-12-31,4777,4791,9568
4585,RCON,-0.1443657331944175,-0.125708485220202,118282600,2020-06-30,4427,5143,9570
4586,VKTX,-0.19096944005514846,-0.101123549909817,438867968,2020-12-31,4533,5037,9570
4587,OPNT,-0.23189569098441717,-0.0920907280339391,47465428,2020-12-31,4592,4979,9571
4588,NETE,-0.47389689883087827,-0.05695984130127277,59738516,2020-12-31,4881,4691,9572
4589,NR,-0.11453129319863138,-0.1469939376996122,293899424,2020-12-31,4344,5230,9574
4590,OCC,-0.1661220201212782,-0.11720281196224194,27875888,2020-10-31,4472,5105,9577
4591,TACT,-0.3027822027933168,-0.07727241406774317,107257664,2020-12-31,4703,4874,9577
4592,GSIT,-0.27210435488782864,-0.08293016577741685,172535504,2020-03-31,4656,4925,9581
4593,VMAR,-0.859794525738124,-0.03338897845575841,63602340,2020-08-31,5140,4441,9581
4594,MYT,-0.2693507590890515,-0.08491881283410259,32512230,2020-06-30,4647,4937,9584
4595,USAT,-0.6646075337406836,-0.042730098059660694,883507008,2020-06-30,5041,4546,9587
4596,VINC,-1.1212715855572999,-0.02717643895391808,266542656,2020-12-31,5234,4357,9591
4597,VVI,-0.18771081594382635,-0.10746307841853614,843288192,2020-12-31,4525,5067,9592
4598,SLN,-0.6442041792286101,-0.0447068880034954,694899200,2020-12-31,5021,4572,9593
4599,CATO,-0.13104865716462105,-0.13892072708184197,307406240,2021-01-30,4397,5197,9594
4600,AKUS,-0.1794150795186758,-0.11285821095903642,477155744,2020-12-31,4509,5086,9595
4601,CPIX,-0.21440248547962598,-0.10095500446353216,47298620,2020-12-31,4562,5033,9595
4602,FUSN,-0.17500922679461156,-0.11672528356966846,403653856,2020-12-31,4494,5102,9596
4603,SQNS,-0.34190493741405953,-0.07455449861826116,223295312,2020-12-31,4741,4855,9596
4604,NCMI,-0.6213080168776371,-0.046456018766704604,348565856,2020-12-31,5005,4596,9601
4605,SPNE,-0.35320432354105763,-0.07329198470813654,613054080,2020-12-31,4754,4848,9602
4606,RRGB,-0.12665137562028211,-0.14366312608427886,574300928,2020-12-27,4385,5220,9605
4607,SNDL,-0.45150345306634965,-0.062438461477491436,1660230016,2020-12-31,4853,4752,9605
4608,FSR,-3.2459448971672487,-0.011987324509512983,4466954752,2020-12-31,5525,4080,9605
4609,LYL,-0.21331926929268802,-0.10338316747782356,17921442,2020-03-31,4560,5048,9608
4610,CGC,-0.29239395948257846,-0.08285730439426926,11021418496,2020-03-31,4684,4924,9608
4611,CMMB,-3.210752688172043,-0.01242406053048891,491038208,2020-12-31,5520,4088,9608
4612,IQ,-0.15793782337388204,-0.12800465766234856,13259986944,2020-12-31,4457,5154,9611
4613,GNUS,-0.7784531288749643,-0.03970561042093983,534573120,2020-12-31,5098,4516,9614
4614,XOG,-0.15047463416393658,-0.13442625667387836,974433984,2020-12-31,4441,5178,9619
4615,MCS,-0.12465465442508658,-0.1498642922228816,683011392,2020-12-31,4373,5248,9621
4616,TDW,-0.10909622480892552,-0.1719345169683259,489808672,2020-12-31,4320,5311,9631
4617,VJET,-0.24270422999979377,-0.09856966107582586,93994648,2020-12-31,4612,5019,9631
4618,MRTX,-0.6452330251253824,-0.04734028611744374,8616387584,2020-12-31,5024,4608,9632
4619,KOD,-1.1514502446705837,-0.029140346931570554,5580282880,2020-12-31,5248,4384,9632
4620,KDNY,-0.24341064557503206,-0.09835410164611257,628033024,2020-12-31,4616,5017,9633
4621,SNDX,-0.3927318516237587,-0.07211761203062039,1068905344,2020-12-31,4794,4839,9633
4622,SKLZ,-2.7484573713027607,-0.01468280270562779,6676944896,2020-12-31,5487,4149,9636
4623,AEVA,-4.335691426646455,-0.010433552570911987,2486086656,2020-12-31,5590,4046,9636
4624,AVCT,-0.40611994671188084,-0.07054444393768368,150716160,2020-12-31,4808,4829,9637
4625,ASPS,-0.3234967982977533,-0.08156274450185043,141093760,2020-12-31,4728,4910,9638
4626,PZG,-0.12569638446573028,-0.15258155390316105,38762428,2020-06-30,4380,5261,9641
4627,RDVT,-1.173509706236042,-0.029010315322379646,241683968,2020-12-31,5262,4379,9641
4628,CLGN,-0.7297015508927408,-0.04365998666011567,128185992,2020-12-31,5084,4558,9642
4629,LUV,-0.20388270980788675,-0.11572065569487432,37460799488,2020-12-31,4546,5098,9644
4630,KC,-0.18685737546840103,-0.1216346662593216,9854090240,2020-12-31,4521,5125,9646
4631,OGI,-0.25396259019209544,-0.09799598659799161,908665152,2020-08-31,4633,5016,9649
4632,WRAP,-0.4424288513154791,-0.06933683717883124,202904384,2020-12-31,4836,4813,9649
4633,RCKT,-0.512458218226774,-0.06090099131176753,2434682880,2020-12-31,4917,4732,9649
4634,VIR,-0.6272938792359365,-0.05085409529873094,5596635136,2020-12-31,5013,4640,9653
4635,XENT,-0.40541196976840543,-0.07362054158815469,676495808,2020-12-31,4807,4850,9657
4636,BLIN,-0.4445217391304348,-0.07007144820412306,15494527,2020-09-30,4840,4819,9659
4637,GEOS,-0.11628472172582882,-0.1694242367056963,118359320,2020-09-30,4353,5308,9661
4638,PTCT,-0.29039447838449134,-0.09220031141541761,3348731392,2020-12-31,4680,4981,9661
4639,DMRC,-0.47467453515613417,-0.06569460728722926,496102272,2020-12-31,4884,4777,9661
4640,PGEN,-0.6231526026091102,-0.053660804686748165,1445796864,2020-12-31,5008,4660,9668
4641,BDSX,-0.7421476510067114,-0.045173935830264834,503649344,2020-12-31,5087,4582,9669
4642,TUSK,-0.10830127612723242,-0.18935026080849704,235025360,2020-12-31,4313,5357,9670
4643,MYGN,-0.4488817891373802,-0.07018481141136364,2148529152,2020-12-31,4847,4824,9671
4644,HA,-0.12548286817678714,-0.1638848651534383,1332844416,2020-12-31,4377,5296,9673
4645,AHPI,-0.2166799105876126,-0.11759725899961997,18382012,2020-06-30,4568,5109,9677
4646,ALPN,-0.2648481331011801,-0.10108856231494348,270584192,2020-12-31,4642,5035,9677
4647,CLNN,-1.2795290543106723,-0.028746485317670763,748839616,2020-12-31,5301,4376,9677
4648,NGM,-0.6024088696529998,-0.056252019065709896,1950287744,2020-12-31,4994,4687,9681
4649,USEG,-0.24313072439633637,-0.10760465921857118,19640460,2020-12-31,4614,5068,9682
4650,NEPH,-0.5699101606984689,-0.058892260636433914,82549640,2020-12-31,4969,4714,9683
4651,VRS,-0.10531496062992125,-0.19992780775025715,499193184,2020-12-31,4301,5383,9684
4652,PRCH,-1.3347273499526253,-0.029060012205944927,1527415552,2020-12-31,5312,4381,9693
4653,ZNTL,-0.4104496435815305,-0.07872070777459858,1535317632,2020-12-31,4811,4883,9694
4654,GMBL,-4.1992623293345925,-0.01350724966441203,310431712,2020-06-30,5581,4116,9697
4655,MAXN,-0.2120288162564601,-0.12558603568719903,800035328,2021-01-03,4556,5142,9698
4656,MTBCP,-0.22023907440916818,-0.12267066982614269,57344276,2020-12-31,4570,5129,9699
4657,DAL,-0.1772127516132139,-0.14025992915430485,31441504256,2020-12-31,4499,5206,9705
4658,AMC,-0.18957248395300957,-0.13385042069622477,4728397312,2020-12-31,4531,5177,9708
4659,MRAM,-0.4815357188335668,-0.069428986200569,109545448,2020-12-31,4895,4814,9709
4660,KALV,-0.539986411414412,-0.06458511876007178,635659392,2020-04-30,4944,4765,9709
4661,HUSA,-0.29817309641313106,-0.09758230937825081,18060480,2020-12-31,4696,5014,9710
4662,GBNH,-0.3509785339790842,-0.089244768781341,169860480,2020-12-31,4748,4965,9713
4663,LYFT,-0.43665483697123375,-0.07830400476281456,20054923264,2020-12-31,4834,4880,9714
4664,UNAM,-0.1678940445416488,-0.14810964345469502,30450010,2020-12-31,4479,5238,9717
4665,WHLM,-0.35152523571824734,-0.08931840390351584,28674810,2020-12-31,4750,4967,9717
4666,TUFN,-0.32256990995616663,-0.09391111604219442,368859840,2020-12-31,4726,4992,9718
4667,PFIN,-0.13069286923135215,-0.17553775826001167,21151140,2020-12-31,4396,5324,9720
4668,KNTE,-1.1550258269434375,-0.035519567778332484,1371712000,2020-12-31,5250,4471,9721
4669,ITCI,-0.35477097731511326,-0.09099627013789281,2564259840,2020-12-31,4755,4973,9728
4670,AUTO,-0.2708241408050203,-0.10906404333814947,38849140,2020-12-31,4653,5076,9729
4671,INO,-0.45299349878879536,-0.07630830703453206,1816428416,2020-12-31,4857,4872,9729
4672,ICD,-0.09737533003239081,-0.23720891093429883,22679960,2020-12-31,4278,5452,9730
4673,IGC,-0.3314020857473928,-0.094984560580721,77576376,2020-03-31,4733,4997,9730
4674,CETXP,-0.10881161195294144,-0.21512096652687776,11037209,2020-09-30,4316,5417,9733
4675,APLS,-0.553245684199082,-0.06552435235245246,3340401664,2020-12-31,4959,4775,9734
4676,EQS,-0.1377170509536009,-0.17681616294161281,25954752,2020-12-31,4408,5329,9737
4677,RGNX,-0.3320180665857272,-0.09633486467899335,1494672128,2020-12-31,4734,5007,9741
4678,AQMS,-0.552453073969063,-0.06628829898738454,234988928,2020-12-31,4956,4786,9742
4679,DKNG,-1.2493283805105702,-0.034307541574450776,24780998656,2020-12-31,5289,4456,9745
4680,NNOX,-1.9564416074799964,-0.025660042587074702,1905127040,2020-12-31,5414,4331,9745
4681,ACRS,-1.3349933964340743,-0.032266054525765725,1500252544,2020-12-31,5313,4433,9746
4682,ZOM,-4.553385493408107,-0.014637578753998645,1205301120,2020-12-31,5600,4147,9747
4683,DSS,-0.29410798828712953,-0.10690293551661084,94908448,2020-12-31,4685,5065,9750
4684,NIO,-0.29725086919354105,-0.10483986276107977,62460383232,2020-12-31,4694,5057,9751
4685,NXTC,-0.15270158646669457,-0.16835460965334917,265511040,2020-12-31,4449,5305,9754
4686,BNGO,-3.3599424631516785,-0.0183579891232731,2031446144,2020-12-31,5530,4225,9755
4687,VERI,-0.6249161790809282,-0.06233216492786576,789064576,2020-12-31,5009,4749,9758
4688,AGIO,-0.4524998854970573,-0.08104124985852407,3672860416,2020-12-31,4855,4905,9760
4689,HTBX,-0.22504212537801788,-0.13750562158123167,188542944,2020-12-31,4577,5191,9768
4690,SRRK,-0.3869189179559807,-0.0931456516747605,1025825280,2020-12-31,4786,4985,9771
4691,STRO,-0.38995148425293974,-0.0923295267222701,922435264,2020-12-31,4790,4982,9772
4692,FNCH,-0.7890040414549238,-0.05450409116255109,809958016,2020-12-31,5106,4667,9773
4693,AINC,-0.1438710827117436,-0.18857424404298054,27086490,2020-12-31,4425,5354,9779
4694,ALT,-0.3328724019580746,-0.10266276854118422,479240160,2020-12-31,4735,5045,9780
4695,FTEK,-0.4663801469568834,-0.08137367274314812,86233304,2020-12-31,4873,4908,9781
4696,CDXC,-1.6424553275976175,-0.03140607533395886,632191680,2020-12-31,5363,4421,9784
4697,ZH,-0.27007022315876994,-0.1239671616402705,4806483456,2020-12-31,4652,5135,9787
4698,AFI,-0.1449123724823437,-0.1897431770614007,112873608,2020-12-31,4430,5358,9788
4699,VOR,-1.2516162549064882,-0.037693067846562546,1188835328,2020-12-31,5292,4496,9788
4700,JBLU,-0.16491865554546206,-0.1742677932286262,6668375040,2020-12-31,4469,5321,9790
4701,GSX,-0.17036533698455142,-0.1699988545915344,6481625088,2020-12-31,4481,5309,9790
4702,FMTX,-0.3151093817816324,-0.10886143459239815,1391420416,2020-12-31,4716,5075,9791
4703,YTRA,-0.1833450986587529,-0.15758261589576938,187123904,2020-03-31,4515,5277,9792
4704,FRSX,-1.1873092220886134,-0.0403855863250906,354583168,2020-12-31,5269,4524,9793
4705,IH,-0.11357910498101521,-0.23766468375193314,649492416,2020-12-31,4340,5454,9794
4706,ACAD,-0.5230263967408448,-0.07566596947358532,3309772288,2020-12-31,4928,4867,9795
4707,NKTR,-0.30609939637697275,-0.11468005442639884,3396062464,2020-12-31,4706,5093,9799
4708,EOLS,-0.39125432841261165,-0.09647372782415892,593898240,2020-12-31,4792,5008,9800
4709,CURI,-0.9085084007923891,-0.05046124797300584,725687872,2020-12-31,5165,4636,9801
4710,OIS,-0.15385894744125028,-0.18802312238399785,359134784,2020-12-31,4451,5352,9803
4711,SILV,-1.052912932760531,-0.04585699720325908,1273790976,2020-12-31,5217,4590,9807
4712,REFR,-1.8500109462199652,-0.031124704461071705,87355104,2020-12-31,5395,4416,9811
4713,CTMX,-0.30060237983326327,-0.11878038717797233,500135552,2020-12-31,4700,5114,9814
4714,ASND,-0.8992498544859137,-0.05315541043909495,6751587840,2020-12-31,5162,4656,9818
4715,ARVN,-1.0244844169374474,-0.048663671690648294,3103010304,2020-12-31,5204,4617,9821
4716,JMIA,-1.2036360410062832,-0.042816244636773866,3667644672,2020-12-31,5276,4548,9824
4717,PPTA,-0.4027824414718726,-0.09886539004359932,309762176,2020-12-31,4803,5023,9826
4718,REAL,-0.524685565289683,-0.07995847856448982,2137179520,2020-12-31,4932,4894,9826
4719,VAPO,-0.5701843170679736,-0.0747067410558334,600259200,2020-12-31,4970,4856,9826
4720,RXDX,-1.7607745538424184,-0.033874256722410304,887860992,2020-12-31,5379,4447,9826
4721,NVTA,-0.9457588156866351,-0.05235724710245274,7472890368,2020-12-31,5179,4652,9831
4722,SEED,-0.19164214243672748,-0.1641989175181449,94559336,2020-09-30,4535,5297,9832
4723,NC,-0.11623869509043927,-0.25503953979745664,170158240,2020-12-31,4352,5481,9833
4724,MSN,-0.14906712209583348,-0.20560972305534803,27565936,2020-03-31,4438,5396,9834
4725,PTEN,-0.15201474811360163,-0.20095543091781715,1298759936,2020-12-31,4448,5387,9835
4726,AWH,-2.8755797217335677,-0.026103193150587154,695996928,2020-12-31,5498,4337,9835
4727,TCRR,-0.4592491577089684,-0.09105723381091717,839785536,2020-12-31,4863,4974,9837
4728,APYX,-0.6544891640866873,-0.06848234529707596,326020064,2020-12-31,5032,4807,9839
4729,LVTX,-1.8484760941788243,-0.03372296992095549,383580288,2020-12-31,5394,4445,9839
4730,CVM,-1.1702544847490512,-0.045113332967726925,653737600,2020-09-30,5260,4580,9840
4731,AUVI,-1.5991546842809508,-0.036069300170706003,100591592,2020-12-31,5360,4480,9840
4732,AUPH,-0.5815081630832367,-0.07539907866938447,1623526400,2020-12-31,4980,4864,9844
4733,FOLD,-0.4796310137288069,-0.08756752144150663,2429063936,2020-12-31,4892,4955,9847
4734,CPST,-0.37016807200810203,-0.10926025573926355,108883744,2020-03-31,4771,5077,9848
4735,VTVT,-0.9844671484342553,-0.05327530191165736,221824064,2020-12-31,5194,4657,9851
4736,DMAC,-0.6483381834890488,-0.07028014610389538,186072144,2020-12-31,5029,4826,9855
4737,SRPT,-0.415561328233207,-0.1024042320519276,5602329088,2020-12-31,4814,5042,9856
4738,AAL,-0.18379151015523718,-0.18203684186624733,15097945088,2020-12-31,4516,5341,9857
4739,PHCF,-0.5303967415545696,-0.08273738672241546,51148408,2020-06-30,4935,4922,9857
4740,NVOS,-0.762407012585283,-0.06462038367573268,64019004,2020-08-31,5094,4766,9860
4741,ADVM,-0.2826280212683876,-0.1393490630634481,887988544,2020-12-31,4665,5200,9865
4742,VLDR,-0.7227894035977248,-0.06608083563374192,2519494144,2020-12-31,5082,4784,9866
4743,SNCR,-0.22911144269873315,-0.16030327804768574,152800528,2020-12-31,4583,5285,9868
4744,DGLY,-0.514389741806742,-0.08645932511587871,89131680,2020-12-31,4919,4949,9868
4745,SRNE,-0.4986625690057481,-0.08990514743287831,2109266176,2020-12-31,4904,4968,9872
4746,MLSS,-1.7958567520301558,-0.036840676817518715,213652784,2020-12-31,5384,4488,9872
4747,FUV,-1.2812000723291441,-0.044666185000758876,424448640,2020-12-31,5302,4571,9873
4748,NCSM,-0.15312516182486666,-0.2213853617632966,67445000,2020-12-31,4450,5424,9874
4749,ARTW,-0.23209566085927957,-0.15939442712255078,15652805,2020-11-30,4593,5281,9874
4750,USWS,-0.24634420697412823,-0.15230609585558275,84007264,2020-12-31,4619,5260,9879
4751,LEGN,-0.8031383078851939,-0.06480238525140973,3783992320,2020-12-31,5112,4768,9880
4752,IMCR,-0.9374291277091936,-0.0578398172330157,1553092992,2020-12-31,5175,4705,9880
4753,CSSE,-0.5782388737482671,-0.08127836833337419,455361152,2020-12-31,4976,4907,9883
4754,NNVC,-0.3906822561436933,-0.11505349542562933,50079156,2020-06-30,4791,5094,9885
4755,MDWD,-0.8315117516200793,-0.0638229168473139,143810832,2020-12-31,5129,4759,9888
4756,IKT,-0.9391188684293563,-0.05855586998968554,57088544,2020-12-31,5178,4712,9890
4757,JILL,-0.22968968725016123,-0.1683576279121929,77245680,2021-01-30,4585,5306,9891
4758,RAAS,-0.38670377731427386,-0.11726243593190089,1935722752,2020-12-31,4785,5106,9891
4759,SPCE,-1.4873302140626519,-0.0430998140804245,6937720320,2020-12-31,5337,4554,9891
4760,PMD,-0.2945661146991696,-0.1402536477740271,38698212,2020-12-31,4688,5205,9893
4761,OM,-1.1304795542253319,-0.05341607696637027,2427700480,2020-12-31,5238,4658,9896
4762,PBF,-0.17128582637190198,-0.21083912664620294,1647813248,2020-12-31,4485,5412,9897
4763,UEPS,-0.18499163165624893,-0.1996095924476727,336298752,2020-06-30,4517,5380,9897
4764,LLIT,-0.706115363693066,-0.07015590465662919,41506576,2020-12-31,5075,4822,9897
4765,VIEW,-0.39461484453193596,-0.11600289392830908,1782202112,2020-12-31,4798,5100,9898
4766,LBPH,-2.5017869907076484,-0.032037932912568484,270672000,2020-12-31,5468,4430,9898
4767,RAMP,-0.8918879331680043,-0.06168909447063679,3418912256,2020-03-31,5158,4741,9899
4768,PPSI,-0.4116064565718678,-0.11364402045167928,39092660,2020-12-31,4812,5088,9900
4769,APRN,-0.1881967430893049,-0.19611789020157644,113648112,2020-12-31,4527,5376,9903
4770,ARCH,-0.1785553336030301,-0.20603384682805542,656635456,2020-12-31,4506,5399,9905
4771,PAVM,-1.2885443107824743,-0.046912239641389346,494764224,2020-12-31,5305,4600,9905
4772,WTTR,-0.16695074099183843,-0.2234106540316791,511258656,2020-12-31,4477,5429,9906
4773,ONDS,-1.1123627836642447,-0.05550493829296409,220288000,2020-12-31,5231,4676,9907
4774,YY,-0.11210449123097356,-0.35848070117933334,7995079680,2020-12-31,4336,5574,9910
4775,UAL,-0.18724877867788015,-0.20097966070965903,18906603520,2020-12-31,4524,5388,9912
4776,AZYO,-0.5407723508534731,-0.09088032194142806,135393568,2020-12-31,4945,4972,9917
4777,STIM,-0.8286129853339259,-0.06717942583324565,305941920,2020-12-31,5124,4797,9921
4778,WISH,-0.6432212028542303,-0.08086944561374913,8435699712,2020-12-31,5019,4903,9922
4779,VVOS,-1.1560866416293345,-0.05485807445606276,168716992,2020-12-31,5252,4670,9922
4780,ARNA,-0.44479926436551526,-0.11115851078420066,3999580672,2020-12-31,4841,5083,9924
4781,ALXO,-6.9726924305333755,-0.02049043688695591,2558911488,2020-12-31,5664,4261,9925
4782,EAST,-0.25721847930702596,-0.16142219446451736,21863084,2020-12-31,4638,5289,9927
4783,AKTS,-1.1326851688173944,-0.05626223191638301,584399616,2020-06-30,5240,4688,9928
4784,QTNT,-0.3623767210683176,-0.12998355956147814,404532000,2020-03-31,4764,5166,9930
4785,MGNX,-0.6913140029855313,-0.07540344606336846,1868574848,2020-12-31,5065,4865,9930
4786,SCR,-3.0083892617449663,-0.031918994668662715,1115123968,2020-08-31,5505,4425,9930
4787,ETNB,-0.4453377366321982,-0.11368939865557236,524191392,2020-12-31,4842,5089,9931
4788,RELI,-0.4477793463993934,-0.11337904320974863,16981408,2020-12-31,4844,5087,9931
4789,OMER,-0.664901227591348,-0.0794789399758799,1129053184,2020-12-31,5042,4892,9934
4790,IDEX,-1.5228140949237492,-0.04595507502401178,1236979328,2020-12-31,5344,4591,9935
4791,OLMA,-4.836665917771287,-0.02540952006997051,1181205504,2020-12-31,5608,4327,9935
4792,AHC,-0.14028919143600857,-0.297128527282772,45175940,2020-12-31,4413,5523,9936
4793,TGA,-0.17102117434132083,-0.24004151267793367,105949512,2020-12-31,4484,5460,9944
4794,FLUX,-0.820881852675651,-0.0702732345221913,162192160,2020-06-30,5120,4825,9945
4795,GERN,-0.30294543964960374,-0.1489168407840842,471425888,2020-12-31,4704,5243,9947
4796,ACET,-0.5831185203304043,-0.08920326776343866,409271008,2020-12-31,4984,4964,9948
4797,APEN,-0.6023646071700992,-0.08819507029650787,147068304,2020-12-31,4993,4958,9951
4798,MTNB,-0.425808882980621,-0.12259344070057632,206318752,2020-12-31,4824,5128,9952
4799,AUMN,-0.8290273556231003,-0.07053845604777159,115451184,2020-12-31,5126,4828,9954
4800,NMRD,-3.810152733535596,-0.02987976607000604,158644160,2020-03-31,5562,4396,9958
4801,SBTX,-2.9480566003940534,-0.03458469918275299,1328776192,2020-12-31,5500,4460,9960
4802,PHUN,-0.6870705148535786,-0.0806980576937347,134589552,2020-12-31,5061,4900,9961
4803,VBIV,-0.9202675331251582,-0.06647452652616624,716294080,2020-12-31,5169,4792,9961
4804,PBPB,-0.17955662905523176,-0.2376458488188956,166680336,2020-12-27,4510,5453,9963
4805,MESO,-0.9383186148045247,-0.06632681739810803,1122741376,2020-06-30,5176,4789,9965
4806,AEZS,-1.363950276243094,-0.05176227617729694,133722600,2020-12-31,5318,4647,9965
4807,CLSK,-14.931138624941703,-0.020168916061841784,748027072,2020-09-30,5711,4254,9965
4808,PPBT,-0.24705165500432424,-0.18641373841814365,75574288,2020-12-31,4620,5347,9967
4809,CRTX,-0.6625766355925086,-0.08367857431810972,992655040,2020-12-31,5040,4927,9967
4810,OSW,-1.2564702331547575,-0.05522988137973371,977938816,2020-12-31,5294,4674,9968
4811,VERO,-0.3016300313734029,-0.15520880695012784,120897280,2020-12-31,4701,5268,9969
4812,CSCW,-0.8422620169036323,-0.07125474298433258,72926632,2020-06-30,5136,4833,9969
4813,VNE,-0.3839458413926499,-0.13747713073124634,2766753024,2020-12-31,4780,5190,9970
4814,ASRT,-0.33677138531415596,-0.1473418397750435,105796568,2020-12-31,4738,5234,9972
4815,OSCR,-0.8494455859093721,-0.07165265195708385,4632354816,2020-12-31,5138,4834,9972
4816,ANGN,-0.5164093115477782,-0.10419948908111643,456420032,2020-12-31,4921,5052,9973
4817,SM,-0.20195371866791223,-0.22371918467409938,1980446976,2020-12-31,4543,5431,9974
4818,NEXI,-1.0248803490757894,-0.06503963450344015,406226752,2020-12-31,5205,4771,9976
4819,CGEM,-1.6381580733621135,-0.04820275090538883,1405570048,2020-12-31,5361,4615,9976
4820,REED,-0.7459286209286209,-0.0791955738328627,100227824,2020-12-31,5089,4888,9977
4821,SRAX,-0.6521030139451192,-0.08597248168905494,115929000,2020-12-31,5030,4948,9978
4822,CLLS,-0.42169395933310244,-0.12870276264193709,827191936,2020-12-31,4822,5157,9979
4823,MARK,-1.226714012564873,-0.05722262406466302,217818832,2020-12-31,5285,4694,9979
4824,NCTY,-0.33440809888598727,-0.14974005731709103,415244864,2020-12-31,4736,5245,9981
4825,RLMD,-0.5527881341699532,-0.098878767189687,590007360,2020-12-31,4957,5024,9981
4826,OCX,-1.0241484244625503,-0.06576256955317794,472578432,2020-12-31,5203,4778,9981
4827,BFLY,-1.5667739496287105,-0.0497542665837464,3184961536,2020-12-31,5353,4628,9981
4828,INZY,-0.4125811911409435,-0.1332048324670345,446287200,2020-12-31,4813,5172,9985
4829,XGN,-1.2077859272991054,-0.05887246974493295,276551232,2020-12-31,5277,4713,9990
4830,AESE,-0.306655579846526,-0.1601847700219856,106459440,2020-12-31,4707,5284,9991
4831,BOLT,-1.2482107507233136,-0.05798628823183053,842444032,2020-12-31,5288,4706,9994
4832,PRFX,-1.1901709401709402,-0.06000441253274209,42563952,2020-12-31,5270,4726,9996
4833,ATOS,-1.0331414713726634,-0.06634225371309314,244064480,2020-12-31,5207,4790,9997
4834,ACHL,-0.8140719285541878,-0.07876526995784476,589422336,2020-12-31,5116,4887,10003
4835,GMTX,-1.3217877528831592,-0.05732890266471207,568442816,2020-12-31,5309,4697,10006
4836,KZR,-0.334877120758483,-0.15587887580575768,290320448,2020-12-31,4737,5271,10008
4837,NES,-0.14222906133216093,-0.3785434677094385,35203948,2020-12-31,4422,5587,10009
4838,ALDX,-1.151239280467542,-0.06421706778243044,568851456,2020-12-31,5247,4763,10010
4839,XCUR,-0.3894298487353788,-0.14483510367428368,178559408,2020-12-31,4788,5224,10012
4840,JNCE,-0.4763850612943077,-0.12127724266370661,500184384,2020-12-31,4889,5124,10013
4841,WWR,-0.8240350581493342,-0.07945985630849499,169118848,2020-12-31,5122,4891,10013
4842,BBIO,-1.4014667962346519,-0.05694670814229674,8116612608,2020-12-31,5325,4690,10015
4843,NEON,-1.2264263074484945,-0.06121289288473435,107401824,2020-12-31,5284,4736,10020
4844,PROF,-1.4817753338570305,-0.056121307472050914,415215200,2020-12-31,5336,4684,10020
4845,USAU,-0.821128643937517,-0.0807880299349637,72992336,2020-04-30,5121,4902,10023
4846,VGZ,-0.9185689201053556,-0.07493630682508781,118330856,2020-12-31,5167,4858,10025
4847,PYPD,-0.37236726479008986,-0.15146747724828424,174891776,2020-12-31,4772,5255,10027
4848,OEG,-0.6026998134445679,-0.1008871189313905,245915696,2020-12-31,4995,5032,10027
4849,BPTS,-0.7382969709807244,-0.08538339631364199,148944016,2020-12-31,5085,4942,10027
4850,AMST,-1.547511174997119,-0.05580392100630403,74544960,2020-06-30,5349,4679,10028
4851,DCPH,-0.5487154688027971,-0.11029875989264652,2524590848,2020-12-31,4952,5079,10031
4852,SDPI,-0.3654950292698202,-0.15464415248627741,22062834,2020-12-31,4766,5266,10032
4853,RAPT,-0.5805079198848017,-0.1043393630115417,523184864,2020-12-31,4979,5055,10034
4854,RDUS,-0.9761476147614762,-0.07266595339032138,913971840,2020-12-31,5190,4844,10034
4855,ATEX,-1.6943416906425537,-0.05419644975901899,813195136,2020-03-31,5371,4664,10035
4856,SLGL,-0.5947163427492328,-0.10391055925678279,292110144,2020-12-31,4987,5049,10036
4857,FBRX,-6.0275423728813555,-0.029681362426323868,535762976,2020-12-31,5644,4393,10037
4858,VRCA,-0.6365811153358681,-0.09876242795167693,378056000,2020-12-31,5017,5022,10039
4859,AVXL,-8.054458305468232,-0.026931795742189586,1013827008,2020-09-30,5685,4354,10039
4860,CNST,-0.4653122530822786,-0.13230524456476148,1076773504,2020-12-31,4870,5170,10040
4861,ATOM,-6.411688869789429,-0.029208815718621595,547298688,2020-12-31,5656,4385,10041
4862,ALEC,-0.4478425282233423,-0.1391902836168112,1382381056,2020-12-31,4845,5199,10044
4863,SABR,-0.5896065599815037,-0.10567256301970074,4877438976,2020-12-31,4986,5062,10048
4864,MGTX,-0.43163651554061194,-0.14362085436394179,590925760,2020-12-31,4831,5218,10049
4865,FUBO,-1.1325870134455265,-0.06875169101304761,3267152640,2020-12-31,5239,4810,10049
4866,BQ,-0.41856879973676836,-0.1470832958271964,480083360,2020-03-31,4818,5232,10050
4867,RUBY,-0.9188356674818245,-0.07870129502969624,2103314432,2020-12-31,5168,4882,10050
4868,CMRX,-1.221255932621876,-0.06493631071851383,723989248,2020-12-31,5282,4770,10052
4869,CLVR,-0.67870054354696,-0.09500483099884129,317675104,2020-12-31,5055,4998,10053
4870,STG,-0.1669473482216742,-0.36655875039577646,174959200,2020-12-31,4475,5579,10054
4871,OCUL,-1.5847243935649806,-0.05735467837421606,1255910656,2020-12-31,5355,4699,10054
4872,DBI,-0.28339580463792985,-0.20271882625695956,1263414912,2021-01-30,4667,5390,10057
4873,UXIN,-0.2963613753024771,-0.19230113428490245,477997792,2020-03-31,4692,5366,10058
4874,ADAP,-0.3454826086843925,-0.17424032680346163,783446912,2020-12-31,4744,5320,10064
4875,PRLD,-5.740816725283314,-0.031976047493372586,2044653312,2020-12-31,5637,4427,10064
4876,CMCM,-0.12612164207901688,-0.8849658558480308,317619968,2020-12-31,4382,5685,10067
4877,ANNX,-0.758771982258778,-0.09154279622045383,951268992,2020-12-31,5092,4976,10068
4878,ARQT,-0.6160002123452203,-0.10787706866142188,1333254784,2020-12-31,4998,5072,10070
4879,RIDE,-0.9930233234174087,-0.07656233818071204,1933202176,2020-12-31,5197,4873,10070
4880,OCFT,-0.2810150239497127,-0.20932757250205383,5933575680,2020-12-31,4663,5408,10071
4881,ITRM,-0.6154170338301215,-0.10853672600908613,232950976,2020-12-31,4997,5074,10071
4882,PMVP,-6.269872600035887,-0.031184729117851466,1475496320,2020-12-31,5654,4417,10071
4883,VXRT,-1.6931768558951965,-0.05760907257070904,653546496,2020-12-31,5370,4702,10072
4884,INUV,-1.167926508363683,-0.06962838867688473,114604976,2020-12-31,5258,4816,10074
4885,AMPE,-2.624564893088016,-0.04649772793671357,356044768,2020-12-31,5477,4598,10075
4886,FLDM,-0.4938840287992568,-0.1332987899428586,342916192,2020-12-31,4902,5174,10076
4887,FREQ,-0.4532293620241503,-0.14365391742929254,370487360,2020-12-31,4858,5219,10077
4888,IMNM,-3.4325307950727884,-0.042653211337008584,324051840,2020-12-31,5535,4544,10079
4889,OBLG,-1.290948587979725,-0.06544900099890125,135277648,2020-12-31,5306,4774,10080
4890,EOSE,-2.3016967126193,-0.05002809071723571,888392256,2020-12-31,5448,4632,10080
4891,BLU,-0.6160146607824071,-0.1108274077801042,340474944,2020-12-31,4999,5082,10081
4892,CHS,-0.21649610888271795,-0.28735902594997426,389041248,2021-01-30,4566,5516,10082
4893,CYRN,-0.3598134194474345,-0.17495274112632997,61076504,2020-12-31,4760,5323,10083
4894,QUIK,-0.5123581847649918,-0.13073694279646167,80920752,2021-01-03,4915,5168,10083
4895,ITRG,-0.32637389688749635,-0.18900943190693625,167958816,2020-12-31,4730,5356,10086
4896,POLA,-0.8183310188107562,-0.09038469690310404,139759360,2020-12-31,5119,4969,10088
4897,SEEL,-3.3848791050162395,-0.0440348837969205,426943168,2020-12-31,5532,4562,10094
4898,CBLI,-12.6897463572585,-0.029263866316017073,90029000,2020-12-31,5708,4386,10094
4899,ICPT,-0.4351835481693401,-0.15324775004343233,731955840,2020-12-31,4833,5262,10095
4900,ROOT,-0.577647297023689,-0.12116179808409537,2985102592,2020-12-31,4975,5122,10097
4901,TLMD,-1.9439883027780902,-0.057266732163586444,626445440,2020-12-31,5412,4695,10107
4902,SOLY,-4.43442118226601,-0.039890754006208236,389798112,2020-12-31,5595,4517,10112
4903,EYES,-2.6187719660946867,-0.0508405210038018,247196656,2020-12-31,5476,4639,10115
4904,AMWL,-1.2647140601018751,-0.06974638988287084,4081462272,2020-12-31,5298,4818,10116
4905,WEI,-0.17159363382559367,-0.5096135419656854,93713800,2020-12-31,4486,5631,10117
4906,GIFI,-0.26874735326501226,-0.24754095741487325,68430848,2020-12-31,4646,5473,10119
4907,YCBD,-1.013623824694197,-0.08225012944099223,214197056,2020-09-30,5202,4918,10120
4908,CELC,-5.436659959140413,-0.03748014353252354,265418640,2020-12-31,5629,4492,10121
4909,HYRE,-1.858629080479561,-0.06025936296127714,247217664,2020-12-31,5396,4728,10124
4910,CFMS,-0.5619494077949136,-0.12987618770187756,163809888,2020-12-31,4963,5163,10126
4911,CDEV,-0.2162354335882201,-0.35292409019744264,1187874176,2020-12-31,4565,5569,10134
4912,IVA,-1.3400147868232974,-0.07008922901968388,548234816,2020-12-31,5314,4820,10134
4913,CMPS,-4.5413215180119435,-0.04175067335225284,1312707200,2020-12-31,5599,4535,10134
4914,FHTX,-0.43069023812366847,-0.17210963156750272,452477248,2020-12-31,4829,5312,10141
4915,INSM,-1.072749701712876,-0.08247191528923863,3273659136,2020-12-31,5222,4920,10142
4916,IKNA,-1.1652644440565543,-0.07928911421628852,555137344,2020-12-31,5257,4889,10146
4917,LCTX,-1.710877799189315,-0.06564595229510915,417026016,2020-12-31,5374,4776,10150
4918,AYRO,-2.2392231996087992,-0.058478250978686704,207756704,2020-12-31,5440,4710,10150
4919,LTRN,-10.063979504755027,-0.034241409532315234,191113568,2020-12-31,5697,4454,10151
4920,MGY,-0.4441540243036088,-0.17240230385131045,2838394368,2020-12-31,4839,5314,10153
4921,IMVT,-4.417064893690699,-0.04395647063039228,1536188416,2020-03-31,5594,4560,10154
4922,SELB,-0.5968843228707088,-0.12991394626041627,469719136,2020-12-31,4991,5165,10156
4923,MDVL,-2.495922283521228,-0.057082701833143866,414899296,2020-12-31,5467,4693,10160
4924,EQ,-0.503544648943422,-0.1518945467328546,202991696,2020-12-31,4906,5256,10162
4925,TRIL,-1.3795232109185598,-0.07286850602466918,1069550464,2020-12-31,5320,4846,10166
4926,DYAI,-1.1829704707319437,-0.08071121002340477,142455216,2020-12-31,5267,4901,10168
4927,GTYH,-0.9669166299073666,-0.09317690438693614,341260288,2020-12-31,5187,4986,10173
4928,JG,-0.2588116307738609,-0.3162173164380691,461734784,2020-12-31,4639,5539,10178
4929,SWIR,-0.5187916470857583,-0.15217254351794024,554417664,2020-12-31,4922,5257,10179
4930,EEX,-0.6716196136701337,-0.12343284525728845,396782048,2020-12-31,5049,5132,10181
4931,CMPI,-0.4206926426666059,-0.19088952532524256,228506480,2020-12-31,4821,5361,10182
4932,PASG,-0.596047725577927,-0.13865959042052087,920853760,2020-12-31,4989,5193,10182
4933,PCSA,-6.044935600351228,-0.04129264766090245,170034288,2020-12-31,5648,4534,10182
4934,RPTX,-1.89529161285819,-0.0659662069925161,1138349056,2020-12-31,5401,4782,10183
4935,TGTX,-4.298885973319925,-0.04685889633279181,6296846848,2020-12-31,5587,4599,10186
4936,CBAY,-0.42509230388912367,-0.19166063979699094,296468224,2020-12-31,4823,5364,10187
4937,SOLO,-1.8985209523608848,-0.06632018528197363,535183904,2020-12-31,5402,4788,10190
4938,KROS,-6.9101007109004735,-0.04088153075115455,1399965312,2020-12-31,5662,4528,10190
4939,AACG,-0.24599732319196588,-0.36054729460148727,127283032,2020-12-31,4618,5576,10194
4940,NINE,-0.3794425118347439,-0.22006711309865207,67358576,2020-12-31,4774,5421,10195
4941,MUX,-0.328193378645034,-0.24170537003325812,546432576,2020-12-31,4732,5464,10196
4942,HEXO,-0.35168320221810223,-0.23546108425788811,788100608,2020-07-31,4751,5447,10198
4943,RMBL,-0.567550939664042,-0.14800478662474917,89133664,2020-12-31,4968,5237,10205
4944,CEI,-0.5514022053811212,-0.15132893378110493,31848512,2020-03-31,4954,5254,10208
4945,CASI,-0.6193043445929617,-0.14193870313641033,283787904,2020-12-31,5002,5209,10211
4946,KBNT,-3.495349042850469,-0.0549294571923294,103218840,2020-12-31,5539,4672,10211
4947,ANVS,-28.074195430484856,-0.03754200055273102,184370736,2020-12-31,5720,4493,10213
4948,ACB,-0.385354019431994,-0.2235580434442428,1761524736,2020-06-30,4784,5430,10214
4949,NEX,-0.3792510528039939,-0.23280109007102046,813304768,2020-12-31,4773,5443,10216
4950,RIBT,-0.4027400693371204,-0.21390160792247898,41406800,2020-12-31,4802,5416,10218
4951,LABP,-1.5886069394096323,-0.07537364155940428,398367776,2020-12-31,5358,4863,10221
4952,SIEN,-0.6970579635169482,-0.12731201921590898,410650272,2020-12-31,5070,5152,10222
4953,STOK,-3.8092639138240574,-0.05393176649371167,1259422080,2020-12-31,5561,4663,10224
4954,IMRN,-1.043971638312973,-0.09748978289254527,32654218,2020-06-30,5212,5013,10225
4955,AKRO,-0.9695774716036241,-0.10132063536353456,965223552,2020-12-31,5188,5038,10226
4956,ARLO,-0.4733048380326507,-0.18645224715141492,511198464,2020-12-31,4880,5348,10228
4957,NTNX,-0.713429773952765,-0.1269170457696686,5595283968,2020-07-31,5079,5149,10228
4958,ONCT,-3.1773229487411703,-0.05909063507685313,407744992,2020-12-31,5517,4716,10233
4959,ADMA,-0.42622707336623766,-0.20988476871981396,216559200,2020-12-31,4825,5410,10235
4960,MDGL,-0.8909317423504358,-0.110652668073957,1875210368,2020-12-31,5156,5080,10236
4961,AXDX,-1.1232565567661568,-0.09588944112858522,543077248,2020-12-31,5235,5003,10238
4962,LIZI,-0.35286043374989556,-0.2596292781146228,368428608,2020-12-31,4753,5486,10239
4963,DWSN,-0.2315559527355774,-0.5771770531035889,57756128,2020-12-31,4591,5651,10242
4964,CLIR,-5.884550084889644,-0.04705434633095839,154812016,2020-12-31,5641,4602,10243
4965,MACK,-1.9166347992351815,-0.07242279747129415,82472728,2020-12-31,5406,4841,10247
4966,SMIT,-0.8721666073865553,-0.11592955081382,27642358,2020-05-31,5149,5099,10248
4967,IMAC,-0.635571820160415,-0.1471367886720454,41531592,2020-12-31,5016,5233,10249
4968,SGTX,-0.7991802034310005,-0.12418359934412414,559308608,2020-12-31,5111,5138,10249
4969,BCEL,-0.43132792064408737,-0.2167814453756222,453364576,2020-12-31,4830,5420,10250
4970,KNSA,-0.6698492697607301,-0.13989842927570095,1207029504,2020-12-31,5048,5203,10251
4971,SNSE,-7.993592481845365,-0.04444718701299417,432215520,2020-12-31,5684,4568,10252
4972,RAIL,-0.3557877439915018,-0.2713777230001859,92750384,2020-12-31,4757,5497,10254
4973,APA,-0.36196013289036544,-0.2673011158792865,6523710464,2020-12-31,4763,5491,10254
4974,ATXI,-7.016150740242261,-0.04627773272808131,114891968,2020-12-31,5667,4592,10259
4975,NURO,-0.5725158254377034,-0.16149728155967014,13745364,2020-12-31,4971,5290,10261
4976,AERI,-0.6442815819639229,-0.148740265771694,883448960,2020-12-31,5022,5242,10264
4977,LHDX,-1.0463782366437233,-0.10420958273523398,331014784,2020-12-31,5215,5053,10268
4978,RDHL,-0.7526601156207734,-0.13480998848974293,341137952,2020-12-31,5090,5181,10271
4979,MICT,-1.5389399424487145,-0.08312637061491474,221505328,2020-12-31,5346,4926,10272
4980,QURE,-1.2400858190878261,-0.09387353917471986,1518097664,2020-12-31,5286,4991,10277
4981,NAK,-0.4547199441633223,-0.21617039137541522,324376320,2020-12-31,4860,5418,10278
4982,JAN,-0.46570378423150594,-0.20943208936352714,22736258,2021-01-02,4871,5409,10280
4983,ENZ,-0.5054343303207337,-0.19429662280772472,166870960,2020-07-31,4909,5371,10280
4984,CSPR,-0.537099925735257,-0.18197822792664092,313440672,2020-12-31,4941,5340,10281
4985,AXSM,-7.380660320527548,-0.047533806960466995,1982106880,2020-12-31,5672,4610,10282
4986,EFOI,-0.5108857001484414,-0.195521275105488,15136021,2020-12-31,4912,5374,10286
4987,YMTX,-0.5380021287499507,-0.18687931010307002,182774832,2020-12-31,4942,5349,10291
4988,ZYME,-0.6871070508144015,-0.1470341924587528,1431087104,2020-12-31,5062,5231,10293
4989,ARDX,-0.8653626172500571,-0.12640171819451226,734181440,2020-12-31,5146,5147,10293
4990,PTPI,-0.35949927576099183,-0.31235045591460336,30574654,2020-12-31,4759,5536,10295
4991,TTOO,-0.6674249090939279,-0.15086429625005338,227192752,2020-12-31,5044,5251,10295
4992,FSTX,-0.5196011200640036,-0.1949583439898411,94825336,2020-12-31,4923,5373,10296
4993,COMS,-0.8045875964093742,-0.13683560480624377,164444336,2020-12-31,5113,5188,10301
4994,OPT,-2.572575185348546,-0.07072970876142746,413976576,2020-06-30,5472,4832,10304
4995,PSTI,-0.5330777299526169,-0.1935616900727728,152565200,2020-06-30,4938,5367,10305
4996,BIOL,-1.0364571684186983,-0.11533187730778863,150873792,2020-12-31,5208,5097,10305
4997,PSTX,-0.4500208031805752,-0.23969659047269004,552762944,2020-12-31,4848,5459,10307
4998,TERN,-1.5885785386364613,-0.08740863678637417,475618144,2020-12-31,5357,4952,10309
4999,MRUS,-1.2205707299810185,-0.0994635308531526,879208576,2020-12-31,5281,5029,10310
5000,ADMS,-0.8472471606273662,-0.13382165732197593,203144160,2020-12-31,5137,5176,10313
5001,ITOS,-2.646532438478747,-0.07173174872665534,948024000,2020-12-31,5478,4836,10314
5002,DYN,-1.195852534562212,-0.1025243761069965,861914816,2020-12-31,5272,5044,10316
5003,ADAG,-2.2127748145340336,-0.07778944919198337,610763456,2020-12-31,5439,4877,10316
5004,PLXP,-3.1669825230327295,-0.06749510827518897,218315040,2020-12-31,5516,4801,10317
5005,SQZ,-0.5329923273657289,-0.19980631255520911,380701472,2020-12-31,4937,5381,10318
5006,CREX,-0.680045294413689,-0.1533073602395645,21490972,2020-12-31,5056,5263,10319
5007,MGTA,-0.789332744942682,-0.1427081602564878,598211136,2020-12-31,5107,5212,10319
5008,ENSV,-0.4273939033898934,-0.2692375126280369,18930072,2020-12-31,4828,5493,10321
5009,GBT,-1.1617735227781003,-0.10768969639967087,2534136832,2020-12-31,5254,5069,10323
5010,VIRX,-3.2259088999007832,-0.06763976400238746,314824064,2020-12-31,5524,4802,10326
5011,ASXC,-1.5031728752356424,-0.093955131248617,607057216,2020-12-31,5338,4993,10331
5012,IMTX,-1.059562891361177,-0.11859287995668566,734772480,2020-12-31,5221,5112,10333
5013,EXPR,-0.3113458929246647,-0.4679126098172958,246251456,2021-01-30,4712,5622,10334
5014,TBPH,-0.7818940955582107,-0.14826683170952296,1366310912,2020-12-31,5101,5239,10340
5015,EQOS,-1.418732528588414,-0.09775711407013135,411984096,2020-03-31,5328,5015,10343
5016,AEY,-0.4772645532548939,-0.2381419218178712,33637152,2020-09-30,4890,5455,10345
5017,CWBR,-0.7225577008157429,-0.15496707750222355,84649968,2020-12-31,5081,5267,10348
5018,ATIF,-0.8247422273731304,-0.14545088841986842,68825752,2020-07-31,5123,5226,10349
5019,SESN,-2.0893192564285252,-0.08269951480353362,424390656,2020-12-31,5431,4921,10352
5020,FLXN,-0.677516861625417,-0.1661507875153292,405382880,2020-12-31,5054,5301,10355
5021,LIVX,-1.454194596790575,-0.09872061176055794,307197920,2020-03-31,5334,5021,10355
5022,FDMT,-2.746413338503296,-0.07594388339943049,1006111872,2020-12-31,5486,4869,10355
5023,MOVE,-9.855368234250221,-0.05390013349103017,199171280,2020-12-31,5693,4662,10355
5024,ASMB,-0.3423474157252751,-0.4353272129348152,174657680,2020-12-31,4742,5614,10356
5025,ATNX,-0.5009839650145773,-0.23712704301115003,383164288,2020-12-31,4905,5451,10356
5026,EIGR,-0.5645290217095104,-0.2046200803437952,284771744,2020-12-31,4965,5393,10358
5027,RETA,-1.8153635138603696,-0.09045996748526833,3200883456,2020-12-31,5388,4970,10358
5028,ISEE,-0.644935278256256,-0.18187948706508408,529126496,2020-12-31,5023,5339,10362
5029,ONCR,-0.6930107627166067,-0.1643524583036756,350377856,2020-12-31,5066,5298,10364
5030,ORTX,-0.6742682430821447,-0.17228004558356946,820541824,2020-12-31,5052,5313,10365
5031,BCRX,-1.7858588129496402,-0.09244061343992459,1812499584,2020-12-31,5383,4984,10367
5032,VTGN,-4.05740422875868,-0.06668337990703314,310528096,2020-03-31,5573,4795,10368
5033,IPWR,-5.76183965859315,-0.06081949382274331,66295444,2020-12-31,5639,4731,10370
5034,ABEO,-0.48532634254209983,-0.24776208073071793,164977456,2020-12-31,4899,5474,10373
5035,AVCO,-1.0794604670883337,-0.12721709683638505,92846160,2020-12-31,5223,5151,10374
5036,JAGX,-2.3219618528610355,-0.08381374640490802,236631648,2020-12-31,5451,4928,10379
5037,AGEN,-0.6544775530006431,-0.1874398939874832,570047744,2020-12-31,5031,5350,10381
5038,HYMC,-0.5124616576108499,-0.2417659747943112,239605200,2020-12-31,4918,5465,10383
5039,UTSI,-0.3914083155111732,-0.3869395910103626,54247808,2020-12-31,4793,5593,10386
5040,MTCR,-0.46145719352526127,-0.29495945879111674,135384976,2020-12-31,4866,5520,10386
5041,GTH,-0.46282375190764447,-0.29307435248916675,2012002816,2020-12-31,4868,5518,10386
5042,HRTX,-0.8978188169895882,-0.14695022727141516,1517181824,2020-12-31,5160,5229,10389
5043,ZGNX,-0.6215817588583775,-0.20051052852636025,1074025088,2020-12-31,5006,5385,10391
5044,BCYC,-1.91078586400912,-0.09329391020446061,655305536,2020-12-31,5404,4988,10392
5045,DBTX,-0.9646637442531808,-0.14203356743172896,262462864,2020-12-31,5184,5210,10394
5046,IFRX,-0.5642489951786629,-0.22921156344744123,163955616,2020-12-31,4964,5437,10401
5047,IMMP,-4.380461802224349,-0.06848284119866192,234253264,2020-06-30,5593,4808,10401
5048,PED,-0.4660154043291952,-0.3052193648448368,116779104,2020-12-31,4872,5530,10402
5049,OPTT,-3.1861508270255117,-0.07874306201913035,152430176,2020-04-30,5518,4886,10404
5050,SRTS,-0.8324345484024018,-0.15723294952617142,62151464,2020-12-31,5132,5273,10405
5051,TARS,-6.043877322587867,-0.06385124686788798,585568512,2020-12-31,5647,4760,10407
5052,AIM,-0.613957524171556,-0.2116658465368909,107599272,2020-12-31,4996,5413,10409
5053,BLUE,-0.44370217708785603,-0.3543416462867994,1890690560,2020-12-31,4838,5572,10410
5054,CHEK,-1.2581956109455432,-0.11892066335810238,121875736,2020-12-31,5296,5115,10411
5055,SCPS,-2.733272581060147,-0.08391102216576805,119057936,2020-12-31,5484,4929,10413
5056,CRNX,-0.8628180039138943,-0.1557609520067492,563803328,2020-12-31,5145,5270,10415
5057,PLAG,-0.6618917138528079,-0.1976174653676805,44622076,2020-12-31,5039,5379,10418
5058,PRTK,-1.0934051611782083,-0.13848314559755212,375951584,2020-12-31,5226,5192,10418
5059,RVPH,-7.456520873594619,-0.0619742427653791,46712604,2020-12-31,5674,4744,10418
5060,GRAY,-0.4529401940391419,-0.34792133562979455,112164520,2020-12-31,4856,5564,10420
5061,KALA,-0.6677347880351708,-0.19710210174906773,465951680,2020-12-31,5045,5378,10423
5062,PLSE,-2.4444716242661446,-0.08857829093427173,568955264,2020-12-31,5463,4960,10423
5063,ACOR,-0.4751145876217922,-0.3184244771557202,39762556,2020-12-31,4886,5541,10427
5064,EB,-2.077939788104479,-0.0950667931446788,2136282880,2020-12-31,5429,4999,10428
5065,TBLT,-0.7844310766709925,-0.17632122526496702,75645360,2020-12-31,5103,5328,10431
5066,ACIU,-0.809642758019111,-0.1737450226276941,499460640,2020-12-31,5114,5318,10432
5067,FET,-0.4075706933831246,-0.48559170729743717,109532864,2020-12-31,4809,5625,10434
5068,ARMP,-0.6979533770894629,-0.19225931079414504,115224648,2020-12-31,5072,5365,10437
5069,TFFP,-9.060020975984242,-0.0620878979357347,335062400,2020-12-31,5692,4745,10437
5070,VRPX,-1.0410841399215511,-0.14639563145160012,24033430,2020-12-31,5211,5228,10439
5071,AYTU,-1.1624379703797378,-0.13522336405318883,169418416,2020-06-30,5255,5185,10440
5072,SVRA,-0.6587380655873807,-0.2085792249326213,217846208,2020-12-31,5036,5406,10442
5073,CRKN,-1.2683987517827455,-0.12580337009922532,55002028,2020-03-31,5299,5144,10443
5074,INBX,-2.285506116777932,-0.09555447209891023,773827840,2020-12-31,5444,5001,10445
5075,KERN,-0.9914573220989008,-0.1508084695603687,107689216,2020-12-31,5196,5250,10446
5076,FGEN,-0.9131576943577249,-0.15939930023142307,1700278400,2020-12-31,5166,5282,10448
5077,NKLA,-2.8741767331522925,-0.08710893687742842,5016908800,2020-12-31,5497,4951,10448
5078,CHMA,-0.4510393523838709,-0.40283790750040177,174109232,2020-12-31,4851,5600,10451
5079,OTLK,-2.376090737018418,-0.09445342421723024,380197152,2020-09-30,5455,4996,10451
5080,NMTR,-3.693273596168276,-0.08031410552308633,288155488,2020-12-31,5555,4898,10453
5081,CRDF,-3.0676343948362286,-0.08593277214486747,343472992,2020-12-31,5508,4946,10454
5082,AFIB,-0.6454342228133224,-0.22442183409853284,370853984,2020-12-31,5025,5432,10457
5083,CNTB,-3.453074498624857,-0.08281558379214789,977571392,2020-12-31,5536,4923,10459
5084,ENOB,-3.547211796820894,-0.08246471666967743,146173136,2020-06-30,5543,4919,10462
5085,EYEN,-1.1470600117886913,-0.14389227292155704,147335696,2020-12-31,5242,5221,10463
5086,KZIA,-3.6151793655499556,-0.08183768268111684,152699264,2020-06-30,5550,4913,10463
5087,DAO,-0.5305335673131077,-0.3033870227052169,3167714560,2020-12-31,4936,5529,10465
5088,YTEN,-0.8576863846362895,-0.17612448451778723,55366432,2020-12-31,5139,5326,10465
5089,CERE,-1.811777766564061,-0.10967780464771305,1663510400,2020-12-31,5387,5078,10465
5090,ABUS,-0.6998105944889106,-0.2070776717615437,319268064,2020-12-31,5073,5403,10476
5091,BHVN,-1.3812092975476338,-0.128882231034677,4483919360,2020-12-31,5321,5158,10479
5092,AVGR,-1.4421610871726882,-0.12646037610728397,142947136,2020-12-31,5333,5148,10481
5093,ARCT,-1.5084995992744759,-0.12485814763968663,972371072,2020-12-31,5340,5141,10481
5094,VISL,-1.7310300974989403,-0.1174969622280428,135097360,2020-12-31,5376,5108,10484
5095,KIN,-0.6475032421563611,-0.24036669369698832,212634400,2020-12-31,5026,5461,10487
5096,KPTI,-0.7717282941593843,-0.20353433481748415,752116288,2020-12-31,5095,5392,10487
5097,ANIX,-3.5591501443713027,-0.08538355101134332,122091752,2020-10-31,5545,4943,10488
5098,CTXR,-5.390113799740213,-0.07518616154705078,245155808,2020-09-30,5627,4861,10488
5099,QTT,-0.5484397607486875,-0.3178116704495215,681356032,2020-12-31,4951,5540,10491
5100,AWRE,-0.832999140647379,-0.18976860933108175,78668776,2020-12-31,5133,5359,10492
5101,SFT,-1.2512471283229405,-0.13940213593813428,734090880,2020-12-31,5291,5201,10492
5102,NYMX,-13.363740022805016,-0.06597033514416274,179436608,2020-12-31,5709,4783,10492
5103,POAI,-0.9386713099677957,-0.17318792631361282,63422296,2020-12-31,5177,5316,10493
5104,SENS,-3.8509830640451623,-0.08417232566087073,884246208,2020-12-31,5563,4932,10495
5105,BIOC,-0.6257692024195687,-0.2587644775359818,61651040,2020-12-31,5012,5484,10496
5106,MRSN,-2.4151636423441696,-0.10110685603215414,1091568256,2020-12-31,5460,5036,10496
5107,PRAX,-4.9641913001682285,-0.07874062492528484,1067876928,2020-12-31,5612,4885,10497
5108,CSSEP,-0.5782388737482671,-0.29631067256162524,95689688,2020-12-31,4976,5522,10498
5109,LJPC,-1.9494119420989144,-0.11253727478965883,111907872,2020-12-31,5413,5085,10498
5110,BTU,-0.417336217552534,-0.8507356134360851,326439648,2020-12-31,4816,5683,10499
5111,XPEV,-0.450647260144936,-0.5712314831193804,27243755520,2020-12-31,4850,5649,10499
5112,XERS,-0.6910567732783951,-0.22851999188914016,280526848,2020-12-31,5064,5435,10499
5113,PUYI,-0.38958562309388806,-4.736700883056126,249702848,2020-06-30,4789,5715,10504
5114,RKDA,-0.5412867115275769,-0.3394960123122625,56327572,2020-12-31,4946,5558,10504
5115,FTSI,-0.527048741296197,-0.35843455369710964,325827104,2020-12-31,4934,5573,10507
5116,GNLN,-0.5764806069520787,-0.3156087016316441,98703864,2020-12-31,4974,5538,10512
5117,EYEG,-0.7085515013377862,-0.23171145274661126,32792344,2020-12-31,5077,5440,10517
5118,VRDN,-0.474907897222747,-0.5155688750484303,113231976,2020-12-31,4885,5634,10519
5119,AAMC,-0.41867396097003345,-1.861866398059229,39534828,2020-12-31,4819,5703,10522
5120,CRMD,-4.338155107869183,-0.08414816045115918,361229888,2020-12-31,5591,4931,10522
5121,UBX,-0.6585609838621886,-0.2632872209685949,318898080,2020-12-31,5035,5488,10523
5122,VRAY,-1.1179244287854173,-0.1638058251927767,689836224,2020-12-31,5232,5295,10527
5123,WTER,-1.4378490041154222,-0.13872491023901806,94222440,2020-03-31,5332,5195,10527
5124,IDBA,-4.196122059758423,-0.0868576556920682,307101600,2020-12-31,5580,4950,10530
5125,TRVN,-1.2511669354154291,-0.14932577979709966,290293184,2020-12-31,5290,5244,10534
5126,PXLW,-1.0952699986600563,-0.17114269272208196,163946944,2020-12-31,5227,5310,10537
5127,VNRX,-2.08429940326993,-0.11856693712082998,189806528,2020-12-31,5430,5111,10541
5128,TSHA,-7.007006680788659,-0.0773361495139372,800164096,2020-12-31,5665,4876,10541
5129,RNA,-4.886007503862282,-0.0845392886955095,830619648,2020-12-31,5610,4933,10543
5130,RVNC,-1.657555010340531,-0.13470096879725166,2008000768,2020-12-31,5365,5179,10544
5131,CLSD,-1.9601092896174863,-0.12334950317970053,152743856,2020-12-31,5416,5131,10547
5132,CUEN,-1.8101694915254238,-0.13186454991962188,50441540,2020-12-31,5386,5169,10555
5133,NLTX,-1.8704537270435722,-0.12905961340381328,506642240,2020-12-31,5398,5159,10557
5134,CGA,-0.46108033086608424,-1.1448614336349718,49277012,2020-06-30,4865,5693,10558
5135,MREO,-5.3877814427075865,-0.08472466650608619,441639584,2020-12-31,5626,4935,10561
5136,MTEM,-0.8978977642041154,-0.20640176645624364,461310400,2020-12-31,5161,5401,10562
5137,RYTM,-1.679496796566608,-0.13872606190003506,1067354176,2020-12-31,5367,5196,10563
5138,NOVN,-2.5026816187225744,-0.11522121809438499,224446432,2020-12-31,5470,5095,10565
5139,SCPH,-0.8416893962826533,-0.22600443428658132,178084304,2020-12-31,5135,5433,10568
5140,CLXT,-0.9567174438457615,-0.2025826078039777,221820720,2020-12-31,5180,5389,10569
5141,GTHX,-3.011957166494958,-0.10614217420117529,1072901824,2020-12-31,5507,5063,10570
5142,ZSAN,-0.6695965005518989,-0.30144223333230025,128610904,2020-12-31,5047,5526,10573
5143,YI,-0.6252457067371202,-0.34779823102923124,920778112,2020-12-31,5011,5563,10574
5144,UCL,-0.9611903853491034,-0.20301196496087365,291687872,2020-12-31,5183,5391,10574
5145,EYPT,-2.186085299023112,-0.12412972547997549,287702432,2020-12-31,5437,5137,10574
5146,TYME,-3.705403395515894,-0.09904562460044934,281204544,2020-03-31,5556,5025,10581
5147,PRQR,-1.7643115186883425,-0.14006332513571343,411976832,2020-12-31,5380,5204,10584
5148,OTIC,-0.5825530147758174,-0.42164564104099533,107751368,2020-12-31,4982,5605,10587
5149,MNOV,-7.5446429094051535,-0.0818075030449925,231156048,2020-12-31,5675,4912,10587
5150,CPG,-0.5123894485887872,-0.6967230411346321,2082983424,2020-12-31,4916,5672,10588
5151,CUE,-1.7165362195604312,-0.1427819077036223,374014400,2020-12-31,5375,5213,10588
5152,MRIN,-0.5161301334789882,-0.6831927092370872,18809920,2020-12-31,4920,5669,10589
5153,LIFE,-0.7821363614019564,-0.2609931064094697,72051296,2020-12-31,5102,5487,10589
5154,THMO,-0.8725721012360211,-0.2325652414134403,32638332,2020-12-31,5150,5441,10591
5155,TCON,-1.7365660458146008,-0.14327442658082482,133427256,2020-12-31,5377,5215,10592
5156,MRKR,-1.1708525139403938,-0.1784517277583117,176819632,2020-12-31,5261,5332,10593
5157,CEMI,-0.8286891273329915,-0.24385906181970587,82546016,2020-12-31,5125,5469,10594
5158,INMB,-18.61307881998356,-0.07860116912502065,175756704,2020-12-31,5716,4881,10597
5159,FULC,-1.0462408321888788,-0.20031496760061837,387819008,2020-12-31,5214,5384,10598
5160,RGLS,-1.2003900949796473,-0.1757345443237407,100056624,2020-12-31,5273,5325,10598
5161,PULM,-1.0510497708621975,-0.20061704285515278,72561336,2020-12-31,5216,5386,10602
5162,SYBX,-0.5530190784539685,-0.5606258032583016,132060472,2020-12-31,4958,5646,10604
5163,CTEK,-0.7264148625349338,-0.294968501230832,24483814,2020-12-31,5083,5521,10604
5164,CFRX,-0.9609580563716438,-0.22036500477278745,164801504,2020-12-31,5182,5422,10604
5165,PIRS,-0.6832437005257115,-0.3248421784714588,152714016,2020-12-31,5059,5547,10606
5166,AGTC,-0.790229449691093,-0.2717886591026099,188538080,2020-06-30,5108,5498,10606
5167,EPZM,-0.908228676876463,-0.2355514451436865,851940416,2020-12-31,5164,5448,10612
5168,LTRPA,-0.654510556621881,-0.3702705698440181,569948160,2020-12-31,5033,5582,10615
5169,LTRPB,-0.654510556621881,-0.37283453329635863,563614848,2020-12-31,5033,5583,10616
5170,CLBS,-1.0365457498646453,-0.20875076216653307,104718240,2020-12-31,5209,5407,10616
5171,AKER,-0.6958842993865637,-0.33114363377550493,53455488,2020-12-31,5069,5551,10620
5172,LBPS,-2.794787508804884,-0.12344610841199098,292748928,2020-12-31,5489,5133,10622
5173,HX,-0.5459186102822902,-0.7041930702734477,33048918,2020-03-31,4950,5674,10624
5174,MOSY,-1.5220745820831547,-0.16001666949208068,22817438,2020-12-31,5343,5283,10626
5175,YVR,-1.416370205465613,-0.16487606195868254,44966428,2020-11-30,5327,5300,10627
5176,ZIOP,-2.423139548908455,-0.13009785736740567,714397568,2020-12-31,5461,5167,10628
5177,RCEL,-6.022153238323691,-0.09328541224322873,523439904,2020-06-30,5643,4987,10630
5178,PHGE,-0.9585630108344422,-0.23815829540809272,156365952,2020-12-31,5181,5456,10637
5179,ATRA,-0.812016878701412,-0.2989261308082301,1151377152,2020-12-31,5115,5524,10639
5180,SLS,-1.848079225160518,-0.14975230464405337,136366592,2020-12-31,5393,5246,10639
5181,MCHX,-0.965483234714004,-0.2390548492164403,119376656,2020-12-31,5185,5457,10642
5182,NEPT,-0.8321746085011779,-0.2856645761891205,230049808,2020-03-31,5131,5512,10643
5183,CRVS,-0.667001996738153,-0.40976913591899905,111097840,2020-12-31,5043,5601,10644
5184,KDMN,-1.3864098462873098,-0.17476248766234692,628850176,2020-12-31,5322,5322,10644
5185,NSPR,-1.6844421872354833,-0.15738610623925978,72160320,2020-12-31,5368,5276,10644
5186,ESPR,-2.4574089068825913,-0.13598149479547844,753053120,2020-12-31,5464,5186,10650
5187,DRIO,-5.126521515515172,-0.10105876247163069,317453152,2020-12-31,5618,5034,10652
5188,AGRX,-0.8962398596798947,-0.2696702551745925,172628928,2020-12-31,5159,5494,10653
5189,AKBA,-0.7870023755568424,-0.3290546198602905,469716096,2020-12-31,5105,5550,10655
5190,ECOR,-0.9724589610012855,-0.24269801939813548,95014528,2020-12-31,5189,5468,10657
5191,SMMT,-3.191876067333496,-0.12451842675709743,466818208,2020-12-31,5519,5140,10659
5192,QLGN,-1.1800230989518472,-0.20492452312362788,74829816,2020-12-31,5266,5394,10660
5193,LIXT,-124.5211954864288,-0.08490916177456312,43322560,2020-12-31,5724,4936,10660
5194,CLVS,-0.9322646724912385,-0.2646862263505991,651221888,2020-12-31,5173,5489,10662
5195,GMDA,-1.5298479974461607,-0.17406048019995263,463537568,2020-12-31,5345,5319,10664
5196,DADA,-0.6330267130359142,-0.5892207277590985,6044065792,2020-12-31,5015,5655,10670
5197,VBLT,-0.9217302913937203,-0.27307090568305137,95383032,2020-12-31,5170,5501,10671
5198,GOEV,-3.617424379641369,-0.12086593161466373,2320003840,2020-12-31,5551,5120,10671
5199,SNOA,-0.7594489981785064,-0.3684447379286988,16931836,2020-03-31,5093,5580,10673
5200,HOOK,-1.437609604748415,-0.18289106451475523,408411296,2020-12-31,5331,5342,10673
5201,GLMD,-0.7869646764613942,-0.35292986226365963,84532744,2020-12-31,5104,5570,10674
5202,RESN,-3.1619004728664715,-0.12968742651861648,235668448,2020-12-31,5515,5162,10677
5203,XSPA,-1.0384275823614144,-0.24471180290533837,165292752,2020-12-31,5210,5470,10680
5204,FBIO,-1.0559424092575773,-0.2414985335599718,516296256,2020-12-31,5218,5463,10681
5205,HGEN,-11.90738490616984,-0.09172964871482142,1008821376,2020-12-31,5707,4977,10684
5206,BDR,-0.9339635026913483,-0.28586261878126246,16861080,2020-12-31,5174,5513,10687
5207,PRTA,-2.0341019811627152,-0.15378425323455755,1002597952,2020-12-31,5423,5264,10687
5208,INPX,-1.292242114236999,-0.19988263565382272,119630752,2020-12-31,5307,5382,10689
5209,MIRM,-1.0906543131124056,-0.242540606622019,553638592,2020-12-31,5225,5466,10691
5210,MIST,-0.6944387384796571,-0.49773278837858426,168032976,2020-12-31,5068,5628,10696
5211,OPGN,-1.5619800460341977,-0.18599982232923465,102171560,2020-12-31,5351,5346,10697
5212,RWLK,-2.2029730225729494,-0.152296927956296,94501712,2020-12-31,5438,5259,10697
5213,ACRX,-1.1289549112556498,-0.24091885934215618,166527200,2020-12-31,5236,5462,10698
5214,SLRX,-2.5165608611647805,-0.1458448851968213,61733332,2020-12-31,5471,5227,10698
5215,LNSR,-0.7731717509402424,-0.41469844416583707,76747552,2020-12-31,5096,5603,10699
5216,AGE,-2.2968144640551014,-0.1512239660523666,61834212,2020-12-31,5446,5253,10699
5217,EDSA,-26.17385330667223,-0.0921872615058404,75116880,2020-09-30,5719,4980,10699
5218,DUOT,-1.8597850648766339,-0.16706075167401876,39262960,2020-12-31,5397,5303,10700
5219,GNPX,-5.521652132104658,-0.10810749467664099,193014528,2020-12-31,5630,5073,10703
5220,NUZE,-2.4096667213159195,-0.1498256015700771,65401972,2020-09-30,5458,5247,10705
5221,ADCT,-2.482963046928134,-0.14834859053621285,1840553472,2020-12-31,5466,5240,10706
5222,ARDS,-0.9786797151470138,-0.28998822545018793,62763964,2020-12-31,5192,5517,10709
5223,EVGN,-1.9437568541438195,-0.16461641151985304,187291312,2020-12-31,5411,5299,10710
5224,SYN,-3.974960876369327,-0.1260548282919839,83860848,2020-12-31,5567,5146,10713
5225,SPRB,-3.4121331632061245,-0.13519710962772188,363043616,2020-12-31,5534,5184,10718
5226,ALGS,-2.317757894238508,-0.15571252375365002,818934464,2020-12-31,5450,5269,10719
5227,WBAI,-0.9268856695912399,-0.3366704205933824,801758592,2020-12-31,5172,5557,10729
5228,EKSO,-2.0625601539942253,-0.16625646910670858,82151344,2020-12-31,5428,5302,10730
5229,INVO,-2.362770392140902,-0.1589077200900619,42515232,2020-12-31,5452,5279,10731
5230,INFI,-3.3876275959169306,-0.13955703450977167,293397376,2020-12-31,5533,5202,10735
5231,YMAB,-6.0429787877261045,-0.1138848941526722,1148223744,2020-12-31,5646,5091,10737
5232,AQST,-1.3332400845455676,-0.2221197807314806,169481520,2020-12-31,5311,5427,10738
5233,GENE,-4.959296232785781,-0.12224728685561578,73114976,2020-06-30,5611,5127,10738
5234,LEXX,-3.2255018961774966,-0.14339362290077368,27971728,2020-08-31,5523,5217,10740
5235,TOUR,-0.7051791583766622,-0.6596834221935357,430554336,2020-12-31,5074,5667,10741
5236,PCVX,-4.286582448081156,-0.12824674969556984,1037844032,2020-12-31,5586,5155,10741
5237,SPRO,-1.1792597671680056,-0.2511123177757392,385916256,2020-12-31,5265,5478,10743
5238,MYOV,-2.966887491958875,-0.14844069528185863,1648009088,2020-03-31,5502,5241,10743
5239,ENTX,-3.130161334427126,-0.1474558804585856,82950000,2020-12-31,5514,5235,10749
5240,PSTV,-0.8611817648209744,-0.4337149282382365,20103742,2020-12-31,5141,5612,10753
5241,PIXY,-1.100903430594555,-0.30064711060706345,52464272,2020-08-31,5229,5525,10754
5242,GOVX,-4.016229942483012,-0.13616277571812213,29745864,2020-12-31,5569,5187,10756
5243,ASTC,-1.5112683926243249,-0.21643441978397315,36156416,2020-06-30,5341,5419,10760
5244,CLSN,-2.3837812612869578,-0.16748478797551616,116852888,2020-12-31,5456,5304,10760
5245,LPCN,-3.591879389988232,-0.14329268836453685,135967520,2020-12-31,5547,5216,10763
5246,SGLB,-4.328837538485215,-0.13364760975984905,39450296,2020-12-31,5589,5175,10764
5247,SINO,-1.9091336244363357,-0.19148055182781049,85093416,2020-06-30,5403,5362,10765
5248,AGLE,-1.1762981997719038,-0.2747625605819057,370202592,2020-12-31,5263,5503,10766
5249,VLON,-3.740625,-0.14136479859443,31739818,2020-12-31,5558,5208,10766
5250,SFET,-1.5563753310631858,-0.22163992313968212,43401764,2020-12-31,5350,5425,10775
5251,CBIO,-0.9661002476304329,-0.3834281811430495,160101408,2020-12-31,5186,5590,10776
5252,MBOT,-1.430437519672647,-0.23484450652991234,57007204,2020-12-31,5330,5446,10776
5253,TELA,-2.8705281090289607,-0.1590173581649471,198120912,2020-12-31,5496,5280,10776
5254,DTIL,-1.288184100025804,-0.2478558800880528,490081344,2020-12-31,5304,5475,10779
5255,CKPT,-6.13945488224398,-0.12319884153900666,221876576,2020-12-31,5651,5130,10781
5256,ONTX,-4.636920222634508,-0.13480843124820707,194400416,2020-12-31,5602,5180,10782
5257,NVFY,-0.7153606855903321,-2.3982653205146383,17537752,2020-12-31,5080,5709,10789
5258,LRMR,-1.2625058990089666,-0.2683192787288933,218682368,2020-12-31,5297,5492,10789
5259,EVLO,-2.414875164257556,-0.17789905410658996,535482400,2020-12-31,5459,5331,10790
5260,BTAI,-7.559530463946339,-0.11930195968200683,881433472,2020-12-31,5676,5116,10792
5261,SRGA,-1.1508940052660583,-0.32842982506447327,226049392,2020-12-31,5246,5549,10795
5262,TNXP,-3.080502530950784,-0.16036549935932537,382223232,2020-12-31,5510,5286,10796
5263,ALRN,-2.662163917391869,-0.1736725321028117,120882208,2020-12-31,5480,5317,10797
5264,EVOK,-2.0337669228590567,-0.19680073344813145,61830520,2020-12-31,5422,5377,10799
5265,VSTM,-1.3550276295281727,-0.2595439719234396,473798144,2020-12-31,5317,5485,10802
5266,NBSE,-5.203530008547915,-0.13497385235891776,155306448,2020-09-30,5620,5183,10803
5267,SPPI,-1.2159118243359335,-0.3019605089579079,461589856,2020-12-31,5280,5527,10807
5268,NDRA,-10.133785077977493,-0.11870769466207937,102796336,2020-12-31,5698,5113,10811
5269,COCP,-5.221132897603486,-0.1386883330270018,100771008,2020-12-31,5621,5194,10815
5270,IMRA,-1.0127510747334418,-0.44668073089299554,134801792,2020-12-31,5201,5619,10820
5271,CDAK,-1.2417777534965035,-0.3088408752675004,340688608,2020-12-31,5287,5533,10820
5272,STSA,-1.1694332865508397,-0.34719508214057465,166433520,2020-12-31,5259,5562,10821
5273,DBVT,-1.391796802666502,-0.27260248600990766,639390080,2020-12-31,5324,5499,10823
5274,NBY,-1.821944995747094,-0.22751277342956705,37363568,2020-12-31,5389,5434,10823
5275,SYRS,-1.3781860200288039,-0.27737852838012717,402504640,2020-12-31,5319,5506,10825
5276,RMTI,-1.1846602751146311,-0.34494799029077006,97329232,2020-12-31,5268,5561,10829
5277,GRCL,-0.8828621078726085,-0.7765657298800743,885103232,2020-12-31,5152,5680,10832
5278,MNPR,-94.52605361758982,-0.11847270695166746,70500312,2020-12-31,5723,5110,10833
5279,GRTX,-1.1770407567441317,-0.3538204889770773,201307376,2020-12-31,5264,5571,10835
5280,BCTX,-5.03259444277489,-0.14408807149956118,28744716,2020-07-31,5614,5222,10836
5281,CYAD,-1.470275116266039,-0.27316035453882165,101460792,2020-12-31,5335,5502,10837
5282,FENC,-23.047680412371133,-0.11986096369474741,177211552,2020-12-31,5718,5119,10837
5283,CNCE,-0.8877686940157153,-0.9079709165343169,147034272,2020-12-31,5154,5686,10840
5284,CTIC,-2.2554744525547443,-0.20620466422275954,234646080,2020-12-31,5441,5400,10841
5285,HSTO,-1.3222711366971442,-0.30712604794899895,41749692,2020-12-31,5310,5532,10842
5286,NAVB,-2.5730483802272346,-0.1941141052694302,53135208,2020-12-31,5473,5369,10842
5287,HJLI,-3.304255322996902,-0.17251728902498292,59100296,2020-12-31,5528,5315,10843
5288,SLDB,-2.5829599091832467,-0.19492732116050668,573824192,2020-12-31,5474,5372,10846
5289,XAIR,-3.6750773881859473,-0.16303530187048676,121894672,2020-03-31,5554,5294,10848
5290,CHK,-1.004019387634472,-0.5781606193368632,4458689536,2020-12-31,5199,5652,10851
5291,HOTH,-2.9400729504675263,-0.18833471464003787,41088780,2020-12-31,5499,5353,10852
5292,WVE,-0.9804143415089395,-0.6343218978686863,305253792,2020-12-31,5193,5662,10855
5293,APVO,-1.8041866264190565,-0.25283786455129637,114127624,2020-12-31,5385,5480,10865
5294,LOGC,-2.2830749166787423,-0.22274584960813243,197280160,2020-12-31,5443,5428,10871
5295,BLRX,-3.0903086669362447,-0.18993512034332966,124159640,2020-12-31,5511,5360,10871
5296,LUMO,-0.8735636001328463,-15.602829306720198,93903784,2020-12-31,5151,5723,10874
5297,APLT,-2.035905172413793,-0.23650412326234588,435657440,2020-12-31,5425,5449,10874
5298,SLGG,-132.82608695652175,-0.12853738675035775,147509424,2020-12-31,5725,5156,10881
5299,CERC,-3.2826650054487025,-0.18900636210853192,253917216,2020-12-31,5527,5355,10882
5300,MRNS,-5.3438999449382525,-0.1544053383750819,567771264,2020-12-31,5623,5265,10888
5301,GNCA,-1.1537554938983967,-0.5364946522481603,142359216,2020-12-31,5249,5640,10889
5302,MYO,-3.556599987876789,-0.1835104589237044,66603640,2020-12-31,5544,5345,10889
5303,CABA,-2.8072519083969465,-0.20798967567602392,258915728,2020-12-31,5491,5404,10895
5304,PRPO,-2.4036793692509857,-0.23029590178043458,37352124,2020-12-31,5457,5439,10896
5305,TCDA,-1.1297071129707112,-0.683832489222328,255744512,2020-12-31,5237,5670,10907
5306,ERYP,-1.2555543394987414,-0.43829299244693415,157765632,2020-12-31,5293,5615,10908
5307,FGF,-1.0453928926666063,-1.5005007942491662,27086522,2020-12-31,5213,5698,10911
5308,BLCT,-0.9906855793177757,-7.947304334515362,292340640,2020-12-31,5195,5718,10913
5309,ISIG,-1.2254228329809724,-0.5094081209343887,10541721,2020-12-31,5283,5630,10913
5310,KTRA,-10.876664142658543,-0.14227052824065647,56964360,2020-06-30,5705,5211,10916
5311,URGN,-1.8238803704265978,-0.30322067355669996,427637792,2020-12-31,5390,5528,10918
5312,CYCN,-1.080544854155201,-1.3173996871280587,97055888,2020-12-31,5224,5696,10920
5313,PDSB,-6.187734883479525,-0.15599040881669873,121103104,2020-12-31,5652,5272,10924
5314,ELOX,-2.96117090835932,-0.22201437762002155,141044512,2020-12-31,5501,5426,10927
5315,TTNP,-1.9713059801555377,-0.28303263442125004,26830270,2020-12-31,5418,5510,10928
5316,TXMD,-3.115119042283103,-0.21354332663554507,511930304,2020-12-31,5513,5415,10928
5317,EVFM,-1.3124239350912779,-0.45193320755128163,175467248,2020-12-31,5308,5621,10929
5318,SINT,-1.5444969124591355,-0.3739505945480255,44925972,2020-12-31,5348,5584,10932
5319,GRTS,-1.6672747574189692,-0.35059507476239815,445459584,2020-12-31,5366,5566,10932
5320,OBLN,-1.5659226396783585,-0.3699749976170269,28958090,2020-12-31,5352,5581,10933
5321,AMPY,-1.1504143380227405,-1.0928405777149395,97201408,2020-12-31,5244,5691,10935
5322,AUTL,-1.2138943234404442,-0.6110455966443336,394840864,2020-12-31,5279,5658,10937
5323,VRME,-17.84,-0.14416979452086898,32232596,2020-12-31,5715,5223,10938
5324,FBIOP,-1.0559424092575773,-12.893005985794007,133659960,2020-12-31,5218,5722,10940
5325,VRNA,-4.065948248048009,-0.19396601614427697,493998720,2020-12-31,5574,5368,10942
5326,OCUP,-4.768765743073048,-0.17915671204394906,66050424,2020-12-31,5607,5335,10942
5327,PBLA,-6.6366782006920415,-0.1607055717521052,43461608,2020-12-31,5659,5288,10947
5328,AXLA,-1.5075044802867383,-0.43071440796178095,163576336,2020-12-31,5339,5610,10949
5329,ONCS,-2.604806049470036,-0.25141473287681454,182855152,2020-07-31,5475,5479,10954
5330,AZRX,-1.8907141465900361,-0.33581656573405577,69228640,2020-12-31,5400,5556,10956
5331,OPTN,-1.590310699438407,-0.39719461713788823,186369568,2020-12-31,5359,5598,10957
5332,DCTH,-2.017711687819663,-0.3148310100993023,86204872,2020-12-31,5420,5537,10957
5333,APTO,-8.386165413533835,-0.1573104698252861,465090144,2020-12-31,5688,5274,10962
5334,ZEAL,-1.2004306538905023,-0.9793528100988773,1430936064,2020-12-31,5274,5689,10963
5335,COGT,-1.6927474681476642,-0.39231627953180387,308340736,2020-12-31,5369,5595,10964
5336,ONCY,-16.82428051254601,-0.15110312645583768,196998080,2020-12-31,5713,5252,10965
5337,APDN,-2.8562669829410097,-0.2504224168016654,53058796,2020-09-30,5494,5477,10971
5338,WATT,-7.758843002142859,-0.16248442859197798,243540464,2020-12-31,5681,5292,10973
5339,ACST,-2.975888943010229,-0.2456117527645845,106343496,2020-03-31,5503,5471,10974
5340,GALT,-5.526638378123526,-0.1831480655708198,149748720,2020-12-31,5631,5343,10974
5341,BCLI,-2.294944227147617,-0.30527875175869623,130383112,2020-12-31,5445,5531,10976
5342,SONM,-1.4296660626456121,-0.567864425874547,50109804,2020-12-31,5329,5648,10977
5343,SBBP,-2.0348185445563365,-0.3337061797676133,177644416,2020-12-31,5424,5554,10978
5344,ETON,-10.874849578820697,-0.15733030750319152,183056992,2020-12-31,5704,5275,10979
5345,LFMD,-28.491022434305446,-0.1521726220024286,375648608,2020-12-31,5721,5258,10979
5346,TLIS,-1.6574087538170714,-0.44217495611516366,328674016,2020-12-31,5364,5617,10981
5347,MOTS,-1.8336248785228377,-0.38379947978368584,59370088,2020-12-31,5391,5591,10982
5348,LYRA,-2.5024225352112675,-0.2949241024262683,145013120,2020-12-31,5469,5519,10988
5349,LTBR,-2.0381640891529917,-0.35125117426199404,42377208,2020-12-31,5426,5568,10994
5350,ALBO,-3.635474491144594,-0.23361861541540507,628455168,2020-12-31,5552,5444,10996
5351,NTEC,-1.2694143565265283,-1.4846173715154862,18651858,2020-12-31,5300,5697,10997
5352,YSG,-1.40873057966159,-1.05318787961185,7143543296,2020-12-31,5326,5690,11016
5353,ADTX,-3.2526384905062735,-0.2662142950588286,42601188,2020-12-31,5526,5490,11016
5354,SCYX,-1.9607083988193352,-0.4226449301348901,173850208,2020-12-31,5417,5606,11023
5355,ARAV,-1.9402405898331394,-0.4397317087791275,107932848,2020-12-31,5410,5616,11026
5356,LQDA,-1.5764131433845052,-0.7377691935884487,111721480,2020-12-31,5354,5678,11032
5357,FTK,-1.772202550594467,-0.5863323613098856,113175352,2020-12-31,5382,5654,11036
5358,CYCC,-3.2181543116490166,-0.2872594026949016,67945768,2020-12-31,5521,5515,11036
5359,BKYI,-2.125681642511288,-0.4169568161837199,27595704,2020-12-31,5433,5604,11037
5360,ATHX,-5.19960172585463,-0.22093727678373992,383136064,2020-12-31,5619,5423,11042
5361,ARPO,-3.538174388407204,-0.27478243842725447,63872956,2020-12-31,5542,5504,11046
5362,FRLN,-2.8563003735010812,-0.3313430554053021,474272992,2020-12-31,5495,5552,11047
5363,LXRX,-4.042764155565406,-0.24907147373465885,775180992,2020-12-31,5572,5476,11048
5364,ADXS,-2.2985915492957747,-0.4101926352255907,79576968,2020-10-31,5447,5602,11049
5365,KLDO,-3.6027040606586582,-0.27287104539369705,300240288,2020-12-31,5549,5500,11049
5366,VCNX,-2.7170806559892586,-0.35065990056809604,77075384,2020-12-31,5483,5567,11050
5367,VIVE,-2.0046607413830477,-0.5102699025678316,33610524,2020-12-31,5419,5633,11052
5368,HTGM,-1.7103368917542707,-0.8083120658791841,30823424,2020-12-31,5373,5681,11054
5369,VYNE,-3.098028599636931,-0.31862537006727637,308231840,2020-12-31,5512,5542,11054
5370,BCDA,-3.6384723523898783,-0.27879468488678233,72859488,2020-12-31,5553,5507,11060
5371,OYST,-6.928459886785087,-0.2056240770248345,526839808,2020-12-31,5663,5397,11060
5372,IMV,-4.689304500292227,-0.2391002084070296,195938208,2020-12-31,5604,5458,11062
5373,CATB,-1.765084358021161,-0.8244643953375675,63460072,2020-12-31,5381,5682,11063
5374,PTE,-1.9116173779019363,-0.624202545036507,79107528,2020-12-31,5405,5659,11064
5375,HEPA,-10.66252590731163,-0.19163340933514336,141016624,2020-12-31,5703,5363,11066
5376,CDTX,-1.9299202234816943,-0.6324756849547319,110947624,2020-12-31,5408,5661,11069
5377,SIOX,-1.9277890805718905,-0.6395536810132469,156864112,2020-03-31,5407,5664,11071
5378,CAPR,-10.483619023405552,-0.19429517501895233,100082776,2020-12-31,5701,5370,11071
5379,MBIO,-3.4716127849416365,-0.3097068402260761,271707616,2020-12-31,5538,5534,11072
5380,PRVB,-5.343141984241839,-0.23654260125438503,506997600,2020-12-31,5622,5450,11072
5381,GHSI,-7.717918463563379,-0.2056420991002867,51785236,2020-12-31,5680,5398,11078
5382,LMNL,-1.9576814247669774,-0.659815850132339,123368456,2020-12-31,5415,5668,11083
5383,CNSP,-7.180712359313326,-0.21348520262507167,56421008,2020-12-31,5669,5414,11083
5384,MBRX,-7.973344103392568,-0.2066115875464222,107804272,2020-12-31,5683,5402,11085
5385,OBSV,-3.380742311770944,-0.3338006875219481,222947232,2020-12-31,5531,5555,11086
5386,DFFN,-7.247929512220574,-0.2287845974365151,85905072,2020-12-31,5670,5436,11106
5387,FIXX,-2.097328889532918,-0.7452276664428175,369569248,2020-12-31,5432,5679,11111
5388,BPTH,-4.1633587786259545,-0.31221284604162886,47523704,2020-12-31,5577,5535,11112
5389,WLL,-1.93004838703681,-2.0287500799510743,1390739968,2020-12-31,5409,5705,11114
5390,PROG,-2.6628649386084584,-0.5198782225455514,233174464,2020-12-31,5481,5636,11117
5391,XFOR,-2.8164071687285386,-0.4858869614343029,156808192,2020-12-31,5492,5626,11118
5392,DARE,-3.8026642268710202,-0.3420536216512994,77119864,2020-12-31,5560,5560,11120
5393,GNFT,-4.16943414476866,-0.3220731018977544,199523936,2020-12-31,5578,5546,11124
5394,NVIV,-2.4349571734475375,-0.6374816803728381,31791214,2020-12-31,5462,5663,11125
5395,WISA,-3.5140099626401,-0.378435728356172,34288408,2020-12-31,5540,5586,11126
5396,SNGX,-4.271134253258989,-0.32163595720617594,60430956,2020-12-31,5585,5545,11130
5397,ARTL,-383.9225727161,-0.210674867704802,23881632,2020-08-31,5726,5411,11137
5398,OAS,-2.154478857601904,-1.8865028820948881,1375728128,2020-12-31,5435,5704,11139
5399,ATNM,-11.79199578725645,-0.22926326888939724,156466736,2020-12-31,5706,5438,11144
5400,BLCM,-2.1675684341308967,-2.836235173784236,29862588,2020-12-31,5436,5710,11146
5401,BXRX,-2.690418179105962,-0.6908202000846752,82066840,2020-12-31,5482,5671,11153
5402,PHIO,-4.3039647577092515,-0.3480941400471441,37077408,2020-12-31,5588,5565,11153
5403,MITO,-2.6551197425126833,-0.7360426971607211,77863240,2020-12-31,5479,5677,11156
5404,IMUX,-8.381139825432141,-0.2475371041291763,316887968,2020-12-31,5687,5472,11159
5405,AYLA,-6.283393120911585,-0.2763699865443076,142891248,2020-12-31,5655,5505,11160
5406,BLPH,-2.3656253524303597,-2.305636674923695,46221704,2020-12-31,5454,5708,11162
5407,PTN,-5.0494219965370055,-0.3269292122760619,151132336,2020-06-30,5615,5548,11163
5408,BBI,-3.5618950585838003,-0.4431890613772903,70945688,2020-12-31,5546,5618,11164
5409,XBIO,-3.3071354552287855,-0.5654548393515572,18892852,2020-12-31,5529,5647,11176
5410,ZYNE,-4.206437441832036,-0.3964782086651877,176556432,2020-12-31,5582,5596,11178
5411,SNES,-4.016708860759493,-0.4351016754677905,20435520,2020-12-31,5570,5613,11183
5412,TMBR,-9.908887356628632,-0.27047391299772333,78107152,2020-12-31,5694,5495,11189
5413,CYTH,-33.28420102585435,-0.24262419632844226,46064396,2020-12-31,5722,5467,11189
5414,WINT,-4.223546302943288,-0.4240076085849801,62754472,2020-12-31,5583,5608,11191
5415,ELDN,-8.109279609279609,-0.2795216814381274,159232464,2020-12-31,5686,5508,11194
5416,LPTX,-4.192535545023697,-0.4515923271802682,107383856,2020-12-31,5579,5620,11199
5417,CRBP,-3.5354348149073407,-0.6312394361013789,230060720,2020-12-31,5541,5660,11201
5418,KRBP,-6.6360965154867255,-0.31863502596796867,68930200,2020-12-31,5658,5543,11201
5419,ADIL,-9.056548810373277,-0.2860232784740909,41102364,2020-12-31,5691,5514,11205
5420,ACHV,-4.877645502645502,-0.3966003898568388,70109088,2020-12-31,5609,5597,11206
5421,AEMD,-5.532980080298352,-0.360410706152363,24990478,2020-03-31,5632,5575,11207
5422,HUGE,-4.03725308123397,-0.5305040458769741,68200120,2020-12-31,5571,5638,11209
5423,OVID,-4.685330413960057,-0.4226675688241879,242630784,2020-12-31,5603,5607,11210
5424,PHAS,-3.947892435098167,-0.5563197281244981,158360992,2020-12-31,5566,5645,11211
5425,RMED,-2.771850257514029,-42.33877122574494,15416678,2020-12-31,5488,5725,11213
5426,CRTD,-5.366798974452611,-0.38053484763284995,45515972,2020-12-31,5625,5588,11213
5427,SNCA,-4.141339902242222,-0.5336734471471851,27327206,2020-12-31,5575,5639,11214
5428,ATHE,-7.6041379844944315,-0.3197748415404746,50043336,2020-06-30,5677,5544,11221
5429,ACER,-4.537907778001608,-0.5101022242903349,43932312,2020-12-31,5598,5632,11230
5430,CHFS,-3.802590442161679,-0.6972837056902577,35272476,2020-12-31,5559,5673,11232
5431,GOSS,-4.364122437983131,-0.5468340504829243,660112064,2020-12-31,5592,5643,11235
5432,TENX,-6.880000725096424,-0.3637406129153899,31136142,2020-12-31,5661,5577,11238
5433,MYSZ,-5.004885993485342,-0.49808977788648334,13117141,2020-12-31,5613,5629,11242
5434,GLYC,-3.457643267678728,-2.1161519480003013,148947712,2020-12-31,5537,5706,11243
5435,CALA,-3.923704435189558,-1.0938008528168492,172294944,2020-12-31,5564,5692,11256
5436,BNTC,-5.074142156862745,-0.5419251516356441,23945708,2020-06-30,5617,5642,11259
5437,RZLT,-7.3456834532374105,-0.3811704308358871,60303460,2020-06-30,5671,5589,11260
5438,SONN,-5.758289625685711,-0.46834991096893497,39676332,2020-09-30,5638,5623,11261
5439,NVCN,-5.717419776536184,-0.49462541124670545,68157528,2020-12-31,5636,5627,11263
5440,NBRV,-3.9424074405294225,-1.5878480041946887,58794044,2020-12-31,5565,5700,11265
5441,IDRA,-4.149643705463183,-1.2058947931982629,56625052,2020-12-31,5576,5695,11271
5442,OGEN,-15.58467471407372,-0.34049518726544187,94547744,2020-12-31,5712,5559,11271
5443,VIRI,-7.646694587530379,-0.43247896778316336,51398508,2020-12-31,5679,5611,11290
5444,ABIO,-4.465477823502515,-1.5144701215484007,52020460,2020-12-31,5596,5699,11295
5445,ALNA,-5.929922135706341,-0.5828713028327115,73943608,2020-12-31,5642,5653,11295
5446,SLNO,-6.042935502175147,-0.571951084854204,96465672,2020-12-31,5645,5650,11295
5447,AVRO,-6.70765454139701,-0.5270981441768186,471162144,2020-12-31,5660,5637,11297
5448,CLRB,-5.358519904747386,-0.7231600702163414,74746072,2020-12-31,5624,5676,11300
5449,ONVO,-14.44770642201835,-0.3841097400649289,66544700,2020-03-31,5710,5592,11302
5450,APRE,-4.708535082729586,-1.6706132958723006,105298392,2020-12-31,5605,5701,11306
5451,CANF,-17.014440433212997,-0.426385053296473,40159168,2020-12-31,5714,5609,11323
5452,BSGM,-10.240066440009343,-0.48464047380779623,145279392,2020-12-31,5700,5624,11324
5453,APTX,-6.065838212450711,-0.9367902335396923,190635360,2020-12-31,5649,5687,11336
5454,SRRA,-7.881301614692469,-0.6103120778279476,199469712,2020-12-31,5682,5657,11339
5455,ETTX,-5.8119172650305435,-1.685385087386056,76859216,2020-12-31,5640,5702,11342
5456,ORGS,-7.057439703153989,-0.8750617978636416,130114896,2020-12-31,5668,5684,11352
5457,INM,-18.81131155306707,-0.5198157552655577,28927834,2020-06-30,5717,5635,11352
5458,TARA,-5.550112794070254,-15.76696170592996,167867568,2020-12-31,5633,5724,11357
5459,ODT,-6.091734786557675,-6.91373673926272,148623856,2020-12-31,5650,5717,11367
5460,TRVI,-7.3821858668484435,-1.1908951085657649,52773160,2020-12-31,5673,5694,11367
5461,GLTO,-6.515010652721286,-53.552551137376774,158644112,2020-12-31,5657,5726,11383
